Id,Label,indegree,outdegree,Degree,pageranks,modularity_class
en.wikipedia.org/wiki/IIT_Kanpur,,174,760,934,1.1e-05,31
en.wikipedia.org/wiki/Special:Random,,547,0,547,2e-05,31
en.wikipedia.org/wiki/Wikipedia:Contact_us,,547,150,697,2e-05,31
en.wikipedia.org/wiki/Help:Introduction,,547,197,744,2e-05,31
en.wikipedia.org/wiki/Special:RecentChanges,,547,0,547,2e-05,31
en.wikipedia.org/wiki/Wikipedia:File_upload_wizard,,547,147,694,2e-05,31
en.wikipedia.org/wiki/Special:SpecialPages,,547,0,547,2e-05,31
en.wikipedia.org/wiki/Special:Search,,547,0,547,2e-05,31
donate.wikimedia.org/?wmf_source=donate&wmf_medium=sidebar&wmf_campaign=en.wikipedia.org&uselang=en,,545,0,545,2e-05,31
en.wikipedia.org/w/index.php?title=Special:CreateAccount&returnto=IIT+Kanpur,,5,0,5,6e-06,31
en.wikipedia.org/w/index.php?title=Special:UserLogin&returnto=IIT+Kanpur,,5,0,5,6e-06,31
en.wikipedia.org/wiki/Special:MyContributions,,547,0,547,2e-05,31
en.wikipedia.org/wiki/Special:MyTalk,,547,0,547,2e-05,31
wikidata.org/wiki/Special:EntityPage/Q782682,,24,0,24,8e-06,31
en.wikipedia.org/w/index.php?title=IIT_Kanpur&action=edit,,5,0,5,6e-06,31
en.wikipedia.org/w/index.php?title=IIT_Kanpur&action=history,,5,0,5,6e-06,31
en.wikipedia.org/wiki/Special:WhatLinksHere/IIT_Kanpur,,5,0,5,6e-06,31
en.wikipedia.org/wiki/Special:RecentChangesLinked/IIT_Kanpur,,5,0,5,6e-06,31
en.wikipedia.org/w/index.php?title=IIT_Kanpur&oldid=1307848471,,5,0,5,6e-06,31
en.wikipedia.org/w/index.php?title=IIT_Kanpur&action=info,,5,0,5,6e-06,31
en.wikipedia.org/w/index.php?title=Special:DownloadAsPdf&page=IIT_Kanpur&action=show-download-screen,,5,0,5,6e-06,31
en.wikipedia.org/w/index.php?title=IIT_Kanpur&printable=yes,,5,0,5,6e-06,31
geohack.toolforge.org/geohack.php?pagename=IIT_Kanpur&params=26.511383_N_80.23493_E_,,5,0,5,6e-06,31
"en.wikipedia.org/wiki/Kalyanpur,_Uttar_Pradesh",,14,507,521,7e-06,31
"en.wikipedia.org/wiki/Kanpur,_Uttar_Pradesh",,6,1058,1064,6e-06,31
en.wikipedia.org/wiki/File:IIT_Kanpur.jpg,,10,73,83,7e-06,31
en.wikipedia.org/w/index.php?title=IIT_Kanpur&action=edit&section=1,,5,0,5,6e-06,31
en.wikipedia.org/wiki/Harcourt_Butler_Technological_Institute,,7,1079,1086,7e-06,31
en.wikipedia.org/wiki/H.K._Kesavan,,6,133,139,6e-06,31
en.wikipedia.org/w/index.php?title=IIT_Kanpur&action=edit&section=2,,5,0,5,6e-06,31
en.wikipedia.org/wiki/File:IIT_Kanpur_3.jpg,,6,80,86,6e-06,31
en.wikipedia.org/wiki/Uttar_Pradesh,,190,1793,1983,1.1e-05,31
en.wikipedia.org/wiki/File:IITKLibrary.jpg,,7,119,126,7e-06,31
en.wikipedia.org/w/index.php?title=IIT_Kanpur&action=edit&section=3,,5,0,5,6e-06,31
en.wikipedia.org/wiki/Noida,,34,738,772,7e-06,31
en.wikipedia.org/w/index.php?title=IIT_Kanpur&action=edit&section=4,,5,0,5,6e-06,31
en.wikipedia.org/wiki/Chakeri,,75,358,433,8e-06,31
en.wikipedia.org/wiki/Kanpur_Metro,,95,509,604,8e-06,31
en.wikipedia.org/wiki/IIT_Kanpur_metro_station,,7,142,149,7e-06,31
en.wikipedia.org/wiki/Kanpur_Central_railway_station,,98,704,802,8e-06,31
en.wikipedia.org/w/index.php?title=IIT_Kanpur&action=edit&section=5,,5,0,5,6e-06,31
en.wikipedia.org/w/index.php?title=IIT_Kanpur&action=edit&section=6,,5,0,5,6e-06,31
en.wikipedia.org/w/index.php?title=IIT_Kanpur&action=edit&section=7,,5,0,5,6e-06,31
en.wikipedia.org/w/index.php?title=IIT_Kanpur&action=edit&section=8,,5,0,5,6e-06,31
en.wikipedia.org/wiki/Materials_Science_and_Engineering,,6,60,66,6e-06,31
en.wikipedia.org/w/index.php?title=IIT_Kanpur&action=edit&section=9,,5,0,5,6e-06,31
en.wikipedia.org/wiki/File:Indian_Institute_of_Technology_Kanpur.jpg,,10,72,82,7e-06,31
en.wikipedia.org/w/index.php?title=IIT_Kanpur&action=edit&section=10,,5,0,5,6e-06,31
en.wikipedia.org/w/index.php?title=IIT_Kanpur&action=edit&section=11,,5,0,5,6e-06,31
en.wikipedia.org/w/index.php?title=IIT_Kanpur&action=edit&section=12,,5,0,5,6e-06,31
en.wikipedia.org/w/index.php?title=IIT_Kanpur&action=edit&section=13,,5,0,5,6e-06,31
en.wikipedia.org/w/index.php?title=IIT_Kanpur&action=edit&section=14,,5,0,5,6e-06,31
en.wikipedia.org/wiki/Outlook_India,,23,111,134,7e-06,31
en.wikipedia.org/w/index.php?title=IIT_Kanpur&action=edit&section=15,,5,0,5,6e-06,31
en.wikipedia.org/wiki/File:Department_of_Computer_Science_and_Engineering_IIT_Kanpur.jpg,,6,63,69,6e-06,31
"en.wikipedia.org/wiki/File:Samtel_Research_and_Development_Building,_at_IIT_Kanpur.jpg",,6,96,102,6e-06,31
en.wikipedia.org/wiki/File:Computer_Center_at_IIT_Kanpur_India1.jpg,,6,70,76,6e-06,31
en.wikipedia.org/w/index.php?title=IIT_Kanpur&action=edit&section=16,,5,0,5,6e-06,31
en.wikipedia.org/w/index.php?title=IIT_Kanpur&action=edit&section=17,,5,0,5,6e-06,31
en.wikipedia.org/w/index.php?title=IIT_Kanpur&action=edit&section=18,,5,0,5,6e-06,31
en.wikipedia.org/w/index.php?title=IIT_Kanpur&action=edit&section=19,,5,0,5,6e-06,31
en.wikipedia.org/w/index.php?title=IIT_Kanpur&action=edit&section=20,,5,0,5,6e-06,31
en.wikipedia.org/w/index.php?title=IIT_Kanpur&action=edit&section=21,,5,0,5,6e-06,31
en.wikipedia.org/w/index.php?title=IIT_Kanpur&action=edit&section=22,,5,0,5,6e-06,31
en.wikipedia.org/w/index.php?title=IIT_Kanpur&action=edit&section=23,,5,0,5,6e-06,31
en.wikipedia.org/w/index.php?title=IIT_Kanpur&action=edit&section=24,,5,0,5,6e-06,31
en.wikipedia.org/w/index.php?title=IIT_Kanpur&action=edit&section=25,,5,0,5,6e-06,31
en.wikipedia.org/wiki/File:IIT_Kanpur_4.jpg,,10,75,85,7e-06,31
"en.wikipedia.org/wiki/Entrepreneurship_Cell,_IIT_Kanpur",,5,760,765,6e-06,31
en.wikipedia.org/w/index.php?title=IIT_Kanpur&action=edit&section=26,,5,0,5,6e-06,31
en.wikipedia.org/w/index.php?title=IIT_Kanpur&action=edit&section=27,,5,0,5,6e-06,31
en.wikipedia.org/w/index.php?title=IIT_Kanpur&action=edit&section=28,,5,0,5,6e-06,31
en.wikipedia.org/wiki/Harcourt_Butler_Technical_University,,98,1078,1176,8e-06,31
en.wikipedia.org/w/index.php?title=IIT_Kanpur&action=edit&section=29,,5,0,5,6e-06,31
nirfindia.org/nirfpdfcdn/2024/pdf/Overall/IR-O-I-1075.pdf,,8,0,8,7e-06,31
iitk.ac.in/infocell/iitk/newhtml/history.htm,,15,0,15,7e-06,31
iitk.ac.in/drpg/social_media/Greeting_2012.htm,,6,0,6,7e-06,31
iitk.ac.in/aero/home/index.php/latest-news/199-iit-kanpur-to-lucknow-helicopter-service-begins,,5,0,5,6e-06,31
spo.iitk.ac.in/reach_us.html,,6,1,7,6e-06,31
nyc.iitk.ac.in/,,5,0,5,6e-06,31
iitk.ac.in/doaa,,6,1,7,7e-06,31
iitk.ac.in/doaa/faqs.pdf,,6,0,6,7e-06,31
business-standard.com/india/news/shot-inarm-for-cat-as-b-schools-seek-credibility/447694/,,7,1,8,7e-06,31
iitk.ac.in/infocell/iitk/newhtml/admissions.htm,,5,0,5,6e-06,31
topuniversities.com/university-rankings/asia-university-rankings/2023,,17,1,18,7e-06,31
search.worldcat.org/issn/0971-8257,,39,1,40,7e-06,31
articles.economictimes.indiatimes.com/2011-10-25/news/30320349_1_nano-satellite-jugnu-iit-kanpur,,6,1,7,7e-06,31
top500.org/list/2015/06/?page=2,,6,1,7,6e-06,31
gktoday.in/topic/iit-kanpur-develops-energy-efficient-system-to-transport-minerals,,5,1,6,6e-06,31
iks.iitk.ac.in/,,5,2,7,6e-06,31
mrtc.mdh.se/eureca/contact.html,,5,0,5,6e-06,31
iitk.ac.in/newdord/templates/r_d/data/R_DNewsletter/november2013.pdf,,6,0,6,7e-06,31
antaragni.in/,,8,1,9,7e-06,31
techkriti.org/,,6,0,6,7e-06,31
udghosh.or/,,6,0,6,7e-06,31
ecelliitk.org/esummit/,,6,1,7,6e-06,31
students.iitk.ac.in/gymkhana/,,8,0,8,7e-06,31
en.wikipedia.org/wiki/Template:Kanpur,,92,202,294,8e-06,31
en.wikipedia.org/wiki/Template_talk:Kanpur,,69,60,129,8e-06,31
en.wikipedia.org/wiki/Special:EditPage/Template:Kanpur,,68,0,68,8e-06,31
en.wikipedia.org/wiki/Kanpur,,152,1057,1209,1e-05,31
en.wikipedia.org/wiki/Siege_of_Cawnpore,,92,564,656,8e-06,31
en.wikipedia.org/wiki/Second_Battle_of_Cawnpore,,92,390,482,8e-06,31
en.wikipedia.org/w/index.php?title=Anandeshwar_Temple&action=edit&redlink=1,,68,0,68,8e-06,31
en.wikipedia.org/wiki/J._K._Temple,,68,284,352,8e-06,31
en.wikipedia.org/w/index.php?title=Sai_Darbar&action=edit&redlink=1,,68,0,68,8e-06,31
en.wikipedia.org/w/index.php?title=Panki_Hanuman_Mandir&action=edit&redlink=1,,68,0,68,8e-06,31
en.wikipedia.org/w/index.php?title=Jain_Glass_Temple&action=edit&redlink=1,,68,0,68,8e-06,31
en.wikipedia.org/w/index.php?title=Kherepati_Temple&action=edit&redlink=1,,68,0,68,8e-06,31
en.wikipedia.org/wiki/Bhitargaon,,73,438,511,8e-06,31
en.wikipedia.org/w/index.php?title=Bara-Devi_Mandir&action=edit&redlink=1,,68,0,68,8e-06,31
en.wikipedia.org/w/index.php?title=Tapeshwari_Mandir&action=edit&redlink=1,,68,0,68,8e-06,31
en.wikipedia.org/wiki/Kanpur_Memorial_Church,,70,238,308,8e-06,31
en.wikipedia.org/wiki/Allen_Forest_Zoo,,69,399,468,8e-06,31
en.wikipedia.org/wiki/Moti_Jheel,,99,393,492,8e-06,31
en.wikipedia.org/wiki/Bithoor,,75,400,475,8e-06,31
en.wikipedia.org/wiki/Jajmau,,69,146,215,8e-06,31
en.wikipedia.org/wiki/Nawabganj_Bird_Sanctuary,,73,655,728,8e-06,31
en.wikipedia.org/wiki/Kanpur_Sangrahalaya,,68,213,281,8e-06,31
en.wikipedia.org/wiki/Ganges_Barrage,,76,377,453,8e-06,31
en.wikipedia.org/w/index.php?title=Rave_3&action=edit&redlink=1,,69,0,69,8e-06,31
en.wikipedia.org/w/index.php?title=Z_Square&action=edit&redlink=1,,68,0,68,8e-06,31
en.wikipedia.org/w/index.php?title=Rave_4&action=edit&redlink=1,,68,0,68,8e-06,31
en.wikipedia.org/w/index.php?title=Patthar_Ghat&action=edit&redlink=1,,68,0,68,8e-06,31
en.wikipedia.org/wiki/Massacre_Ghat,,68,248,316,8e-06,31
en.wikipedia.org/w/index.php?title=Sarsaiya_Ghat&action=edit&redlink=1,,68,0,68,8e-06,31
en.wikipedia.org/wiki/Kanpur_Development_Authority,,69,245,314,8e-06,31
en.wikipedia.org/wiki/Kanpur_City_Police,,69,199,268,8e-06,31
en.wikipedia.org/wiki/Phool_Bagh,,68,259,327,8e-06,31
en.wikipedia.org/wiki/Nana_Rao_Park,,68,228,296,8e-06,31
en.wikipedia.org/wiki/British_India_Corporation,,91,224,315,8e-06,31
en.wikipedia.org/wiki/Inext,,69,85,154,8e-06,31
en.wikipedia.org/wiki/Lohia_Machinery_Limited,,70,366,436,8e-06,31
en.wikipedia.org/wiki/Panki_Thermal_Power_Station,,92,369,461,8e-06,31
en.wikipedia.org/wiki/Category:Education_in_Kanpur,,70,64,134,8e-06,31
en.wikipedia.org/wiki/Chhatrapati_Shahu_Ji_Maharaj_University,,97,519,616,8e-06,31
en.wikipedia.org/wiki/Chandra_Shekhar_Azad_University_of_Agriculture_%26_Technology,,68,433,501,8e-06,31
en.wikipedia.org/wiki/Ganesh_Shankar_Vidyarthi_Memorial_Medical_College,,93,368,461,8e-06,31
en.wikipedia.org/wiki/Indian_Institute_of_Technology_Kanpur,,114,760,874,8e-06,31
en.wikipedia.org/wiki/P_K_Kelkar_library,,68,760,828,8e-06,31
"en.wikipedia.org/wiki/Odyssey_(HBTI,_Kanpur)",,68,1078,1146,8e-06,31
en.wikipedia.org/wiki/Govt._Central_Textile_Institute,,68,360,428,8e-06,31
"en.wikipedia.org/wiki/University_Institute_of_Engineering_and_Technology,_Kanpur_University",,69,519,588,8e-06,31
en.wikipedia.org/w/index.php?title=Government_Leather_Institute_Kanpur&action=edit&redlink=1,,68,0,68,8e-06,31
en.wikipedia.org/wiki/Pranveer_Singh_Institute_of_Technology,,70,393,463,8e-06,31
en.wikipedia.org/wiki/Krishna_Institute_of_Technology,,70,393,463,8e-06,31
en.wikipedia.org/wiki/Kanpur_Institute_of_Technology,,69,393,462,8e-06,31
en.wikipedia.org/wiki/List_of_engineering_colleges_in_Kanpur,,70,89,159,8e-06,31
en.wikipedia.org/wiki/Civil_Lines,,70,76,146,8e-06,31
"en.wikipedia.org/w/index.php?title=Tilak_Nagar,_Kanpur&action=edit&redlink=1",,68,0,68,8e-06,31
en.wikipedia.org/w/index.php?title=Arya_Nagar&action=edit&redlink=1,,68,0,68,8e-06,31
en.wikipedia.org/w/index.php?title=Swaroop_Nagar&action=edit&redlink=1,,68,0,68,8e-06,31
en.wikipedia.org/w/index.php?title=Chunni_Ganj&action=edit&redlink=1,,68,0,68,8e-06,31
en.wikipedia.org/w/index.php?title=Azad_Nagar&action=edit&redlink=1,,68,0,68,8e-06,31
en.wikipedia.org/w/index.php?title=Nawab_Ganj&action=edit&redlink=1,,68,0,68,8e-06,31
en.wikipedia.org/wiki/Kakadeo,,69,218,287,8e-06,31
en.wikipedia.org/w/index.php?title=Geeta_Nagar&action=edit&redlink=1,,68,0,68,8e-06,31
en.wikipedia.org/w/index.php?title=Pandu_Nagar&action=edit&redlink=1,,68,0,68,8e-06,31
en.wikipedia.org/w/index.php?title=Sarvodya_Nagar&action=edit&redlink=1,,68,0,68,8e-06,31
en.wikipedia.org/w/index.php?title=Sharda_Nagar&action=edit&redlink=1,,68,0,68,8e-06,31
en.wikipedia.org/w/index.php?title=Shastri_Nagar_(Kanpur)&action=edit&redlink=1,,68,0,68,8e-06,31
en.wikipedia.org/wiki/Rawatpur,,70,228,298,8e-06,31
en.wikipedia.org/w/index.php?title=Keshavpuram&action=edit&redlink=1,,68,0,68,8e-06,31
en.wikipedia.org/w/index.php?title=Ravidas_Puram_Shivaji_Nagar&action=edit&redlink=1,,68,0,68,8e-06,31
"en.wikipedia.org/wiki/The_Mall,_Kanpur",,68,248,316,8e-06,31
en.wikipedia.org/wiki/Lal_Bangla,,69,100,169,8e-06,31
en.wikipedia.org/wiki/Shyam_Nagar,,69,81,150,8e-06,31
en.wikipedia.org/wiki/Kanpur_Cantonment,,71,267,338,8e-06,31
"en.wikipedia.org/w/index.php?title=Indira_Nagar,_Kanpur&action=edit&redlink=1",,68,0,68,8e-06,31
en.wikipedia.org/wiki/Kalianpur,,70,507,577,8e-06,31
"en.wikipedia.org/wiki/Panki,_Kanpur",,73,223,296,8e-06,31
"en.wikipedia.org/wiki/Mandhana,_Kanpur",,70,111,181,8e-06,31
en.wikipedia.org/wiki/Chobepur,,70,115,185,8e-06,31
en.wikipedia.org/wiki/Armapur_Estate,,72,331,403,8e-06,31
en.wikipedia.org/wiki/New_Kanpur_City,,68,336,404,8e-06,31
"en.wikipedia.org/wiki/Barra,_Kanpur",,70,107,177,8e-06,31
en.wikipedia.org/wiki/Govind_Nagar,,71,225,296,8e-06,31
en.wikipedia.org/w/index.php?title=Gujaini&action=edit&redlink=1,,68,0,68,8e-06,31
en.wikipedia.org/wiki/Kidwai_Nagar,,71,107,178,8e-06,31
en.wikipedia.org/wiki/Ratan_Lal_Nagar,,70,90,160,8e-06,31
en.wikipedia.org/wiki/Naubasta,,69,139,208,8e-06,31
en.wikipedia.org/w/index.php?title=Yashoda_Nagar&action=edit&redlink=1,,68,0,68,8e-06,31
en.wikipedia.org/w/index.php?title=Jarauli&action=edit&redlink=1,,68,0,68,8e-06,31
en.wikipedia.org/w/index.php?title=Tatya_Tope_Nagar&action=edit&redlink=1,,68,0,68,8e-06,31
en.wikipedia.org/w/index.php?title=Hanspuram&action=edit&redlink=1,,68,0,68,8e-06,31
en.wikipedia.org/wiki/Shuklaganj,,70,246,316,8e-06,31
en.wikipedia.org/w/index.php?title=Gangotri_Township&action=edit&redlink=1,,68,0,68,8e-06,31
en.wikipedia.org/w/index.php?title=The_Landmark_Hotel&action=edit&redlink=1,,68,0,68,8e-06,31
en.wikipedia.org/w/index.php?title=Hotel_Megadoot&action=edit&redlink=1,,68,0,68,8e-06,31
en.wikipedia.org/w/index.php?title=Hotel_Gaurav&action=edit&redlink=1,,68,0,68,8e-06,31
en.wikipedia.org/w/index.php?title=Hotel_Bliss&action=edit&redlink=1,,68,0,68,8e-06,31
en.wikipedia.org/w/index.php?title=Kanha_Continental&action=edit&redlink=1,,68,0,68,8e-06,31
en.wikipedia.org/w/index.php?title=Kanha_International&action=edit&redlink=1,,68,0,68,8e-06,31
en.wikipedia.org/wiki/Kesco,,68,233,301,8e-06,31
en.wikipedia.org/wiki/Kanpur_Metropolitan_Bus_Service,,94,379,473,8e-06,31
en.wikipedia.org/wiki/Chandari_Junction_railway_station,,71,418,489,8e-06,31
en.wikipedia.org/wiki/Govindpuri_railway_station,,72,446,518,8e-06,31
en.wikipedia.org/wiki/Kanpur_Anwarganj_railway_station,,94,302,396,8e-06,31
en.wikipedia.org/wiki/Lucknow-Kanpur_Suburban_Railway,,69,483,552,8e-06,31
en.wikipedia.org/wiki/Kanpur_Lucknow_Roadways_Service,,74,209,283,8e-06,31
en.wikipedia.org/wiki/Green_Park_Stadium,,70,359,429,8e-06,31
en.wikipedia.org/wiki/Kamla_Club_Ground,,68,238,306,8e-06,31
en.wikipedia.org/wiki/Kanpur_(Lok_Sabha_constituency),,93,547,640,8e-06,31
en.wikipedia.org/wiki/Akbarpur_(Lok_Sabha_constituency),,93,354,447,8e-06,31
en.wikipedia.org/wiki/Department_of_Industrial_and_Management_Engineering_IIT_Kanpur,,76,760,836,8e-06,31
en.wikipedia.org/wiki/Template:Kanpur_division_topics,,77,181,258,8e-06,31
en.wikipedia.org/wiki/Template_talk:Kanpur_division_topics,,54,58,112,7e-06,31
en.wikipedia.org/wiki/Special:EditPage/Template:Kanpur_division_topics,,53,0,53,7e-06,31
en.wikipedia.org/wiki/Kanpur_division,,59,444,503,7e-06,31
en.wikipedia.org/wiki/Kanpur_Zoological_Park,,55,399,454,7e-06,31
en.wikipedia.org/wiki/Lakh_Bahosi_Sanctuary,,54,251,305,7e-06,31
en.wikipedia.org/wiki/Etawah_Safari_Park,,59,282,341,7e-06,31
en.wikipedia.org/wiki/Sarsai_Nawar_Wetland,,55,206,261,7e-06,31
en.wikipedia.org/wiki/Auraiya_district,,79,631,710,8e-06,31
en.wikipedia.org/wiki/Etawah_district,,84,442,526,8e-06,31
en.wikipedia.org/wiki/Farrukhabad_district,,81,584,665,8e-06,31
en.wikipedia.org/wiki/Kannauj_district,,79,481,560,8e-06,31
en.wikipedia.org/wiki/Kanpur_Nagar_district,,93,506,599,8e-06,31
en.wikipedia.org/wiki/Kanpur_Dehat_district,,83,447,530,8e-06,31
en.wikipedia.org/wiki/Auraiya,,58,148,206,7e-06,31
en.wikipedia.org/wiki/Bidhuna,,56,191,247,7e-06,31
en.wikipedia.org/wiki/Bilhaur,,62,205,267,7e-06,31
en.wikipedia.org/wiki/Ghatampur,,64,215,279,7e-06,31
"en.wikipedia.org/wiki/Akbarpur,_Kanpur_Dehat",,59,407,466,7e-06,31
en.wikipedia.org/wiki/Bhognipur,,55,100,155,7e-06,31
en.wikipedia.org/wiki/Derapur,,55,118,173,7e-06,31
en.wikipedia.org/wiki/Rasulabad,,58,204,262,7e-06,31
en.wikipedia.org/wiki/Sikandara,,58,196,254,7e-06,31
en.wikipedia.org/wiki/Maitha,,56,109,165,7e-06,31
en.wikipedia.org/wiki/Etawah,,70,454,524,8e-06,31
en.wikipedia.org/wiki/Jaswantnagar,,57,123,180,7e-06,31
en.wikipedia.org/wiki/Saifai,,62,517,579,8e-06,31
en.wikipedia.org/wiki/Takha,,58,136,194,7e-06,31
en.wikipedia.org/wiki/Chibramau,,54,220,274,7e-06,31
en.wikipedia.org/wiki/Tirwa,,54,192,246,7e-06,31
en.wikipedia.org/wiki/Farrukhabad,,63,292,355,8e-06,31
en.wikipedia.org/wiki/Kaimganj,,57,264,321,7e-06,31
"en.wikipedia.org/wiki/Amritpur,_Uttar_Pradesh",,54,97,151,7e-06,31
en.wikipedia.org/wiki/Kali_River_(Uttar_Pradesh),,61,146,207,7e-06,31
en.wikipedia.org/wiki/Dibiyapur,,57,505,562,7e-06,31
en.wikipedia.org/wiki/Phaphund_railway_station,,54,372,426,7e-06,31
en.wikipedia.org/wiki/Etawah_Junction_railway_station,,60,320,380,7e-06,31
en.wikipedia.org/wiki/Howrah–Delhi_main_line,,63,759,822,8e-06,31
en.wikipedia.org/wiki/Lucknow–Kanpur_Suburban_Railway,,64,482,546,7e-06,31
en.wikipedia.org/wiki/Kanpur_Monorail,,54,200,254,7e-06,31
en.wikipedia.org/wiki/Lohia_Machinery,,53,366,419,7e-06,31
en.wikipedia.org/wiki/Chandra_Shekhar_Azad_University_of_Agriculture_and_Technology,,59,433,492,7e-06,31
"en.wikipedia.org/wiki/Government_Medical_College,_Kannauj",,55,97,152,7e-06,31
en.wikipedia.org/wiki/Uttar_Pradesh_Textile_Technology_Institute,,55,360,415,7e-06,31
en.wikipedia.org/wiki/Uttar_Pradesh_University_of_Medical_Sciences,,59,338,397,7e-06,31
en.wikipedia.org/wiki/Ghatampur_(Lok_Sabha_constituency),,54,210,264,7e-06,31
en.wikipedia.org/wiki/Bilhaur_(Lok_Sabha_constituency),,56,217,273,7e-06,31
en.wikipedia.org/wiki/Unnao_(Lok_Sabha_constituency),,57,334,391,7e-06,31
en.wikipedia.org/wiki/Fatehpur_(Lok_Sabha_constituency),,54,311,365,7e-06,31
en.wikipedia.org/wiki/Etawah_(Lok_Sabha_constituency),,55,363,418,7e-06,31
en.wikipedia.org/wiki/Mainpuri_(Lok_Sabha_constituency),,58,352,410,7e-06,31
en.wikipedia.org/wiki/Template:Auraiya_district,,55,138,193,7e-06,31
en.wikipedia.org/wiki/Template:Etawah_district,,57,72,129,7e-06,31
en.wikipedia.org/wiki/Template:Farrukhabad_district,,56,139,195,7e-06,31
en.wikipedia.org/wiki/Template:Kannauj_district,,56,135,191,7e-06,31
en.wikipedia.org/wiki/Template:Kanpur_Nagar_district,,61,143,204,7e-06,31
en.wikipedia.org/wiki/Template:Kanpur_Dehat_district,,57,138,195,7e-06,31
en.wikipedia.org/wiki/Category:Villages_in_Auraiya_district,,54,57,111,7e-06,31
en.wikipedia.org/wiki/Category:Villages_in_Etawah_district,,55,65,120,7e-06,31
en.wikipedia.org/wiki/Category:Villages_in_Farrukhabad_district,,54,54,108,7e-06,31
en.wikipedia.org/wiki/Category:Villages_in_Kannauj_district,,54,52,106,7e-06,31
en.wikipedia.org/wiki/Category:Villages_in_Kanpur_Nagar_district,,54,98,152,7e-06,31
en.wikipedia.org/wiki/Category:Villages_in_Kanpur_Dehat_district,,55,75,130,7e-06,31
en.wikipedia.org/wiki/Category:People_from_Etawah,,54,85,139,7e-06,31
en.wikipedia.org/wiki/Category:People_from_Farrukhabad,,54,80,134,7e-06,31
en.wikipedia.org/wiki/Category:People_from_Kanpur,,55,152,207,7e-06,31
en.wikipedia.org/wiki/Category:People_from_Kanpur_Dehat_district,,54,73,127,7e-06,31
en.wikipedia.org/wiki/Template:Agra_division_topics,,76,142,218,8e-06,31
en.wikipedia.org/wiki/Template:Aligarh_division_topics,,76,117,193,8e-06,31
en.wikipedia.org/wiki/Template:Faizabad_division_topics,,76,118,194,8e-06,31
en.wikipedia.org/wiki/Template:Azamgarh_division_topics,,76,98,174,8e-06,31
en.wikipedia.org/wiki/Template:Bareilly_division_topics,,76,118,194,8e-06,31
en.wikipedia.org/wiki/Template:Basti_division_topics,,76,85,161,8e-06,31
en.wikipedia.org/wiki/Template:Chitrakoot_division_topics,,76,98,174,8e-06,31
en.wikipedia.org/wiki/Template:Devipatan_division_topics,,76,111,187,8e-06,31
en.wikipedia.org/wiki/Template:Gorakhpur_division_topics,,76,106,182,8e-06,31
en.wikipedia.org/wiki/Template:Jhansi_division_topics,,76,108,184,8e-06,31
en.wikipedia.org/wiki/Template:Lucknow_division_topics,,76,145,221,8e-06,31
en.wikipedia.org/wiki/Template:Meerut_division_topics,,76,139,215,8e-06,31
en.wikipedia.org/wiki/Template:Mirzapur_Division_topics,,76,106,182,8e-06,31
en.wikipedia.org/wiki/Template:Moradabad_division_topics,,76,104,180,8e-06,31
en.wikipedia.org/wiki/Template:Allahabad_division_topics,,74,119,193,8e-06,31
en.wikipedia.org/wiki/Template:Saharanpur_division_topics,,76,104,180,8e-06,31
en.wikipedia.org/wiki/Template:Varanasi_division_topics,,76,115,191,8e-06,31
en.wikipedia.org/wiki/Template:BRICS_Universities_League,,40,129,169,7e-06,31
en.wikipedia.org/wiki/Template_talk:BRICS_Universities_League,,40,66,106,7e-06,31
en.wikipedia.org/wiki/Special:EditPage/Template:BRICS_Universities_League,,39,0,39,7e-06,31
isni.org/isni/0000000087020100,,11,0,11,7e-06,31
viaf.org/viaf/126123809,,12,1,13,7e-06,31
d-nb.info/gnd/1020910-4,,12,1,13,7e-06,31
id.loc.gov/authorities/n50075050,,11,0,11,7e-06,31
authority.bibsys.no/authority/rest/authorities/html/90635103,,10,0,10,7e-06,31
nli.org.il/en/authorities/987007322664205171,,10,0,10,7e-06,31
ci.nii.ac.jp/author/DA02749148?l=en,,7,0,7,7e-06,31
lux.collections.yale.edu/view/group/09dc57d3-8de9-453a-9db8-8bd9079c03fd,,6,6,12,7e-06,31
en.wikipedia.org/wiki/Category:IIT_Kanpur,,18,68,86,7e-06,31
en.wikipedia.org/wiki/Category:Engineering_colleges_in_Uttar_Pradesh,,15,78,93,7e-06,31
en.wikipedia.org/wiki/Category:Universities_and_colleges_in_Kanpur,,19,70,89,7e-06,31
en.wikipedia.org/wiki/Category:1959_establishments_in_Uttar_Pradesh,,6,94,100,6e-06,31
foundation.wikimedia.org/wiki/Special:MyLanguage/Policy:Terms_of_Use,,556,0,556,2.1e-05,31
foundation.wikimedia.org/wiki/Special:MyLanguage/Policy:Privacy_policy,,565,0,565,2.1e-05,31
wikimediafoundation.org/,,548,143,691,2e-05,31
en.wikipedia.org/wiki/Wikipedia:General_disclaimer,,547,237,784,2e-05,31
foundation.wikimedia.org/wiki/Special:MyLanguage/Policy:Universal_Code_of_Conduct,,569,0,569,2.1e-05,31
developer.wikimedia.org/,,570,74,644,2.1e-05,31
stats.wikimedia.org/,,569,1,570,2.1e-05,31
foundation.wikimedia.org/wiki/Special:MyLanguage/Policy:Cookie_statement,,569,0,569,2.1e-05,31
en.m.wikipedia.org/w/index.php?title=IIT_Kanpur&mobileaction=toggle_view_mobile,,5,0,5,6e-06,31
wikimedia.org/,,569,38,607,2.1e-05,31
mediawiki.org/,,570,1,571,2.1e-05,31
en.wikipedia.org/w/load.php?lang=en&modules=startup&only=scripts&raw=1&skin=vector-2022,,547,0,547,2e-05,31
en.wikipedia.org/static/images/icons/wikipedia.png,,547,0,547,2e-05,31
en.wikipedia.org/static/images/mobile/copyright/wikipedia-wordmark-en.svg,,547,0,547,2e-05,31
en.wikipedia.org/static/images/mobile/copyright/wikipedia-tagline-en.svg,,547,0,547,2e-05,31
upload.wikimedia.org/wikipedia/en/thumb/a/a3/IIT_Kanpur_Logo.svg/250px-IIT_Kanpur_Logo.svg.png,,6,0,6,7e-06,31
upload.wikimedia.org/wikipedia/en/thumb/4/41/Flag_of_India.svg/40px-Flag_of_India.svg.png,,133,0,133,9e-06,31
upload.wikimedia.org/wikipedia/en/thumb/1/17/Iitk-wordmark.svg/250px-Iitk-wordmark.svg.png,,5,0,5,6e-06,31
upload.wikimedia.org/wikipedia/commons/thumb/7/75/IIT_Kanpur.jpg/250px-IIT_Kanpur.jpg,,9,0,9,7e-06,31
upload.wikimedia.org/wikipedia/commons/thumb/c/c9/IIT_Kanpur_3.jpg/500px-IIT_Kanpur_3.jpg,,5,0,5,6e-06,31
upload.wikimedia.org/wikipedia/commons/thumb/0/03/IITKLibrary.jpg/250px-IITKLibrary.jpg,,9,0,9,7e-06,31
upload.wikimedia.org/wikipedia/commons/thumb/f/fd/IIT_Kanpur_4.jpg/250px-IIT_Kanpur_4.jpg,,9,0,9,7e-06,31
en.wikipedia.org/wiki/Special:CentralAutoLogin/start?type=1x1&usesul3=1,,547,0,547,2e-05,31
en.wikipedia.org/static/images/footer/wikimedia.svg,,547,0,547,2e-05,31
en.wikipedia.org/w/resources/assets/mediawiki_compact.svg,,547,0,547,2e-05,31
en.wikipedia.org/w/load.php?lang=en&modules=site.styles&only=styles&skin=vector-2022,,547,0,547,2e-05,31
economictimes.indiatimes.com/,,1,0,1,1.2e-05,31
ar.wikipedia.org/wiki/ويكيبيديا:اتصل_بنا,,2,0,2,7e-06,31
ar.wikipedia.org/wiki/كانبور,,3,0,3,7e-06,31
ar.wikipedia.org/wiki/تصنيف:تأسيسات_سنة_1959_في_أتر_برديش,,2,0,2,7e-06,31
ar.wikipedia.org/wiki/تصنيف:كليات_الهندسة_في_أتر_برديش,,2,0,2,7e-06,31
ar.wikipedia.org/wiki/ويكيبيديا:إخلاء_مسؤولية_عام,,2,0,2,7e-06,31
bn.wikipedia.org/wiki/সাহায্য:ভূমিকা,,2,0,2,7e-06,31
bn.wikipedia.org/wiki/উইকিপিডিয়া:আপলোড,,2,0,2,7e-06,31
bn.wikipedia.org/wiki/উইকিপিডিয়া:সাধারণ_দাবিত্যাগ,,2,0,2,7e-06,31
de.wikipedia.org/wiki/Wikipedia:Kontakt,,2,0,2,7e-06,31
de.wikipedia.org/wiki/Kanpur,,3,0,3,7e-06,31
commons.wikimedia.org/wiki/Main_Page,,12,0,12,7e-06,31
commons.wikimedia.org/wiki/Commons:Welcome,,11,0,11,7e-06,31
commons.wikimedia.org/wiki/Commons:Contact_us,,3,0,3,7e-06,31
commons.wikimedia.org/wiki/File:IITKLibrary.jpg,,3,0,3,7e-06,31
"commons.wikimedia.org/wiki/File:Samtel_Research_and_Development_Building,_at_IIT_Kanpur.jpg",,2,0,2,7e-06,31
commons.wikimedia.org/wiki/Category:Engineering_colleges_in_Uttar_Pradesh,,2,0,2,7e-06,31
creativecommons.org/publicdomain/zero/1.0/,,4,0,4,7e-06,31
upload.wikimedia.org/wikipedia/commons/thumb/0/03/IITKLibrary.jpg/120px-IITKLibrary.jpg,,2,0,2,7e-06,31
en.wikipedia.org/wiki/File:Question_book-new.svg,,122,0,122,9e-06,31
en.wikipedia.org/wiki/Wikipedia:Verifiability,,148,0,148,9e-06,31
en.wikipedia.org/wiki/Help:Referencing_for_beginners,,118,0,118,9e-06,31
en.wikipedia.org/wiki/Help:Maintenance_template_removal,,156,0,156,9e-06,31
en.wikipedia.org/wiki/Automotive_industry,,4,0,4,7e-06,31
en.wikipedia.org/wiki/Category:All_articles_needing_additional_references,,111,0,111,9e-06,31
en.wikipedia.org/wiki/Category:Official_website_different_in_Wikidata_and_Wikipedia,,43,0,43,7e-06,31
upload.wikimedia.org/wikipedia/en/thumb/9/99/Question_book-new.svg/60px-Question_book-new.svg.png,,123,0,123,9e-06,31
bn.wikipedia.org/wiki/অচ্যুত_কানবিন্দে,,2,0,2,7e-06,31
es.wikipedia.org/wiki/Achyut_Kanvinde,,2,0,2,7e-06,31
en.wikipedia.org/wiki/Wayback_Machine,,151,0,151,8e-06,31
search.worldcat.org/issn/0971-751X,,40,0,40,7e-06,31
en.wikipedia.org/wiki/Sarvagya_Singh_Katiyar,,5,0,5,7e-06,31
en.wikipedia.org/wiki/Category:Webarchive_template_wayback_links,,151,0,151,8e-06,31
en.wikipedia.org/wiki/Category:Short_description_matches_Wikidata,,143,0,143,9e-06,31
en.wikipedia.org/wiki/Category:Use_dmy_dates_from_January_2019,,11,0,11,7e-06,31
en.wikipedia.org/wiki/Category:Use_Indian_English_from_January_2019,,8,0,8,7e-06,31
upload.wikimedia.org/wikipedia/commons/thumb/0/03/IITKLibrary.jpg/330px-IITKLibrary.jpg,,6,0,6,7e-06,31
en.wikipedia.org/wiki/A._P._J._Abdul_Kalam,,18,0,18,7e-06,31
en.wikipedia.org/wiki/Wikipedia:Protection_policy,,43,0,43,7e-06,31
en.wikipedia.org/wiki/Atal_Bihari_Vajpayee,,17,0,17,7e-06,31
en.wikipedia.org/wiki/Defence_Research_and_Development_Organisation,,22,0,22,7e-06,31
en.wikipedia.org/wiki/British_Raj,,40,0,40,7e-06,31
en.wikipedia.org/wiki/Help:IPA/English,,22,0,22,7e-06,31
en.wikipedia.org/wiki/Bharatiya_Janata_Party,,36,0,36,7e-06,31
en.wikipedia.org/wiki/Indian_National_Congress,,32,0,32,7e-06,31
en.wikipedia.org/wiki/States_and_union_territories_of_India,,49,0,49,7e-06,31
en.wikipedia.org/wiki/Hindu,,11,0,11,7e-06,31
en.wikipedia.org/wiki/Muslim,,9,0,9,7e-06,31
en.wikipedia.org/wiki/Samajwadi_Party,,31,0,31,7e-06,31
en.wikipedia.org/wiki/Nationalist_Congress_Party,,3,0,3,6e-06,31
en.wikipedia.org/wiki/Lakshmi_Sahgal,,4,0,4,7e-06,31
en.wikipedia.org/wiki/Uniform_Civil_Code,,2,0,2,6e-06,31
en.wikipedia.org/wiki/Thiruvananthapuram,,12,0,12,7e-06,31
en.wikipedia.org/wiki/Indian_Standard_Time,,54,0,54,8e-06,31
en.wikipedia.org/wiki/Srijan_Pal_Singh,,4,0,4,7e-06,31
en.wikipedia.org/wiki/Madurai,,10,0,10,7e-06,31
en.wikipedia.org/wiki/India_Post,,6,0,6,6e-06,31
en.wikipedia.org/wiki/Outlook_(Indian_magazine),,6,0,6,7e-06,31
en.wikipedia.org/wiki/ABP_News,,2,0,2,6e-06,31
en.wikipedia.org/wiki/The_Indian_Express,,32,0,32,7e-06,31
en.wikipedia.org/wiki/Press_Information_Bureau,,11,0,11,7e-06,31
en.wikipedia.org/wiki/Zee_News,,4,0,4,6e-06,31
en.wikipedia.org/wiki/The_New_York_Times,,27,0,27,7e-06,31
en.wikipedia.org/wiki/The_Pioneer_(India),,12,0,12,7e-06,31
en.wikipedia.org/wiki/File:Wikisource-logo.svg,,34,0,34,7e-06,31
en.wikipedia.org/wiki/Zakir_Husain,,7,0,7,7e-06,31
en.wikipedia.org/wiki/Ram_Nath_Kovind,,11,0,11,7e-06,31
en.wikipedia.org/wiki/File:Flag_of_India.svg,,12,0,12,7e-06,31
en.wikipedia.org/wiki/C._V._Raman,,9,0,9,6e-06,31
en.wikipedia.org/wiki/M._Visvesvaraya,,6,0,6,7e-06,31
en.wikipedia.org/wiki/Govind_Ballabh_Pant,,4,0,4,6e-06,31
en.wikipedia.org/wiki/Zakir_Husain_(politician),,8,0,8,7e-06,31
en.wikipedia.org/wiki/B._R._Ambedkar,,10,0,10,7e-06,31
en.wikipedia.org/wiki/Mahadevi_Varma,,7,0,7,7e-06,31
en.wikipedia.org/wiki/Mulayam_Singh_Yadav,,9,0,9,7e-06,31
en.wikipedia.org/wiki/G._D._Birla,,6,0,6,6e-06,31
en.wikipedia.org/wiki/Portal:India,,61,0,61,7e-06,31
en.wikipedia.org/wiki/Artillery,,7,0,7,7e-06,31
en.wikipedia.org/wiki/Category:Pages_using_the_Phonos_extension,,10,0,10,6e-06,31
en.wikipedia.org/wiki/Category:Use_Indian_English_from_July_2024,,4,0,4,6e-06,31
en.wikipedia.org/wiki/Category:Pages_including_recorded_pronunciations,,8,0,8,6e-06,31
upload.wikimedia.org/wikipedia/commons/thumb/4/4c/Wikisource-logo.svg/40px-Wikisource-logo.svg.png,,21,0,21,7e-06,31
en.wikipedia.org/wiki/Bachelor%27s_degree,,21,0,21,7e-06,31
en.wikipedia.org/wiki/Technology,,18,0,18,7e-06,31
en.wikipedia.org/wiki/Manufacturing,,9,0,9,7e-06,31
en.wikipedia.org/wiki/World_War_I,,16,0,16,7e-06,31
en.wikipedia.org/wiki/Master%27s_degree,,32,0,32,7e-06,31
en.wikipedia.org/wiki/Doctor_of_Philosophy,,29,0,29,7e-06,31
en.wikipedia.org/wiki/Postgraduate_diploma,,9,0,9,7e-06,31
en.wikipedia.org/w/index.php?title=Special:CreateAccount&returnto=Kanpur+Zoological+Park,,2,0,2,6e-06,31
en.wikipedia.org/w/index.php?title=Special:UserLogin&returnto=Kanpur+Zoological+Park,,2,0,2,6e-06,31
de.wikipedia.org/wiki/Kanpur_Zoological_Park,,2,0,2,6e-06,31
hi.wikipedia.org/wiki/कानपुर_प्राणी_उद्यान,,2,0,2,6e-06,31
pa.wikipedia.org/wiki/ਐਲਨ_ਫੋਰੈਸਟ_ਜ਼ੂ,,2,0,2,6e-06,31
wikidata.org/wiki/Special:EntityPage/Q4731647,,2,0,2,6e-06,31
en.wikipedia.org/wiki/Talk:Kanpur_Zoological_Park,,2,0,2,6e-06,31
en.wikipedia.org/w/index.php?title=Kanpur_Zoological_Park&action=edit,,2,0,2,6e-06,31
en.wikipedia.org/w/index.php?title=Kanpur_Zoological_Park&action=history,,2,0,2,6e-06,31
en.wikipedia.org/wiki/Special:WhatLinksHere/Kanpur_Zoological_Park,,2,0,2,6e-06,31
en.wikipedia.org/wiki/Special:RecentChangesLinked/Kanpur_Zoological_Park,,2,0,2,6e-06,31
en.wikipedia.org/w/index.php?title=Kanpur_Zoological_Park&oldid=1304676037,,2,0,2,6e-06,31
en.wikipedia.org/w/index.php?title=Kanpur_Zoological_Park&action=info,,2,0,2,6e-06,31
en.wikipedia.org/w/index.php?title=Kanpur_Zoological_Park&printable=yes,,2,0,2,6e-06,31
commons.wikimedia.org/wiki/Category:Kanpur_Zoo,,2,0,2,6e-06,31
en.wikipedia.org/wiki/Special:EditPage/Kanpur_Zoological_Park,,2,0,2,6e-06,31
"google.com/search?as_eq=wikipedia&q=""Kanpur+Zoological+Park""",,2,0,2,6e-06,31
"google.com/search?tbm=nws&q=""Kanpur+Zoological+Park""+-wikipedia&tbs=ar:1",,2,0,2,6e-06,31
"google.com/search?&q=""Kanpur+Zoological+Park""&tbs=bkt:s&tbm=bks",,2,0,2,6e-06,31
"google.com/search?tbs=bks:1&q=""Kanpur+Zoological+Park""+-wikipedia",,2,0,2,6e-06,31
"scholar.google.com/scholar?q=""Kanpur+Zoological+Park""",,2,0,2,6e-06,31
"jstor.org/action/doBasicSearch?Query=""Kanpur+Zoological+Park""&acc=on&wc=on",,2,0,2,6e-06,31
en.wikipedia.org/wiki/File:Oskanpur-2.jpg,,2,0,2,6e-06,31
en.wikipedia.org/wiki/Central_Zoo_Authority_of_India,,2,0,2,6e-06,31
en.wikipedia.org/wiki/Hindi,,61,0,61,7e-06,31
en.wikipedia.org/wiki/Zoo,,2,0,2,6e-06,31
en.wikipedia.org/wiki/North_India,,43,0,43,7e-06,31
en.wikipedia.org/wiki/Zoological_park,,2,0,2,6e-06,31
en.wikipedia.org/w/index.php?title=Kanpur_Zoological_Park&action=edit&section=1,,2,0,2,6e-06,31
en.wikipedia.org/wiki/Ice_cream,,2,0,2,6e-06,31
en.wikipedia.org/w/index.php?title=Kanpur_Zoological_Park&action=edit&section=2,,2,0,2,6e-06,31
en.wikipedia.org/wiki/Cawnpore,,10,0,10,7e-06,31
en.wikipedia.org/wiki/G._B._Pant_University_of_Agriculture_and_Technology,,2,0,2,6e-06,31
en.wikipedia.org/wiki/File:Dr_Ashwani_Kumar_tripathi_with_Dayang.jpg,,2,0,2,6e-06,31
en.wikipedia.org/wiki/File:Dr_Ashwani_Kumar_Tripathi_with_lion_cubs.jpg,,2,0,2,6e-06,31
en.wikipedia.org/w/index.php?title=Kanpur_Zoological_Park&action=edit&section=3,,2,0,2,6e-06,31
en.wikipedia.org/wiki/File:Oskanpur-1.JPG,,2,0,2,6e-06,31
en.wikipedia.org/wiki/File:Tigress_at_Kanpur_Zoo.JPG,,2,0,2,6e-06,31
en.wikipedia.org/wiki/Leopard,,4,0,4,7e-06,31
en.wikipedia.org/wiki/Hyena,,2,0,2,6e-06,31
en.wikipedia.org/wiki/Asian_black_bear,,2,0,2,6e-06,31
en.wikipedia.org/wiki/Grizzly_bear,,2,0,2,6e-06,31
en.wikipedia.org/wiki/Sloth,,2,0,2,6e-06,31
en.wikipedia.org/wiki/Rhinoceros,,3,0,3,6e-06,31
en.wikipedia.org/wiki/Hippopotamus,,2,0,2,6e-06,31
en.wikipedia.org/wiki/Monkey,,2,0,2,6e-06,31
en.wikipedia.org/wiki/Langur,,2,0,2,6e-06,31
en.wikipedia.org/wiki/Baboon,,2,0,2,6e-06,31
en.wikipedia.org/wiki/Deer,,3,0,3,7e-06,31
en.wikipedia.org/wiki/Zebra,,2,0,2,6e-06,31
en.wikipedia.org/wiki/Antelope,,3,0,3,7e-06,31
en.wikipedia.org/wiki/Common_chimpanzee,,2,0,2,6e-06,31
en.wikipedia.org/wiki/Orangutan,,2,0,2,6e-06,31
en.wikipedia.org/wiki/Reptile,,4,0,4,6e-06,31
en.wikipedia.org/wiki/Indian_gharial,,2,0,2,6e-06,31
en.wikipedia.org/wiki/Asiatic_lions,,2,0,2,6e-06,31
en.wikipedia.org/wiki/File:Leopard_Kanpur_Zoo.JPG,,2,0,2,6e-06,31
en.wikipedia.org/wiki/File:Chhajju_Kanpur_Zoo.JPG,,2,0,2,6e-06,31
en.wikipedia.org/wiki/Chimpanzee,,2,0,2,6e-06,31
en.wikipedia.org/wiki/File:Bird_waiting_for_fish.jpg,,2,0,2,6e-06,31
en.wikipedia.org/wiki/Indian_pond_heron,,2,0,2,6e-06,31
en.wikipedia.org/w/index.php?title=Kanpur_Zoological_Park&action=edit&section=4,,2,0,2,6e-06,31
en.wikipedia.org/w/index.php?title=Kanpur_Zoological_Park&action=edit&section=5,,2,0,2,6e-06,31
en.wikipedia.org/wiki/Botanical,,2,0,2,6e-06,31
en.wikipedia.org/wiki/Forest,,2,0,2,6e-06,31
en.wikipedia.org/wiki/Conservation_movement,,2,0,2,6e-06,31
en.wikipedia.org/wiki/Natural_habitat,,2,0,2,6e-06,31
en.wikipedia.org/wiki/Environmental_issues,,5,0,5,6e-06,31
en.wikipedia.org/wiki/Eco-friendly,,3,0,3,6e-06,31
en.wikipedia.org/wiki/File:Kanpur_zoo_butterfly_park.jpg,,2,0,2,6e-06,31
en.wikipedia.org/w/index.php?title=Kanpur_Zoological_Park&action=edit&section=6,,2,0,2,6e-06,31
en.wikipedia.org/wiki/File:Kanpur_zoo_Lake1.jpg,,2,0,2,6e-06,31
en.wikipedia.org/wiki/File:Kanpur_zoo_lake2.jpg,,2,0,2,6e-06,31
en.wikipedia.org/wiki/File:Kanpur_zoo_lake_3.jpg,,2,0,2,6e-06,31
en.wikipedia.org/wiki/File:Zoo_Lake_4.jpg,,2,0,2,6e-06,31
en.wikipedia.org/wiki/Savanna,,2,0,2,6e-06,31
en.wikipedia.org/wiki/Pied_kingfisher,,2,0,2,6e-06,31
en.wikipedia.org/wiki/Orange-headed_thrush,,2,0,2,6e-06,31
en.wikipedia.org/wiki/Painted_stork,,3,0,3,6e-06,31
en.wikipedia.org/wiki/Little_egret,,2,0,2,6e-06,31
en.wikipedia.org/wiki/Great_cormorant,,2,0,2,6e-06,31
en.wikipedia.org/wiki/Asian_openbill,,2,0,2,6e-06,31
en.wikipedia.org/wiki/Black-headed_ibis,,3,0,3,6e-06,31
en.wikipedia.org/wiki/Lesser_whistling_duck,,3,0,3,6e-06,31
en.wikipedia.org/wiki/Indian_grey_hornbill,,2,0,2,6e-06,31
en.wikipedia.org/w/index.php?title=Kanpur_Zoological_Park&action=edit&section=7,,2,0,2,6e-06,31
en.wikipedia.org/w/index.php?title=Kanpur_Zoological_Park&action=edit&section=8,,2,0,2,6e-06,31
en.wikipedia.org/wiki/Asian_palm_civet,,2,0,2,6e-06,31
en.wikipedia.org/w/index.php?title=Kanpur_Zoological_Park&action=edit&section=9,,2,0,2,6e-06,31
en.wikipedia.org/wiki/File:Kanpur_zoo_aquarium.jpg,,2,0,2,6e-06,31
en.wikipedia.org/w/index.php?title=Kanpur_Zoological_Park&action=edit&section=10,,2,0,2,6e-06,31
en.wikipedia.org/wiki/Sculpture,,6,0,6,7e-06,31
en.wikipedia.org/wiki/Dinosaur,,3,0,3,6e-06,31
en.wikipedia.org/w/index.php?title=Kanpur_Zoological_Park&action=edit&section=11,,2,0,2,6e-06,31
en.wikipedia.org/wiki/File:Kanpur_zoo_Toy_train_station.jpg,,2,0,2,6e-06,31
en.wikipedia.org/wiki/File:Kanpur_zoo_toy_train1.jpg,,2,0,2,6e-06,31
en.wikipedia.org/w/index.php?title=Kanpur_Zoological_Park&action=edit&section=12,,2,0,2,6e-06,31
en.wikipedia.org/wiki/Mortality_rate,,2,0,2,6e-06,31
en.wikipedia.org/wiki/Potassium_permanganate_(medical_use),,2,0,2,6e-06,31
en.wikipedia.org/wiki/Povidone-iodine,,2,0,2,6e-06,31
en.wikipedia.org/w/index.php?title=Rhino_Resource_Centre&action=edit&redlink=1,,2,0,2,6e-06,31
en.wikipedia.org/wiki/World_Wide_Fund_for_Nature,,2,0,2,6e-06,31
en.wikipedia.org/wiki/International_Rhino_Foundation,,2,0,2,6e-06,31
en.wikipedia.org/wiki/Turmeric,,4,0,4,7e-06,31
en.wikipedia.org/wiki/Ayurveda,,6,0,6,7e-06,31
en.wikipedia.org/wiki/Gangrene,,2,0,2,6e-06,31
en.wikipedia.org/wiki/Python_brongersmai,,2,0,2,6e-06,31
en.wikipedia.org/wiki/Muntjac,,3,0,3,6e-06,31
en.wikipedia.org/wiki/Broodiness,,2,0,2,6e-06,31
en.wikipedia.org/wiki/Pheasant,,2,0,2,6e-06,31
en.wikipedia.org/wiki/Incubator_(culture),,2,0,2,6e-06,31
en.wikipedia.org/wiki/Eastern_barn_owl,,2,0,2,6e-06,31
en.wikipedia.org/wiki/Jungle_owlet,,2,0,2,6e-06,31
"en.wikipedia.org/wiki/Wildlife_Protection_Act,_1972",,2,0,2,6e-06,31
en.wikipedia.org/w/index.php?title=Kanpur_Zoological_Park&action=edit&section=13,,2,0,2,6e-06,31
en.wikipedia.org/w/index.php?title=Kanpur_Zoological_Park&action=edit&section=14,,2,0,2,6e-06,31
en.wikipedia.org/wiki/Nawab_Wajid_Ali_Shah_Prani_Udyan,,9,0,9,7e-06,31
en.wikipedia.org/wiki/Shaheed_Ashfaq_Ullah_Khan_Prani_Udyan,,2,0,2,6e-06,31
en.wikipedia.org/w/index.php?title=Kanpur_Zoological_Park&action=edit&section=15,,2,0,2,6e-06,31
web.archive.org/web/20200122230938/http://www.kanpurzoo.org/zoo.php,,2,0,2,6e-06,31
kanpurzoo.org/zoo.php,,2,0,2,6e-06,31
web.archive.org/web/20190606073543/http://www.kanpurzoo.org/zoo.php,,2,0,2,6e-06,31
cza.nic.in/uploads/documents/zoos/zoo-status/english/299.pdf,,2,0,2,6e-06,31
timesofindia.indiatimes.com/city/kanpur/Kanpur-zoo-now-ISO-certifed/articleshow/48369312.cms,,2,0,2,6e-06,31
mapsofindia.com/kanpur/places-of-interest/allen-forest-zoo.html,,2,0,2,6e-06,31
aninews.in/news/national/general-news/kanpur-gets-its-first-butterfly-park201802030739260001/,,2,0,2,6e-06,31
dailypioneer.com/2018/state-editions/hindi-film-anokha-aspatal-screened.html,,2,0,2,6e-06,31
innohealthmagazine.com/issues/kanpur-zoo-adopts-innovative-methods-for-animal-health-management/,,2,0,2,6e-06,31
timesofindia.indiatimes.com/city/kanpur/Bhakti-without-Borders-Bhajans/articleshow/50208678.cms,,2,0,2,6e-06,31
en.wikipedia.org/w/index.php?title=Kanpur_Zoological_Park&action=edit&section=16,,2,0,2,6e-06,31
en.wikipedia.org/wiki/Template:Zoos_of_India,,3,0,3,6e-06,31
en.wikipedia.org/wiki/Template_talk:Zoos_of_India,,3,0,3,6e-06,31
en.wikipedia.org/wiki/Special:EditPage/Template:Zoos_of_India,,3,0,3,6e-06,31
en.wikipedia.org/wiki/List_of_zoos_in_India,,3,0,3,6e-06,31
en.wikipedia.org/wiki/Alipore_Zoo,,3,0,3,6e-06,31
en.wikipedia.org/wiki/Amirthi_Zoological_Park,,3,0,3,6e-06,31
en.wikipedia.org/wiki/Arignar_Anna_Zoological_Park,,5,0,5,7e-06,31
en.wikipedia.org/wiki/Assam_State_Zoo_cum_Botanical_Garden,,3,0,3,6e-06,31
en.wikipedia.org/wiki/Bannerghatta_Biological_Park,,4,0,4,6e-06,31
en.wikipedia.org/wiki/Chennai_Snake_Park,,3,0,3,6e-06,31
en.wikipedia.org/wiki/G._B._Pant_High_Altitude_Zoo,,3,0,3,6e-06,31
en.wikipedia.org/wiki/Gopalpur_Zoo,,3,0,3,6e-06,31
en.wikipedia.org/wiki/Gorewada_Zoo,,3,0,3,6e-06,31
en.wikipedia.org/wiki/Gulab_Bagh_and_Zoo,,3,0,3,6e-06,31
en.wikipedia.org/wiki/Indira_Gandhi_Zoological_Park,,3,0,3,6e-06,31
en.wikipedia.org/wiki/Jaipur_Zoo,,3,0,3,6e-06,31
en.wikipedia.org/wiki/Jawaharlal_Nehru_Biological_Park,,3,0,3,6e-06,31
en.wikipedia.org/wiki/Jijamata_Udyaan,,3,0,3,6e-06,31
en.wikipedia.org/wiki/Kamla_Nehru_Prani_Sangrahalay,,3,0,3,6e-06,31
en.wikipedia.org/wiki/Kurumbapatti_Zoological_Park,,3,0,3,6e-06,31
en.wikipedia.org/wiki/Madras_Crocodile_Bank,,3,0,3,6e-06,31
en.wikipedia.org/wiki/Mahendra_Chaudhary_Zoological_Park,,3,0,3,6e-06,31
en.wikipedia.org/wiki/Marble_Palace_Zoo,,3,0,3,6e-06,31
en.wikipedia.org/wiki/Mysore_Zoo,,3,0,3,6e-06,31
en.wikipedia.org/wiki/Nandankanan_Zoological_Park,,3,0,3,6e-06,31
en.wikipedia.org/wiki/National_Zoological_Park_Delhi,,3,0,3,6e-06,31
en.wikipedia.org/wiki/Nehru_Zoological_Park,,5,0,5,7e-06,31
en.wikipedia.org/wiki/Padmaja_Naidu_Himalayan_Zoological_Park,,3,0,3,6e-06,31
en.wikipedia.org/wiki/Parassinikkadavu_Snake_Park,,3,0,3,6e-06,31
en.wikipedia.org/wiki/Rajiv_Gandhi_Zoological_Park,,3,0,3,6e-06,31
en.wikipedia.org/wiki/Sajjangarh_Biological_Park,,3,0,3,6e-06,31
en.wikipedia.org/wiki/Sakkarbaug_Zoological_Garden,,3,0,3,6e-06,31
en.wikipedia.org/wiki/Sanjay_Gandhi_Jaivik_Udyan,,4,0,4,7e-06,31
en.wikipedia.org/wiki/Sri_Venkateswara_Zoological_Park,,4,0,4,7e-06,31
en.wikipedia.org/wiki/Tata_Steel_Zoological_Park,,3,0,3,6e-06,31
en.wikipedia.org/wiki/Thiruvananthapuram_Zoo,,3,0,3,6e-06,31
en.wikipedia.org/wiki/Thrissur_Zoo,,3,0,3,6e-06,31
en.wikipedia.org/wiki/VOC_park_and_zoo,,3,0,3,6e-06,31
en.wikipedia.org/wiki/Warangal_Zoo,,3,0,3,6e-06,31
en.wikipedia.org/wiki/Tiger_and_Lion_Safari,,4,0,4,7e-06,31
en.wikipedia.org/wiki/List_of_aquaria_in_India,,3,0,3,6e-06,31
en.wikipedia.org/wiki/Bengaluru_Aquarium,,3,0,3,6e-06,31
en.wikipedia.org/wiki/Jagdishchandra_Bose_Aquarium,,3,0,3,6e-06,31
en.wikipedia.org/wiki/Marine_Kingdom,,5,0,5,7e-06,31
en.wikipedia.org/wiki/Taraporewala_Aquarium,,3,0,3,6e-06,31
en.wikipedia.org/wiki/Central_Zoo_Authority,,4,0,4,7e-06,31
en.wikipedia.org/wiki/Indian_Institute_of_Forest_Management,,3,0,3,6e-06,31
en.wikipedia.org/wiki/South_Asian_Zoo_Association_for_Regional_Cooperation,,3,0,3,6e-06,31
en.wikipedia.org/wiki/Wildlife_Institute_of_India,,3,0,3,6e-06,31
en.wikipedia.org/wiki/Zoo_Outreach_Organisation,,3,0,3,6e-06,31
en.wikipedia.org/wiki/List_of_botanical_gardens_in_India,,3,0,3,6e-06,31
en.wikipedia.org/wiki/Protected_areas_of_India,,10,0,10,7e-06,31
en.wikipedia.org/wiki/Tiger_reserves_of_India,,3,0,3,6e-06,31
en.wikipedia.org/wiki/Wildlife_sanctuaries_of_India,,4,0,4,6e-06,31
en.wikipedia.org/wiki/File:Wapiti_from_Wagon_Trails.jpg,,3,0,3,6e-06,31
en.wikipedia.org/wiki/Portal:Animals,,3,0,3,6e-06,31
en.wikipedia.org/wiki/Category:Zoos_in_Uttar_Pradesh,,2,0,2,6e-06,31
en.wikipedia.org/wiki/Category:Tourist_attractions_in_Kanpur,,9,0,9,7e-06,31
en.wikipedia.org/wiki/Category:Botanical_gardens_in_India,,2,0,2,6e-06,31
en.wikipedia.org/wiki/Category:Kanpur_division,,7,0,7,7e-06,31
en.wikipedia.org/wiki/Category:1971_establishments_in_Uttar_Pradesh,,2,0,2,6e-06,31
en.wikipedia.org/wiki/Category:Zoos_established_in_1971,,2,0,2,6e-06,31
en.wikipedia.org/wiki/Category:Articles_needing_additional_references_from_November_2014,,2,0,2,6e-06,31
en.wikipedia.org/wiki/Category:Use_dmy_dates_from_August_2014,,5,0,5,7e-06,31
en.wikipedia.org/wiki/Category:Use_Indian_English_from_August_2014,,7,0,7,7e-06,31
en.wikipedia.org/wiki/Category:Pages_using_infobox_zoo_with_unknown_parameters,,3,0,3,7e-06,31
en.m.wikipedia.org/w/index.php?title=Kanpur_Zoological_Park&mobileaction=toggle_view_mobile,,2,0,2,6e-06,31
upload.wikimedia.org/wikipedia/commons/thumb/d/d0/Oskanpur-2.jpg/250px-Oskanpur-2.jpg,,2,0,2,6e-06,31
upload.wikimedia.org/wikipedia/commons/thumb/1/1b/Oskanpur-1.JPG/250px-Oskanpur-1.JPG,,2,0,2,6e-06,31
upload.wikimedia.org/wikipedia/commons/thumb/6/6e/Kanpur_zoo_Lake1.jpg/250px-Kanpur_zoo_Lake1.jpg,,2,0,2,6e-06,31
upload.wikimedia.org/wikipedia/commons/thumb/4/4f/Kanpur_zoo_lake2.jpg/250px-Kanpur_zoo_lake2.jpg,,2,0,2,6e-06,31
upload.wikimedia.org/wikipedia/commons/thumb/f/f2/Kanpur_zoo_lake_3.jpg/250px-Kanpur_zoo_lake_3.jpg,,2,0,2,6e-06,31
upload.wikimedia.org/wikipedia/commons/thumb/4/46/Zoo_Lake_4.jpg/250px-Zoo_Lake_4.jpg,,2,0,2,6e-06,31
en.wikipedia.org/wiki/Ticker_symbol,,5,0,5,7e-06,31
en.wikipedia.org/wiki/Chairman,,9,0,9,7e-06,31
en.wikipedia.org/wiki/Chief_executive_officer,,9,0,9,7e-06,31
en.wikipedia.org/wiki/Multinational_corporation,,6,0,6,6e-06,31
en.wikipedia.org/wiki/Template:Cite_book,,39,0,39,7e-06,31
en.wikipedia.org/wiki/Help:CS1_errors,,53,0,53,7e-06,31
en.wikipedia.org/wiki/Doi_(identifier),,116,0,116,7e-06,31
en.wikipedia.org/wiki/Category:Pages_with_non-numeric_formatnum_arguments,,12,0,12,7e-06,31
en.wikipedia.org/wiki/Hindustan_Times,,35,0,35,7e-06,31
en.wikipedia.org/wiki/Category:Articles_with_unsourced_statements_from_September_2022,,5,0,5,7e-06,31
en.wikipedia.org/wiki/Volleyball,,10,0,10,7e-06,31
en.wikipedia.org/wiki/Ambedkar_Nagar_district,,39,0,39,7e-06,31
en.wikipedia.org/wiki/Lucknow,,53,0,53,7e-06,31
en.wikipedia.org/wiki/Association_football,,14,0,14,7e-06,31
en.wikipedia.org/wiki/Indian_Railways,,22,0,22,7e-06,31
en.wikipedia.org/wiki/Allahabad_High_Court,,19,0,19,7e-06,31
en.wikipedia.org/wiki/Akhilesh_Yadav,,8,0,8,7e-06,31
en.wikipedia.org/wiki/Lakh,,7,0,7,7e-06,31
en.wikipedia.org/wiki/Government_of_Uttar_Pradesh,,29,0,29,7e-06,31
en.wikipedia.org/wiki/Arjun_Vajpai,,2,0,2,6e-06,31
en.wikipedia.org/wiki/Sourav_Ganguly,,2,0,2,6e-06,31
en.wikipedia.org/wiki/Wikipedia:No_original_research,,22,0,22,7e-06,31
en.wikipedia.org/wiki/Wikipedia:Citing_sources,,68,0,68,8e-06,31
en.wikipedia.org/wiki/Sport,,5,0,5,7e-06,31
en.wikipedia.org/wiki/Category:All_articles_that_may_contain_original_research,,6,0,6,7e-06,31
en.wikipedia.org/wiki/Category:Articles_with_multiple_maintenance_issues,,25,0,25,7e-06,31
upload.wikimedia.org/wikipedia/en/thumb/b/b4/Ambox_important.svg/40px-Ambox_important.svg.png,,53,0,53,8e-06,31
en.wikipedia.org/wiki/Bachelor_of_Technology,,25,0,25,7e-06,31
en.wikipedia.org/wiki/All_India_Council_for_Technical_Education,,23,0,23,7e-06,31
en.wikipedia.org/wiki/Centrally_Funded_Technical_Institutes,,11,0,11,7e-06,31
en.wikipedia.org/wiki/Deemed_university,,29,0,29,7e-06,31
en.wikipedia.org/wiki/Collegiate_university,,13,0,13,7e-06,31
en.wikipedia.org/wiki/Entropy,,7,0,7,7e-06,31
en.wikipedia.org/wiki/Copper,,8,0,8,6e-06,31
en.wikipedia.org/wiki/Alloy,,7,0,7,6e-06,31
en.wikipedia.org/wiki/Bibcode_(identifier),,55,0,55,7e-06,31
en.wikipedia.org/wiki/Category:CS1:_long_volume_value,,14,0,14,7e-06,31
en.wikipedia.org/wiki/Category:All_articles_containing_potentially_dated_statements,,51,0,51,7e-06,31
en.wikipedia.org/wiki/Category:Articles_with_unsourced_statements_from_January_2024,,9,0,9,7e-06,31
en.wikipedia.org/wiki/Sikhism,,14,0,14,7e-06,31
en.wikipedia.org/wiki/File:Wiki_letter_w_cropped.svg,,13,0,13,7e-06,31
en.wikipedia.org/wiki/Category:All_articles_to_be_expanded,,13,0,13,7e-06,31
en.wikipedia.org/w/index.php?title=Special:CreateAccount&returnto=Bhitargaon,,1,0,1,6e-06,31
en.wikipedia.org/w/index.php?title=Special:UserLogin&returnto=Bhitargaon,,1,0,1,6e-06,31
de.wikipedia.org/wiki/Bhitargaon,,1,0,1,6e-06,31
fr.wikipedia.org/wiki/Bhitargaon,,1,0,1,6e-06,31
hi.wikipedia.org/wiki/भीतरगाँव,,1,0,1,6e-06,31
ta.wikipedia.org/wiki/பித்தர்காம்,,1,0,1,6e-06,31
tt.wikipedia.org/wiki/Бхитаргаон,,1,0,1,6e-06,31
th.wikipedia.org/wiki/ภีตรคาว,,1,0,1,6e-06,31
wikidata.org/wiki/Special:EntityPage/Q4901840,,1,0,1,6e-06,31
en.wikipedia.org/wiki/Talk:Bhitargaon,,1,0,1,6e-06,31
en.wikipedia.org/w/index.php?title=Bhitargaon&action=edit,,1,0,1,6e-06,31
en.wikipedia.org/w/index.php?title=Bhitargaon&action=history,,1,0,1,6e-06,31
en.wikipedia.org/wiki/Special:WhatLinksHere/Bhitargaon,,1,0,1,6e-06,31
en.wikipedia.org/wiki/Special:RecentChangesLinked/Bhitargaon,,1,0,1,6e-06,31
en.wikipedia.org/w/index.php?title=Bhitargaon&oldid=1288780934,,1,0,1,6e-06,31
en.wikipedia.org/w/index.php?title=Bhitargaon&action=info,,1,0,1,6e-06,31
en.wikipedia.org/w/index.php?title=Special:DownloadAsPdf&page=Bhitargaon&action=show-download-screen,,1,0,1,6e-06,31
en.wikipedia.org/w/index.php?title=Bhitargaon&printable=yes,,1,0,1,6e-06,31
commons.wikimedia.org/wiki/Category:Bhitargaon,,1,0,1,6e-06,31
geohack.toolforge.org/geohack.php?pagename=Bhitargaon&params=26.210556_N_80.276111_E_type:landmark,,1,0,1,6e-06,31
en.wikipedia.org/wiki/Bitargaon,,1,0,1,6e-06,31
en.wikipedia.org/wiki/File:Gupt_kalin_mandir_bhitargaon_(cropped).jpg,,1,0,1,6e-06,31
en.wikipedia.org/wiki/File:India_Uttar_Pradesh_relief_map.svg,,6,0,6,7e-06,31
en.wikipedia.org/wiki/Common_era,,1,0,1,6e-06,31
en.wikipedia.org/wiki/Town,,4,0,4,7e-06,31
en.wikipedia.org/wiki/City,,3,0,3,6e-06,31
en.wikipedia.org/wiki/Hindu_temple,,6,0,6,7e-06,31
en.wikipedia.org/w/index.php?title=Bhitargaon&action=edit&section=1,,1,0,1,6e-06,31
en.wikipedia.org/wiki/File:Bhitargaon_back.jpg,,1,0,1,6e-06,31
en.wikipedia.org/wiki/Terracotta,,3,0,3,6e-06,31
en.wikipedia.org/wiki/Gupta_period,,2,0,2,6e-06,31
en.wikipedia.org/wiki/Shikhara,,1,0,1,6e-06,31
en.wikipedia.org/wiki/Garbhagriha,,1,0,1,6e-06,31
en.wikipedia.org/wiki/Vishnu,,7,0,7,7e-06,31
en.wikipedia.org/wiki/Alexander_Cunningham,,3,0,3,6e-06,31
en.wikipedia.org/wiki/Ardhamandapa,,1,0,1,6e-06,31
en.wikipedia.org/w/index.php?title=Bhitargaon&action=edit&section=2,,1,0,1,6e-06,31
en.wikipedia.org/wiki/Mahishasuramardini,,1,0,1,6e-06,31
en.wikipedia.org/wiki/Nara-Narayana,,1,0,1,6e-06,31
en.wikipedia.org/w/index.php?title=Bhitargaon&action=edit&section=3,,1,0,1,6e-06,31
en.wikipedia.org/wiki/Special:EditPage/Bhitargaon,,1,0,1,6e-06,31
en.wikipedia.org/wiki/File:Behta_bujurg_temple_(ASI_inscription).jpg,,1,0,1,6e-06,31
en.wikipedia.org/wiki/Archaeological_Survey_of_India,,5,0,5,7e-06,31
en.wikipedia.org/wiki/Jagannath,,1,0,1,6e-06,31
en.wikipedia.org/w/index.php?title=Bhitargaon&action=edit&section=4,,1,0,1,6e-06,31
en.wikipedia.org/wiki/Po_Nagar,,1,0,1,6e-06,31
en.wikipedia.org/wiki/Po_Klong_Garai,,1,0,1,6e-06,31
en.wikipedia.org/wiki/Mahabodhi_Temple,,1,0,1,6e-06,31
id.wikipedia.org/wiki/Candi_Bima,,1,0,1,6e-06,31
en.wikipedia.org/wiki/Sambor_Prei_Kuk,,1,0,1,6e-06,31
"en.wikipedia.org/wiki/Sirpur,_Mahasamund",,1,0,1,6e-06,31
jstor.org/stable/3249898,,1,0,1,6e-06,31
arthistory.upenn.edu/saltrange/george/Kalar.html,,1,0,1,6e-06,31
en.wikipedia.org/w/index.php?title=Bhitargaon&action=edit&section=5,,1,0,1,6e-06,31
"en.wikipedia.org/wiki/File:Lord_Jagannath,_Jagannath_Temple,_Behta_Bujurg,_Uttar_Pradesh,_2023.jpg",,1,0,1,6e-06,31
en.wikipedia.org/wiki/File:Bhitargaon_front.jpg,,1,0,1,6e-06,31
en.wikipedia.org/wiki/File:Brick_temple.jpg,,1,0,1,6e-06,31
en.wikipedia.org/wiki/File:Bhitargaon_details2.jpg,,1,0,1,6e-06,31
en.wikipedia.org/wiki/File:Bhitargaon_details.jpg,,1,0,1,6e-06,31
en.wikipedia.org/wiki/File:Behta_bujurg_temple_complex..jpg,,1,0,1,6e-06,31
en.wikipedia.org/wiki/File:Bhitargaon_temple_.jpg,,1,0,1,6e-06,31
en.wikipedia.org/w/index.php?title=Bhitargaon&action=edit&section=6,,1,0,1,6e-06,31
en.wikipedia.org/wiki/Gwalior,,15,0,15,7e-06,31
en.wikipedia.org/w/index.php?title=Bhitargaon&action=edit&section=7,,1,0,1,6e-06,31
en.wikipedia.org/wiki/Special:BookSources/0140081445,,1,0,1,6e-06,31
books.google.com/books?id=LwcBVvdqyBkC&pg=PA116,,1,0,1,6e-06,31
cse.iitk.ac.in/users/amit/bicycling/bhitargaon/,,1,0,1,6e-06,31
books.google.com/books?id=jh1fF8HvJmMC&pg=PA31&lpg=PA31,,1,0,1,6e-06,31
books.google.com/books?id=36IBkEKlEC8C&pg=PA92&lpg=PA92,,1,0,1,6e-06,31
bl.uk/onlinegallery/onlineex/apac/photocoll/r/019pho000001003u00677000.html,,1,0,1,6e-06,31
en.wikipedia.org/wiki/Special:BookSources/8121506417,,1,0,1,6e-06,31
books.google.com/books?id=pNmfdAKFpkQC&pg=PA60&lpg=PA60,,1,0,1,6e-06,31
books.google.com/books?id=NNcXrBlI9S0C&pg=PA101&lpg=PA101,,1,0,1,6e-06,31
books.google.com/books?id=PvlthkbFU1UC&pg=PA1005&lpg=PA1005,,1,0,1,6e-06,31
en.wikipedia.org/w/index.php?title=Bhitargaon&action=edit&section=8,,1,0,1,6e-06,31
commons.wikimedia.org/wiki/Category:Temple_of_Bhitargaon,,1,0,1,6e-06,31
india9.com/i9show/Bhitargaon-41339.htm,,1,0,1,6e-06,31
en.wikipedia.org/wiki/Template_talk:Kanpur_Nagar_district,,13,0,13,7e-06,31
en.wikipedia.org/wiki/Special:EditPage/Template:Kanpur_Nagar_district,,13,0,13,7e-06,31
en.wikipedia.org/wiki/Choubepur_Kalan,,13,0,13,7e-06,31
en.wikipedia.org/wiki/Northern_Railway_Colony,,13,0,13,7e-06,31
en.wikipedia.org/wiki/Shivrajpur,,14,0,14,7e-06,31
"en.wikipedia.org/wiki/Gajner,_Kanpur",,13,0,13,7e-06,31
en.wikipedia.org/wiki/Karbigwan,,13,0,13,7e-06,31
en.wikipedia.org/wiki/Makanpur,,13,0,13,7e-06,31
en.wikipedia.org/wiki/Agra_district,,40,0,40,7e-06,31
en.wikipedia.org/wiki/Aligarh_district,,39,0,39,7e-06,31
en.wikipedia.org/wiki/Ayodhya_district,,38,0,38,7e-06,31
en.wikipedia.org/wiki/Amethi_district,,38,0,38,7e-06,31
en.wikipedia.org/wiki/Amroha_district,,37,0,37,7e-06,31
en.wikipedia.org/wiki/Azamgarh_district,,37,0,37,7e-06,31
en.wikipedia.org/wiki/Badaun_district,,22,0,22,7e-06,31
en.wikipedia.org/wiki/Bagpat_district,,38,0,38,7e-06,31
en.wikipedia.org/wiki/Bahraich_district,,38,0,38,7e-06,31
en.wikipedia.org/wiki/Ballia_district,,37,0,37,7e-06,31
"en.wikipedia.org/wiki/Balrampur_district,_Uttar_Pradesh",,38,0,38,7e-06,31
en.wikipedia.org/wiki/Banda_district_(India),,34,0,34,7e-06,31
en.wikipedia.org/wiki/Barabanki_district,,38,0,38,7e-06,31
en.wikipedia.org/wiki/Bareilly_district,,41,0,41,7e-06,31
en.wikipedia.org/wiki/Basti_district,,38,0,38,7e-06,31
en.wikipedia.org/wiki/Bhadohi_district,,38,0,38,7e-06,31
en.wikipedia.org/wiki/Bijnor_district,,38,0,38,7e-06,31
en.wikipedia.org/wiki/Bulandshahr_district,,42,0,42,7e-06,31
en.wikipedia.org/wiki/Chandauli_district,,37,0,37,7e-06,31
en.wikipedia.org/wiki/Chitrakoot_district,,37,0,37,7e-06,31
en.wikipedia.org/wiki/Deoria_district,,37,0,37,7e-06,31
en.wikipedia.org/wiki/Etah_district,,39,0,39,7e-06,31
en.wikipedia.org/wiki/Fatehpur_district,,40,0,40,7e-06,31
en.wikipedia.org/wiki/Firozabad_district,,40,0,40,7e-06,31
en.wikipedia.org/wiki/Gautam_Buddha_Nagar_district,,38,0,38,7e-06,31
"en.wikipedia.org/wiki/Ghaziabad_district,_Uttar_Pradesh",,29,0,29,7e-06,31
en.wikipedia.org/wiki/Ghazipur_district,,37,0,37,7e-06,31
en.wikipedia.org/wiki/Gonda_district,,38,0,38,7e-06,31
en.wikipedia.org/wiki/Gorakhpur_district,,37,0,37,7e-06,31
"en.wikipedia.org/wiki/Hamirpur_district,_Uttar_Pradesh",,38,0,38,7e-06,31
en.wikipedia.org/wiki/Hapur_district,,36,0,36,7e-06,31
en.wikipedia.org/wiki/Hardoi_district,,41,0,41,7e-06,31
en.wikipedia.org/wiki/Hathras_district,,39,0,39,7e-06,31
en.wikipedia.org/wiki/Jalaun_district,,38,0,38,7e-06,31
en.wikipedia.org/wiki/Jaunpur_district,,38,0,38,7e-06,31
en.wikipedia.org/wiki/Jhansi_district,,37,0,37,7e-06,31
en.wikipedia.org/wiki/Kasganj_district,,35,0,35,7e-06,31
en.wikipedia.org/wiki/Kaushambi_district,,40,0,40,7e-06,31
en.wikipedia.org/wiki/Kushinagar_district,,37,0,37,7e-06,31
en.wikipedia.org/wiki/Lakhimpur_Kheri_district,,41,0,41,7e-06,31
"en.wikipedia.org/wiki/Lalitpur_district,_India",,33,0,33,7e-06,31
en.wikipedia.org/wiki/Lucknow_district,,40,0,40,7e-06,31
en.wikipedia.org/wiki/Maharajganj_district,,37,0,37,7e-06,31
en.wikipedia.org/wiki/Mahoba_district,,37,0,37,7e-06,31
en.wikipedia.org/wiki/Mainpuri_district,,39,0,39,7e-06,31
en.wikipedia.org/wiki/Mathura_district,,41,0,41,7e-06,31
en.wikipedia.org/wiki/Mau_district,,37,0,37,7e-06,31
en.wikipedia.org/wiki/Meerut_district,,37,0,37,7e-06,31
en.wikipedia.org/wiki/Mirzapur_district,,39,0,39,7e-06,31
en.wikipedia.org/wiki/Moradabad_district,,38,0,38,7e-06,31
en.wikipedia.org/wiki/Muzaffarnagar_district,,39,0,39,7e-06,31
en.wikipedia.org/wiki/Pilibhit_district,,36,0,36,7e-06,31
"en.wikipedia.org/wiki/Pratapgarh_district,_Uttar_Pradesh",,38,0,38,7e-06,31
en.wikipedia.org/wiki/Prayagraj_district,,39,0,39,7e-06,31
en.wikipedia.org/wiki/Raebareli_district,,40,0,40,7e-06,31
en.wikipedia.org/wiki/Rampur_district,,38,0,38,7e-06,31
en.wikipedia.org/wiki/Saharanpur_district,,39,0,39,7e-06,31
en.wikipedia.org/wiki/Sambhal_district,,38,0,38,7e-06,31
en.wikipedia.org/wiki/Sant_Kabir_Nagar_district,,37,0,37,7e-06,31
en.wikipedia.org/wiki/Shahjahanpur_district,,37,0,37,7e-06,31
en.wikipedia.org/wiki/Shamli_district,,38,0,38,7e-06,31
en.wikipedia.org/wiki/Shravasti_district,,37,0,37,7e-06,31
en.wikipedia.org/wiki/Siddharthnagar_district,,38,0,38,7e-06,31
en.wikipedia.org/wiki/Sitapur_district,,41,0,41,7e-06,31
en.wikipedia.org/wiki/Sonbhadra_district,,37,0,37,7e-06,31
en.wikipedia.org/wiki/Sultanpur_district,,38,0,38,7e-06,31
en.wikipedia.org/wiki/Unnao_district,,43,0,43,7e-06,31
en.wikipedia.org/wiki/Varanasi_district,,41,0,41,7e-06,31
en.wikipedia.org/wiki/Template:Hindu_temples_in_Uttar_Pradesh,,3,0,3,6e-06,31
en.wikipedia.org/wiki/Template_talk:Hindu_temples_in_Uttar_Pradesh,,3,0,3,6e-06,31
en.wikipedia.org/wiki/Special:EditPage/Template:Hindu_temples_in_Uttar_Pradesh,,3,0,3,6e-06,31
en.wikipedia.org/wiki/Saharanpur_division,,15,0,15,7e-06,31
en.wikipedia.org/wiki/Shakumbhri_Devi,,3,0,3,6e-06,31
en.wikipedia.org/wiki/Meerut_division,,15,0,15,7e-06,31
en.wikipedia.org/wiki/Belon_Temple,,3,0,3,6e-06,31
en.wikipedia.org/wiki/Sikri_Mata_Temple,,3,0,3,6e-06,31
en.wikipedia.org/wiki/Banke_Bihari_Temple,,5,0,5,7e-06,31
en.wikipedia.org/wiki/Daan-Ghati,,3,0,3,6e-06,31
"en.wikipedia.org/wiki/Dwarkadhish_Temple,_Mathura",,3,0,3,6e-06,31
en.wikipedia.org/wiki/Krishna_Janmasthan_Temple_Complex,,5,0,5,7e-06,31
"en.wikipedia.org/wiki/ISKCON_Temple,_Vrindavan",,3,0,3,6e-06,31
en.wikipedia.org/wiki/Mankameshwar_Temple,,6,0,6,7e-06,31
"en.wikipedia.org/wiki/Prem_Mandir,_Vrindavan",,3,0,3,6e-06,31
en.wikipedia.org/wiki/Vrindavan_Chandrodaya_Temple,,3,0,3,6e-06,31
"en.wikipedia.org/wiki/Radha_Madan_Mohan_Temple,_Vrindavan",,3,0,3,6e-06,31
"en.wikipedia.org/wiki/Radha_Raman_Temple,_Vrindavan",,3,0,3,6e-06,31
en.wikipedia.org/wiki/Gorakhpur_division,,15,0,15,7e-06,31
en.wikipedia.org/wiki/Gorakhnath_Math,,3,0,3,6e-06,31
en.wikipedia.org/wiki/JK_Temple,,7,0,7,7e-06,31
en.wikipedia.org/wiki/Lucknow_division,,17,0,17,7e-06,31
en.wikipedia.org/wiki/Gola_Gokaran_Nath_Temple,,3,0,3,6e-06,31
en.wikipedia.org/wiki/Ayodhya_division,,15,0,15,7e-06,31
en.wikipedia.org/wiki/Hanuman_Garhi_Temple,,3,0,3,6e-06,31
en.wikipedia.org/wiki/Lodi_Baba_Mandir,,3,0,3,6e-06,31
en.wikipedia.org/wiki/Nandmahar_Dham,,3,0,3,6e-06,31
en.wikipedia.org/wiki/Durgan_Dham_Temple,,3,0,3,6e-06,31
en.wikipedia.org/wiki/Mata_Mawai_Dham,,3,0,3,6e-06,31
en.wikipedia.org/wiki/Ulta_Gadha_Dham,,3,0,3,6e-06,31
en.wikipedia.org/wiki/Jhansi_division,,15,0,15,7e-06,31
en.wikipedia.org/wiki/Jarai-ka-Math,,3,0,3,6e-06,31
en.wikipedia.org/wiki/Neelkantheshwar,,3,0,3,6e-06,31
en.wikipedia.org/wiki/Prayagraj_division,,16,0,16,7e-06,31
en.wikipedia.org/wiki/Alopi_Devi_Mandir,,3,0,3,6e-06,31
en.wikipedia.org/wiki/Someshwar_Mahadev_Temple,,3,0,3,6e-06,31
en.wikipedia.org/wiki/Varanasi_division,,19,0,19,7e-06,31
"en.wikipedia.org/wiki/Durga_Mandir,_Ramnagar",,3,0,3,6e-06,31
en.wikipedia.org/wiki/Mirzapur_division,,15,0,15,7e-06,31
en.wikipedia.org/wiki/Vindhyachal,,3,0,3,6e-06,31
wikidata.org/wiki/Q4901840,,1,0,1,6e-06,31
nli.org.il/en/authorities/987007550530705171,,1,0,1,6e-06,31
en.wikipedia.org/wiki/Category:Neighbourhoods_in_Kanpur,,14,0,14,7e-06,31
en.wikipedia.org/wiki/Category:5th-century_Hindu_temples,,1,0,1,6e-06,31
en.wikipedia.org/wiki/Category:Cities_and_towns_in_Kanpur_Nagar_district,,10,0,10,7e-06,31
en.wikipedia.org/wiki/Category:Hindu_temples_in_Uttar_Pradesh,,2,0,2,6e-06,31
en.wikipedia.org/wiki/Category:Gupta_art,,1,0,1,6e-06,31
en.wikipedia.org/wiki/Category:Articles_needing_additional_references_from_April_2024,,1,0,1,6e-06,31
en.m.wikipedia.org/w/index.php?title=Bhitargaon&mobileaction=toggle_view_mobile,,1,0,1,6e-06,31
upload.wikimedia.org/wikipedia/commons/thumb/5/55/Bhitargaon_back.jpg/250px-Bhitargaon_back.jpg,,1,0,1,6e-06,31
upload.wikimedia.org/wikipedia/commons/thumb/1/19/Bhitargaon_front.jpg/250px-Bhitargaon_front.jpg,,1,0,1,6e-06,31
upload.wikimedia.org/wikipedia/commons/thumb/7/7a/Brick_temple.jpg/250px-Brick_temple.jpg,,1,0,1,6e-06,31
en.wikipedia.org/wiki/Biochemistry,,12,0,12,7e-06,31
en.wikipedia.org/wiki/Category:Articles_with_unsourced_statements_from_May_2025,,3,0,3,7e-06,31
en.wikipedia.org/w/index.php?title=Special:CreateAccount&returnto=Bithoor,,1,0,1,6e-06,31
en.wikipedia.org/w/index.php?title=Special:UserLogin&returnto=Bithoor,,1,0,1,6e-06,31
zh-min-nan.wikipedia.org/wiki/Bithoor,,1,0,1,6e-06,31
bh.wikipedia.org/wiki/बिठूर,,1,0,1,6e-06,31
ceb.wikipedia.org/wiki/Bithūr,,1,0,1,6e-06,31
es.wikipedia.org/wiki/Bithoor,,1,0,1,6e-06,31
fr.wikipedia.org/wiki/Bithur,,1,0,1,6e-06,31
hi.wikipedia.org/wiki/बिठूर,,1,0,1,6e-06,31
bpy.wikipedia.org/wiki/বিথোর,,1,0,1,6e-06,31
it.wikipedia.org/wiki/Bithur,,1,0,1,6e-06,31
kn.wikipedia.org/wiki/ಬೈಥೂರು,,1,0,1,6e-06,31
mg.wikipedia.org/wiki/Bithoor,,1,0,1,6e-06,31
mr.wikipedia.org/wiki/बिठूर,,1,0,1,6e-06,31
ms.wikipedia.org/wiki/Bithoor,,1,0,1,6e-06,31
nl.wikipedia.org/wiki/Bithoor,,1,0,1,6e-06,31
new.wikipedia.org/wiki/विथूर,,1,0,1,6e-06,31
ja.wikipedia.org/wiki/ビトゥール,,1,0,1,6e-06,31
pa.wikipedia.org/wiki/ਬਿਠੂਰ,,1,0,1,6e-06,31
pl.wikipedia.org/wiki/Bithoor,,1,0,1,6e-06,31
sr.wikipedia.org/wiki/Битур,,1,0,1,6e-06,31
sv.wikipedia.org/wiki/Bithūr,,1,0,1,6e-06,31
ta.wikipedia.org/wiki/பித்தூர்,,1,0,1,6e-06,31
ur.wikipedia.org/wiki/بٹھور,,1,0,1,6e-06,31
vi.wikipedia.org/wiki/Bithoor,,1,0,1,6e-06,31
zh.wikipedia.org/wiki/比托奥尔,,1,0,1,6e-06,31
wikidata.org/wiki/Special:EntityPage/Q861837,,1,0,1,6e-06,31
en.wikipedia.org/wiki/Talk:Bithoor,,1,0,1,6e-06,31
en.wikipedia.org/w/index.php?title=Bithoor&action=edit,,1,0,1,6e-06,31
en.wikipedia.org/w/index.php?title=Bithoor&action=history,,1,0,1,6e-06,31
en.wikipedia.org/wiki/Special:WhatLinksHere/Bithoor,,1,0,1,6e-06,31
en.wikipedia.org/wiki/Special:RecentChangesLinked/Bithoor,,1,0,1,6e-06,31
en.wikipedia.org/w/index.php?title=Bithoor&oldid=1285012903,,1,0,1,6e-06,31
en.wikipedia.org/w/index.php?title=Bithoor&action=info,,1,0,1,6e-06,31
en.wikipedia.org/w/index.php?title=Special:DownloadAsPdf&page=Bithoor&action=show-download-screen,,1,0,1,6e-06,31
en.wikipedia.org/w/index.php?title=Bithoor&printable=yes,,1,0,1,6e-06,31
commons.wikimedia.org/wiki/Category:Bithoor,,1,0,1,6e-06,31
en.wikipedia.org/wiki/File:1167_main-ghat-at-bithoor.jpg,,1,0,1,6e-06,31
en.wikipedia.org/wiki/Shivaratri,,1,0,1,6e-06,31
en.wikipedia.org/wiki/File:India_Uttar_Pradesh_location_map.svg,,51,0,51,8e-06,31
en.wikipedia.org/wiki/States_and_territories_of_India,,44,0,44,8e-06,31
en.wikipedia.org/wiki/List_of_districts_of_India,,39,0,39,8e-06,31
en.wikipedia.org/wiki/Kanpur_Nagar,,8,0,8,7e-06,31
en.wikipedia.org/wiki/Local_government,,1,0,1,6e-06,31
en.wikipedia.org/wiki/Time_zone,,55,0,55,8e-06,31
en.wikipedia.org/wiki/UTC%2B5:30,,42,0,42,8e-06,31
en.wikipedia.org/wiki/Vehicle_registration_plate,,36,0,36,8e-06,31
bithoornp.in/Dynamic/WebControlPanel/English/index.aspx,,1,0,1,6e-06,31
en.wikipedia.org/wiki/War_of_Independence_of_1857,,1,0,1,6e-06,31
en.wikipedia.org/wiki/Nana_Sahib,,9,0,9,7e-06,31
en.wikipedia.org/w/index.php?title=Bithoor&action=edit&section=1,,1,0,1,6e-06,31
en.wikipedia.org/wiki/File:Nana_Sahib_Memorial.JPG,,1,0,1,6e-06,31
en.wikipedia.org/wiki/File:Bithoor_013.jpg,,1,0,1,6e-06,31
en.wikipedia.org/wiki/File:Bithoor_024.jpg,,1,0,1,6e-06,31
en.wikipedia.org/wiki/Baji_Rao_II,,3,0,3,7e-06,31
en.wikipedia.org/wiki/Ain-i_Akbari,,2,0,2,6e-06,31
en.wikipedia.org/wiki/Mahallah,,2,0,2,6e-06,31
en.wikipedia.org/wiki/Sarkar_(administrative_division),,2,0,2,6e-06,31
en.wikipedia.org/wiki/Dam_(Indian_coin),,2,0,2,6e-06,31
en.wikipedia.org/wiki/Indian_Rebellion_of_1857,,28,0,28,7e-06,31
en.wikipedia.org/wiki/Rani_Lakshmibai,,6,0,6,7e-06,31
en.wikipedia.org/wiki/United_Provinces_of_Agra_and_Oudh,,17,0,17,7e-06,31
en.wikipedia.org/wiki/Henry_Havelock,,4,0,4,6e-06,31
en.wikipedia.org/wiki/United_Kingdom_of_Great_Britain_and_Ireland,,3,0,3,6e-06,31
en.wikipedia.org/w/index.php?title=Bithoor&action=edit&section=2,,1,0,1,6e-06,31
en.wikipedia.org/wiki/Census,,15,0,15,7e-06,31
en.wikipedia.org/wiki/Balaji_Baji_Rao,,1,0,1,6e-06,31
en.wikipedia.org/w/index.php?title=Bithoor&action=edit&section=3,,1,0,1,6e-06,31
"en.wikipedia.org/wiki/File:Siddhidham_ashram,_Bithoor.jpg",,1,0,1,6e-06,31
en.wikipedia.org/w/index.php?title=Bithoor&action=edit&section=4,,1,0,1,6e-06,31
en.wikipedia.org/wiki/Kanpur_City_Transport_Services_Limited,,2,0,2,6e-06,31
en.wikipedia.org/w/index.php?title=Bithoor&action=edit&section=5,,1,0,1,6e-06,31
en.wikipedia.org/wiki/Sultan_(2016_film),,1,0,1,6e-06,31
en.wikipedia.org/wiki/Salman_Khan,,1,0,1,6e-06,31
en.wikipedia.org/w/index.php?title=Bithoor&action=edit&section=6,,1,0,1,6e-06,31
en.wikipedia.org/w/index.php?title=Bithoor&action=edit&section=7,,1,0,1,6e-06,31
en.wikipedia.org/wiki/Abu%27l-Fazl_ibn_Mubarak,,2,0,2,6e-06,31
archive.org/details/ainiakbarivolum00mubgoog,,2,0,2,6e-06,31
books.google.com/books?id=9fovAQAAIAAJ,,1,0,1,6e-06,31
en.wikipedia.org/wiki/Special:BookSources/978-81-7041-859-7,,2,0,2,6e-06,31
en.wikipedia.org/wiki/Public_domain,,6,0,6,7e-06,31
en.wikipedia.org/wiki/Hugh_Chisholm,,3,0,3,6e-06,31
en.wikisource.org/wiki/1911_Encyclopædia_Britannica/Bithur,,2,0,2,6e-06,31
en.wikipedia.org/wiki/Encyclopædia_Britannica_Eleventh_Edition,,13,0,13,7e-06,31
books.google.com/books?id=QTZAAAAAMAAJ,,2,0,2,6e-06,31
search.worldcat.org/oclc/1077615,,2,0,2,6e-06,31
national-army-museum.ac.uk/exhibitions/indiaRising/page10.shtml,,1,0,1,6e-06,31
web.archive.org/web/20040616075334/http://www.censusindia.net/results/town.php?stad=A&state5=999,,11,0,11,7e-06,31
censusindia.net/results/town.php?stad=A&state5=999,,11,0,11,7e-06,31
census2011.co.in/data/town/801004-bithoor-uttar-pradesh.html,,1,0,1,6e-06,31
talkingmoviez.com/official-salmans-sultan-to-be-shot-in-bithoor-village-kanpur-up/,,1,0,1,6e-06,31
web.archive.org/web/20160425170135/http://www.boxofficecollection.info/movie-2016,,1,0,1,6e-06,31
boxofficecollection.info/movie-2016,,1,0,1,6e-06,31
en.wikipedia.org/w/index.php?title=Bithoor&action=edit&section=8,,1,0,1,6e-06,31
en.wikipedia.org/wiki/Araul,,1,0,1,6e-06,31
en.wikipedia.org/wiki/Category:History_of_Kanpur,,5,0,5,7e-06,31
en.wikipedia.org/wiki/Category:Parganas_of_sarkar_Kannauj_listed_in_the_Ain-i-Akbari,,2,0,2,6e-06,31
en.wikipedia.org/wiki/Category:Use_dmy_dates_from_October_2018,,8,0,8,7e-06,31
en.wikipedia.org/wiki/Category:Use_Indian_English_from_October_2018,,8,0,8,7e-06,31
en.wikipedia.org/wiki/Category:Articles_containing_potentially_dated_statements_from_2001,,9,0,9,7e-06,31
en.wikipedia.org/wiki/Category:Wikipedia_articles_in_need_of_updating_from_October_2018,,1,0,1,6e-06,31
en.m.wikipedia.org/w/index.php?title=Bithoor&mobileaction=toggle_view_mobile,,1,0,1,6e-06,31
upload.wikimedia.org/wikipedia/commons/thumb/0/0c/Red_pog.svg/20px-Red_pog.svg.png,,62,0,62,8e-06,31
upload.wikimedia.org/wikipedia/commons/thumb/e/e3/Bithoor_013.jpg/250px-Bithoor_013.jpg,,1,0,1,6e-06,31
upload.wikimedia.org/wikipedia/commons/thumb/5/56/Bithoor_024.jpg/250px-Bithoor_024.jpg,,1,0,1,6e-06,31
upload.wikimedia.org/wikipedia/commons/d/de/Siddhidham_ashram%2C_Bithoor.jpg,,1,0,1,6e-06,31
upload.wikimedia.org/wikipedia/commons/thumb/4/4c/Wikisource-logo.svg/20px-Wikisource-logo.svg.png,,16,0,16,7e-06,31
en.wikipedia.org/w/index.php?title=Special:CreateAccount&returnto=British+India+Corporation,,1,0,1,6e-06,31
en.wikipedia.org/w/index.php?title=Special:UserLogin&returnto=British+India+Corporation,,1,0,1,6e-06,31
wikidata.org/wiki/Special:EntityPage/Q4970091,,1,0,1,6e-06,31
en.wikipedia.org/wiki/Talk:British_India_Corporation,,1,0,1,6e-06,31
en.wikipedia.org/w/index.php?title=British_India_Corporation&action=edit,,1,0,1,6e-06,31
en.wikipedia.org/w/index.php?title=British_India_Corporation&action=history,,1,0,1,6e-06,31
en.wikipedia.org/wiki/Special:WhatLinksHere/British_India_Corporation,,1,0,1,6e-06,31
en.wikipedia.org/wiki/Special:RecentChangesLinked/British_India_Corporation,,1,0,1,6e-06,31
en.wikipedia.org/w/index.php?title=British_India_Corporation&oldid=1283227820,,1,0,1,6e-06,31
en.wikipedia.org/w/index.php?title=British_India_Corporation&action=info,,1,0,1,6e-06,31
en.wikipedia.org/w/index.php?title=British_India_Corporation&printable=yes,,1,0,1,6e-06,31
en.wikipedia.org/wiki/Public_Sector_Undertaking,,1,0,1,6e-06,31
en.wikipedia.org/wiki/Indian_army,,1,0,1,6e-06,31
en.wikipedia.org/wiki/Sir_Alexander_MacRobert,,1,0,1,6e-06,31
"en.wikipedia.org/wiki/Rachel,_Lady_MacRobert",,1,0,1,6e-06,31
en.wikipedia.org/wiki/Registrar_of_Companies_(India),,1,0,1,6e-06,31
"en.wikipedia.org/wiki/Dhariwal,_India",,1,0,1,6e-06,31
en.wikipedia.org/wiki/File:LalImli.JPG,,3,0,3,7e-06,31
en.wikipedia.org/w/index.php?title=British_India_Corporation&action=edit&section=1,,1,0,1,6e-06,31
financialexpress.com/news/up-govt-unveils-revival-package-for-british-india-corporation/71834/,,1,0,1,6e-06,31
zaubacorp.com/company/BRITISH-INDIA-CORPORATION-LIMITED/U17117UP1920GOI000162,,1,0,1,6e-06,31
uk.reuters.com/article/uk-india-industry-zombies-idUKKCN0I10X920141012,,1,0,1,6e-06,31
web.archive.org/web/20110716110342/http://dpe.nic.in/survey0506/vol3/219.pdf,,1,0,1,6e-06,31
dpe.nic.in/survey0506/vol3/219.pdf,,1,0,1,6e-06,31
web.archive.org/web/20090619091654/http://texmin.nic.in/note_on_bic_ntc_section.pdf,,1,0,1,6e-06,31
texmin.nic.in/tex_08.htm,,1,0,1,6e-06,31
yugantarpravah.com/news/kanpurs-lal-imli-is-now-in-the-pages-of-history-132357-26-04-2023,,1,0,1,6e-06,31
en.wikipedia.org/wiki/Special:BookSources/978-1-909238-09-1,,1,0,1,6e-06,31
en.wikipedia.org/wiki/Wikipedia:Stub,,47,0,47,8e-06,31
en.wikipedia.org/wiki/Template:India-company-stub,,2,0,2,7e-06,31
en.wikipedia.org/wiki/Template_talk:India-company-stub,,2,0,2,7e-06,31
en.wikipedia.org/wiki/Special:EditPage/Template:India-company-stub,,2,0,2,7e-06,31
en.wikipedia.org/wiki/Category:Companies_based_in_Kanpur,,7,0,7,7e-06,31
en.wikipedia.org/wiki/Category:Companies_nationalised_by_the_Government_of_India,,1,0,1,6e-06,31
en.wikipedia.org/wiki/Category:Companies_established_in_1872,,1,0,1,6e-06,31
en.wikipedia.org/wiki/Category:Indian_companies_established_in_1876,,1,0,1,6e-06,31
en.wikipedia.org/wiki/Category:Indian_companies_established_in_1920,,1,0,1,6e-06,31
en.wikipedia.org/wiki/Category:Manufacturing_companies_established_in_1920,,1,0,1,6e-06,31
en.wikipedia.org/wiki/Category:Indian_company_stubs,,2,0,2,7e-06,31
en.wikipedia.org/wiki/Category:Use_dmy_dates_from_March_2025,,10,0,10,7e-06,31
en.wikipedia.org/wiki/Category:All_stub_articles,,47,0,47,8e-06,31
en.m.wikipedia.org/w/index.php?title=British_India_Corporation&mobileaction=toggle_view_mobile,,1,0,1,6e-06,31
upload.wikimedia.org/wikipedia/commons/thumb/1/11/LalImli.JPG/250px-LalImli.JPG,,3,0,3,7e-06,31
upload.wikimedia.org/wikipedia/en/thumb/4/41/Flag_of_India.svg/20px-Flag_of_India.svg.png,,5,0,5,7e-06,31
upload.wikimedia.org/wikipedia/commons/thumb/a/a2/Factory.svg/20px-Factory.svg.png,,2,0,2,7e-06,31
en.wikipedia.org/wiki/Private_university,,41,0,41,7e-06,31
en.wikipedia.org/wiki/Higher_education_accreditation,,20,0,20,7e-06,31
en.wikipedia.org/wiki/Nobel_Prize,,23,0,23,7e-06,31
en.wikipedia.org/wiki/Electrical_Engineering,,19,0,19,7e-06,31
en.wikipedia.org/wiki/Master_of_Business_Administration,,23,0,23,7e-06,31
en.wikipedia.org/wiki/Massachusetts_Institute_of_Technology,,39,0,39,7e-06,31
en.wikipedia.org/wiki/Microsoft,,21,0,21,7e-06,31
en.wikipedia.org/wiki/Rand_Corporation,,5,0,5,6e-06,31
en.wikipedia.org/wiki/Business_incubator,,8,0,8,7e-06,31
en.wikipedia.org/wiki/Basketball,,9,0,9,7e-06,31
en.wikipedia.org/wiki/Wikisource,,10,0,10,7e-06,31
en.wikipedia.org/wiki/Michigan_State_University,,13,0,13,7e-06,31
en.wikipedia.org/wiki/Category:Pages_using_multiple_image_with_auto_scaled_images,,22,0,22,7e-06,31
en.wikipedia.org/w/index.php?title=Special:CreateAccount&returnto=Category%3AEducation+in+Kanpur,,1,0,1,7e-06,31
en.wikipedia.org/w/index.php?title=Special:UserLogin&returnto=Category%3AEducation+in+Kanpur,,1,0,1,7e-06,31
ar.wikipedia.org/wiki/تصنيف:التعليم_في_كانبور,,1,0,1,7e-06,31
wikidata.org/wiki/Special:EntityPage/Q8403918,,1,0,1,7e-06,31
en.wikipedia.org/wiki/Category_talk:Education_in_Kanpur,,1,0,1,7e-06,31
en.wikipedia.org/w/index.php?title=Category:Education_in_Kanpur&action=edit,,1,0,1,7e-06,31
en.wikipedia.org/w/index.php?title=Category:Education_in_Kanpur&action=history,,1,0,1,7e-06,31
en.wikipedia.org/wiki/Special:WhatLinksHere/Category:Education_in_Kanpur,,1,0,1,7e-06,31
en.wikipedia.org/wiki/Special:RecentChangesLinked/Category:Education_in_Kanpur,,1,0,1,7e-06,31
en.wikipedia.org/w/index.php?title=Category:Education_in_Kanpur&oldid=1227023233,,1,0,1,7e-06,31
en.wikipedia.org/w/index.php?title=Category:Education_in_Kanpur&action=info,,1,0,1,7e-06,31
en.wikipedia.org/w/index.php?title=Category:Education_in_Kanpur&printable=yes,,1,0,1,7e-06,31
en.wikipedia.org/wiki/Help:Categories,,8,0,8,7e-06,31
en.wikipedia.org/wiki/Education_in_Kanpur,,1,0,1,7e-06,31
en.wikipedia.org/wiki/Category:Schools_in_Kanpur,,1,0,1,7e-06,31
en.wikipedia.org/wiki/Wikipedia:FAQ/Categorization,,41,0,41,8e-06,31
en.wikipedia.org/wiki/List_of_educational_institutions_in_Kanpur,,4,0,4,7e-06,31
en.wikipedia.org/wiki/Indian_Institute_of_Pulses_Research,,2,0,2,7e-06,31
en.wikipedia.org/wiki/Category:Education_in_Uttar_Pradesh_by_populated_place,,1,0,1,7e-06,31
en.wikipedia.org/wiki/Category:Kanpur,,11,0,11,7e-06,31
en.m.wikipedia.org/w/index.php?title=Category:Education_in_Kanpur&mobileaction=toggle_view_mobile,,1,0,1,7e-06,31
en.wikipedia.org/wiki/Research_and_development,,12,0,12,7e-06,31
en.wikipedia.org/wiki/Chancellor_(education),,35,0,35,7e-06,31
en.wikipedia.org/wiki/Typhoid,,3,0,3,6e-06,31
en.wikipedia.org/wiki/JSTOR_(identifier),,49,0,49,7e-06,31
en.wikipedia.org/wiki/University_of_Houston,,7,0,7,7e-06,31
en.wikipedia.org/wiki/Category:CS1_errors:_ISBN_date,,20,0,20,7e-06,31
upload.wikimedia.org/wikipedia/commons/thumb/e/ed/Decrease2.svg/20px-Decrease2.svg.png,,18,0,18,7e-06,31
en.wikipedia.org/wiki/Massive_open_online_course,,5,0,5,6e-06,31
en.wikipedia.org/wiki/Board_of_directors,,9,0,9,7e-06,31
en.wikipedia.org/wiki/Russia,,22,0,22,7e-06,31
en.wikipedia.org/wiki/Category:Articles_containing_potentially_dated_statements_from_2011,,7,0,7,7e-06,31
en.wikipedia.org/w/index.php?title=Special:CreateAccount&returnto=Chakeri,,1,0,1,6e-06,31
en.wikipedia.org/w/index.php?title=Special:UserLogin&returnto=Chakeri,,1,0,1,6e-06,31
zh-min-nan.wikipedia.org/wiki/Chakeri,,1,0,1,6e-06,31
es.wikipedia.org/wiki/Chakeri,,1,0,1,6e-06,31
hi.wikipedia.org/wiki/चकेरी,,1,0,1,6e-06,31
bpy.wikipedia.org/wiki/চকেরি,,1,0,1,6e-06,31
it.wikipedia.org/wiki/Chakeri,,1,0,1,6e-06,31
mg.wikipedia.org/wiki/Chakeri,,1,0,1,6e-06,31
ms.wikipedia.org/wiki/Chakeri,,1,0,1,6e-06,31
nl.wikipedia.org/wiki/Chakeri,,1,0,1,6e-06,31
new.wikipedia.org/wiki/चकेरी,,1,0,1,6e-06,31
pl.wikipedia.org/wiki/Chakeri,,1,0,1,6e-06,31
pt.wikipedia.org/wiki/Chakeri,,1,0,1,6e-06,31
ta.wikipedia.org/wiki/சாகேரி,,1,0,1,6e-06,31
ur.wikipedia.org/wiki/چکیری,,1,0,1,6e-06,31
vi.wikipedia.org/wiki/Chakeri,,1,0,1,6e-06,31
zh.wikipedia.org/wiki/恰凯里,,1,0,1,6e-06,31
wikidata.org/wiki/Special:EntityPage/Q859127,,1,0,1,6e-06,31
en.wikipedia.org/wiki/Talk:Chakeri,,1,0,1,6e-06,31
en.wikipedia.org/w/index.php?title=Chakeri&action=edit,,1,0,1,6e-06,31
en.wikipedia.org/w/index.php?title=Chakeri&action=history,,1,0,1,6e-06,31
en.wikipedia.org/wiki/Special:WhatLinksHere/Chakeri,,1,0,1,6e-06,31
en.wikipedia.org/wiki/Special:RecentChangesLinked/Chakeri,,1,0,1,6e-06,31
en.wikipedia.org/w/index.php?title=Chakeri&oldid=1300605924,,1,0,1,6e-06,31
en.wikipedia.org/w/index.php?title=Chakeri&action=info,,1,0,1,6e-06,31
en.wikipedia.org/w/index.php?title=Special:DownloadAsPdf&page=Chakeri&action=show-download-screen,,1,0,1,6e-06,31
en.wikipedia.org/w/index.php?title=Chakeri&printable=yes,,1,0,1,6e-06,31
"en.wikipedia.org/wiki/Chakeri,_Iran_(disambiguation)",,1,0,1,6e-06,31
en.wikipedia.org/wiki/File:Chakeri_railway_station_nameplate.JPG,,1,0,1,6e-06,31
en.wikipedia.org/wiki/Chakeri_railway_station,,9,0,9,7e-06,31
en.wikipedia.org/wiki/File:India_location_map_3.png,,20,0,20,7e-06,31
en.wikipedia.org/wiki/Hindi_language,,47,0,47,8e-06,31
en.wikipedia.org/wiki/Postal_Index_Number,,26,0,26,7e-06,31
en.wikipedia.org/wiki/Lok_Sabha,,67,0,67,8e-06,31
en.wikipedia.org/wiki/Vidhan_Sabha,,25,0,25,7e-06,31
"en.wikipedia.org/wiki/Maharajpur,_Kanpur",,3,0,3,6e-06,31
en.wikipedia.org/w/index.php?title=Chakeri&action=edit&section=1,,1,0,1,6e-06,31
en.wikipedia.org/w/index.php?title=Female_Sex_Ratio&action=edit&redlink=1,,1,0,1,6e-06,31
en.wikipedia.org/w/index.php?title=Chakeri&action=edit&section=2,,1,0,1,6e-06,31
en.wikipedia.org/wiki/Yayati,,1,0,1,6e-06,31
en.wikipedia.org/w/index.php?title=Chakeri&action=edit&section=3,,1,0,1,6e-06,31
en.wikipedia.org/w/index.php?title=Chakeri&action=edit&section=4,,1,0,1,6e-06,31
en.wikipedia.org/w/index.php?title=Chakeri&action=edit&section=5,,1,0,1,6e-06,31
en.wikipedia.org/w/index.php?title=Chakeri&action=edit&section=6,,1,0,1,6e-06,31
en.wikipedia.org/wiki/Delhi,,70,0,70,7e-06,31
en.wikipedia.org/w/index.php?title=Chakeri&action=edit&section=7,,1,0,1,6e-06,31
en.wikipedia.org/wiki/Kanpur_Central,,16,0,16,7e-06,31
en.wikipedia.org/w/index.php?title=Chakeri&action=edit&section=8,,1,0,1,6e-06,31
en.wikipedia.org/w/index.php?title=Chakeri&action=edit&section=9,,1,0,1,6e-06,31
en.wikipedia.org/wiki/Sriprakash_Jaiswal,,3,0,3,6e-06,31
en.wikipedia.org/wiki/Satish_Mahana,,5,0,5,7e-06,31
en.wikipedia.org/wiki/Ghazala_Lari,,1,0,1,6e-06,31
en.wikipedia.org/wiki/Kritika_Kamra,,1,0,1,6e-06,31
en.wikipedia.org/wiki/Poonam_Dhillon,,1,0,1,6e-06,31
en.wikipedia.org/wiki/Kuldeep_Yadav,,3,0,3,6e-06,31
en.wikipedia.org/w/index.php?title=Chakeri&action=edit&section=10,,1,0,1,6e-06,31
en.wikipedia.org/w/index.php?title=Chakeri&action=edit&section=,,1,0,1,6e-06,31
en.wikipedia.org/w/index.php?title=Chakeri&action=edit&section=11,,1,0,1,6e-06,31
census2011.co.in/data/town/150571-chakeri-uttar-pradesh.html,,1,0,1,6e-06,31
rataniti.com/,,1,0,1,6e-06,31
indiantollways.com/2010/11/09/etawah-chakeri-section-to-be-six-laned/,,1,0,1,6e-06,31
en.wikipedia.org/wiki/Category:Use_dmy_dates_from_June_2018,,13,0,13,7e-06,31
en.wikipedia.org/wiki/Category:Use_Indian_English_from_June_2018,,12,0,12,7e-06,31
en.wikipedia.org/wiki/Category:Wikipedia_articles_in_need_of_updating_from_September_2023,,1,0,1,6e-06,31
en.wikipedia.org/wiki/Category:Articles_to_be_expanded_from_June_2020,,1,0,1,6e-06,31
en.wikipedia.org/wiki/Category:Articles_with_empty_sections_from_June_2020,,1,0,1,6e-06,31
en.m.wikipedia.org/w/index.php?title=Chakeri&mobileaction=toggle_view_mobile,,1,0,1,6e-06,31
en.wikipedia.org/wiki/Majority,,18,0,18,7e-06,31
hi.wikipedia.org/wiki/चन्द्र_शेखर_आजाद_कृषि_एवं_प्रौद्योगिकी_विश्वविद्यालय,,2,0,2,6e-06,31
wikidata.org/wiki/Special:EntityPage/Q5071310,,2,0,2,6e-06,31
en.wikipedia.org/wiki/Talk:Chandra_Shekhar_Azad_University_of_Agriculture_and_Technology,,2,0,2,6e-06,31
en.wikipedia.org/wiki/Special:EditPage/Chandra_Shekhar_Azad_University_of_Agriculture_and_Technology,,2,0,2,6e-06,31
"google.com/search?as_eq=wikipedia&q=""Chandra+Shekhar+Azad+University+of+Agriculture+and+Technology""",,2,0,2,6e-06,31
"scholar.google.com/scholar?q=""Chandra+Shekhar+Azad+University+of+Agriculture+and+Technology""",,2,0,2,6e-06,31
en.wikipedia.org/wiki/File:Chandra_Shekhar_Azad_University_of_Agriculture_and_Technology_logo.png,,2,0,2,6e-06,31
en.wikipedia.org/wiki/State_university_(India),,22,0,22,7e-06,31
en.wikipedia.org/wiki/National_Assessment_and_Accreditation_Council,,17,0,17,7e-06,31
en.wikipedia.org/wiki/Governor_of_Uttar_Pradesh,,10,0,10,7e-06,31
en.wikipedia.org/wiki/Vice-Chancellor,,30,0,30,7e-06,31
en.wikipedia.org/wiki/Urban_areas,,8,0,8,7e-06,31
en.wikipedia.org/wiki/University_Grants_Commission_(India),,33,0,33,7e-06,31
csauk.ac.in/,,2,0,2,6e-06,31
en.wikipedia.org/wiki/Revolutionary_movement_for_Indian_independence,,4,0,4,6e-06,31
en.wikipedia.org/wiki/Chandrashekhar_Azad,,2,0,2,6e-06,31
en.wikipedia.org/wiki/Hardoi,,7,0,7,7e-06,31
"en.wikipedia.org/wiki/Mathura,_Uttar_Pradesh",,4,0,4,6e-06,31
en.wikipedia.org/wiki/Rabi_crop,,2,0,2,6e-06,31
en.wikipedia.org/wiki/Cereal,,3,0,3,6e-06,31
en.wikipedia.org/wiki/Faisalabad,,2,0,2,6e-06,31
en.wikipedia.org/wiki/Barley,,3,0,3,6e-06,31
en.wikipedia.org/wiki/Legumes,,2,0,2,6e-06,31
en.wikipedia.org/wiki/Oilseed,,2,0,2,6e-06,31
en.wikipedia.org/wiki/Vegetable,,2,0,2,6e-06,31
en.wikipedia.org/wiki/Cotton,,2,0,2,6e-06,31
en.wikipedia.org/wiki/Kishan_Singh_(biologist),,3,0,3,6e-06,31
en.wikipedia.org/wiki/Hargovind_Bhargava,,4,0,4,7e-06,31
web.archive.org/web/20190912143711/http://csauk.ac.in/,,2,0,2,6e-06,31
upcatet.org/,,2,0,2,6e-06,31
myneta.info/up2012/candidate.php?candidate_id=49,,2,0,2,6e-06,31
en.wikipedia.org/wiki/Template:Universities_in_Uttar_Pradesh,,12,0,12,7e-06,31
en.wikipedia.org/wiki/Template_talk:Universities_in_Uttar_Pradesh,,12,0,12,7e-06,31
en.wikipedia.org/wiki/Special:EditPage/Template:Universities_in_Uttar_Pradesh,,12,0,12,7e-06,31
en.wikipedia.org/wiki/Central_university_(India),,20,0,20,7e-06,31
en.wikipedia.org/wiki/Aligarh_Muslim_University,,20,0,20,7e-06,31
en.wikipedia.org/wiki/Babasaheb_Bhimrao_Ambedkar_University,,18,0,18,7e-06,31
en.wikipedia.org/wiki/Rajiv_Gandhi_National_Aviation_University,,13,0,13,7e-06,31
en.wikipedia.org/wiki/Rani_Lakshmi_Bai_Central_Agricultural_University,,14,0,14,7e-06,31
en.wikipedia.org/wiki/University_of_Allahabad,,18,0,18,7e-06,31
en.wikipedia.org/wiki/Acharya_Narendra_Deva_University_of_Agriculture_and_Technology,,13,0,13,7e-06,31
en.wikipedia.org/wiki/Atal_Bihari_Vajpayee_Medical_University,,14,0,14,7e-06,31
en.wikipedia.org/wiki/Banda_University_of_Agriculture_and_Technology,,12,0,12,7e-06,31
en.wikipedia.org/wiki/Bhatkhande_Sanskriti_Vishwavidyalaya,,12,0,12,7e-06,31
en.wikipedia.org/wiki/Bundelkhand_University,,12,0,12,7e-06,31
en.wikipedia.org/wiki/Chaudhary_Charan_Singh_University,,14,0,14,7e-06,31
en.wikipedia.org/wiki/Deen_Dayal_Upadhyay_Gorakhpur_University,,12,0,12,7e-06,31
"en.wikipedia.org/wiki/Dr._A._P._J._Abdul_Kalam_Technical_University,_Lucknow",,17,0,17,7e-06,31
en.wikipedia.org/wiki/Dr._Bhimrao_Ambedkar_University,,14,0,14,7e-06,31
en.wikipedia.org/wiki/Dr._Rajendra_Prasad_National_Law_University,,12,0,12,7e-06,31
en.wikipedia.org/wiki/Dr._Ram_Manohar_Lohia_Avadh_University,,12,0,12,7e-06,31
en.wikipedia.org/wiki/Dr._Ram_Manohar_Lohia_Institute_of_Medical_Sciences,,13,0,13,7e-06,31
en.wikipedia.org/wiki/Dr._Ram_Manohar_Lohiya_National_Law_University,,13,0,13,7e-06,31
en.wikipedia.org/wiki/Dr._Shakuntala_Misra_National_Rehabilitation_University,,12,0,12,7e-06,31
en.wikipedia.org/wiki/Gautam_Buddha_University,,12,0,12,7e-06,31
"en.wikipedia.org/wiki/Guru_Jambheshwar_University,_Moradabad",,12,0,12,7e-06,31
en.wikipedia.org/wiki/Jananayak_Chandrashekhar_University,,12,0,12,7e-06,31
en.wikipedia.org/wiki/Khwaja_Moinuddin_Chishti_Language_University,,12,0,12,7e-06,31
en.wikipedia.org/wiki/King_George%27s_Medical_University,,21,0,21,7e-06,31
en.wikipedia.org/wiki/Madan_Mohan_Malaviya_University_of_Technology,,14,0,14,7e-06,31
en.wikipedia.org/wiki/Mahatma_Gandhi_Kashi_Vidyapith,,15,0,15,7e-06,31
en.wikipedia.org/wiki/Mahatma_Jyotiba_Phule_Rohilkhand_University,,12,0,12,7e-06,31
en.wikipedia.org/wiki/Mahayogi_Guru_Gorakhnath_AYUSH_University,,12,0,12,7e-06,31
en.wikipedia.org/wiki/Prof._Rajendra_Singh_(Rajju_Bhaiya)_University,,12,0,12,7e-06,31
en.wikipedia.org/wiki/Sampurnanand_Sanskrit_Vishwavidyalaya,,16,0,16,7e-06,31
en.wikipedia.org/wiki/Sanjay_Gandhi_Postgraduate_Institute_of_Medical_Sciences,,18,0,18,7e-06,31
en.wikipedia.org/wiki/Sardar_Vallabh_Bhai_Patel_University_of_Agriculture_and_Technology,,12,0,12,7e-06,31
en.wikipedia.org/wiki/Siddharth_University,,12,0,12,7e-06,31
en.wikipedia.org/wiki/University_of_Lucknow,,20,0,20,7e-06,31
en.wikipedia.org/wiki/Uttar_Pradesh_Forestry_%26_Horticulture_University,,12,0,12,7e-06,31
en.wikipedia.org/wiki/Uttar_Pradesh_Rajarshi_Tandon_Open_University,,12,0,12,7e-06,31
en.wikipedia.org/wiki/Veer_Bahadur_Singh_Purvanchal_University,,12,0,12,7e-06,31
en.wikipedia.org/wiki/Central_Institute_of_Higher_Tibetan_Studies,,16,0,16,7e-06,31
en.wikipedia.org/wiki/Dayalbagh_Educational_Institute,,15,0,15,7e-06,31
en.wikipedia.org/wiki/Indian_Veterinary_Research_Institute,,12,0,12,7e-06,31
"en.wikipedia.org/wiki/Sam_Higginbottom_University_of_Agriculture,_Technology_and_Sciences",,14,0,14,7e-06,31
en.wikipedia.org/wiki/Shiv_Nadar_University,,14,0,14,7e-06,31
en.wikipedia.org/wiki/Shobhit_Institute_of_Engineering_%26_Technology,,14,0,14,7e-06,31
"en.wikipedia.org/wiki/Amity_University,_Noida",,13,0,13,7e-06,31
"en.wikipedia.org/wiki/Babu_Banarasi_Das_University,_Lucknow",,12,0,12,7e-06,31
en.wikipedia.org/wiki/Bareilly_International_University,,12,0,12,7e-06,31
en.wikipedia.org/wiki/Bennett_University,,13,0,13,7e-06,31
en.wikipedia.org/wiki/Era_University,,12,0,12,7e-06,31
en.wikipedia.org/wiki/Galgotias_University,,12,0,12,7e-06,31
en.wikipedia.org/wiki/GLA_University,,13,0,13,7e-06,31
en.wikipedia.org/wiki/IFTM_University,,12,0,12,7e-06,31
en.wikipedia.org/wiki/IIMT_University,,12,0,12,7e-06,31
en.wikipedia.org/wiki/Integral_University,,13,0,13,7e-06,31
en.wikipedia.org/wiki/Invertis_University,,12,0,12,7e-06,31
en.wikipedia.org/wiki/J.S._University,,12,0,12,7e-06,31
en.wikipedia.org/wiki/Jagadguru_Rambhadracharya_Divyanga_University,,12,0,12,7e-06,31
en.wikipedia.org/wiki/Jaypee_Institute_of_Information_Technology,,14,0,14,7e-06,31
en.wikipedia.org/wiki/Mangalayatan_University,,12,0,12,7e-06,31
en.wikipedia.org/wiki/Mahayogi_Gorakhnath_University,,12,0,12,7e-06,31
en.wikipedia.org/wiki/Mohammad_Ali_Jauhar_University,,12,0,12,7e-06,31
en.wikipedia.org/wiki/Monad_University,,12,0,12,7e-06,31
en.wikipedia.org/wiki/Rama_University,,15,0,15,7e-06,31
en.wikipedia.org/wiki/Sanskriti_University,,13,0,13,7e-06,31
en.wikipedia.org/wiki/Sharda_University,,12,0,12,7e-06,31
en.wikipedia.org/wiki/Shobhit_University_(Gangoh),,12,0,12,7e-06,31
en.wikipedia.org/wiki/Shri_Ramswaroop_Memorial_University,,12,0,12,7e-06,31
en.wikipedia.org/wiki/Shri_Venkateshwara_University,,12,0,12,7e-06,31
en.wikipedia.org/wiki/Swami_Vivekanand_Subharti_University,,13,0,13,7e-06,31
en.wikipedia.org/wiki/Teerthanker_Mahaveer_University,,12,0,12,7e-06,31
wikidata.org/wiki/Q5071310,,2,0,2,6e-06,31
isni.org/isni/0000000107264664,,2,0,2,6e-06,31
viaf.org/viaf/149668877,,2,0,2,6e-06,31
id.loc.gov/authorities/n81051082,,2,0,2,6e-06,31
en.wikipedia.org/wiki/Category:Chandra_Shekhar_Azad_University_of_Agriculture_and_Technology,,2,0,2,6e-06,31
en.wikipedia.org/wiki/Category:Agricultural_universities_and_colleges_in_Uttar_Pradesh,,2,0,2,6e-06,31
en.wikipedia.org/wiki/Category:Universities_in_Uttar_Pradesh,,11,0,11,7e-06,31
en.wikipedia.org/wiki/Category:Memorials_to_Chandra_Shekhar_Azad,,2,0,2,6e-06,31
en.wikipedia.org/wiki/Category:1975_establishments_in_Uttar_Pradesh,,3,0,3,7e-06,31
en.wikipedia.org/wiki/Category:Universities_and_colleges_established_in_1975,,2,0,2,6e-06,31
en.wikipedia.org/wiki/Category:Use_dmy_dates_from_November_2015,,10,0,10,7e-06,31
en.wikipedia.org/wiki/Category:Use_Indian_English_from_November_2015,,14,0,14,7e-06,31
en.wikipedia.org/wiki/Category:Articles_needing_additional_references_from_July_2017,,2,0,2,6e-06,31
en.wikipedia.org/wiki/Category:Pages_using_infobox_university_with_the_affiliations_parameter,,28,0,28,7e-06,31
en.wikipedia.org/wiki/Category:Articles_with_unsourced_statements_from_July_2017,,3,0,3,6e-06,31
en.wikipedia.org/wiki/Category:Vague_or_ambiguous_time_from_April_2018,,3,0,3,6e-06,31
en.wikipedia.org/wiki/Indian_Institute_of_Chemical_Engineers,,4,0,4,6e-06,31
en.wikipedia.org/wiki/Hdl_(identifier),,26,0,26,7e-06,31
en.wikipedia.org/wiki/Agricultural_chemistry,,6,0,6,6e-06,31
ar.wikipedia.org/wiki/جامعة_شاترافاتي_شهنوجي_مهراج,,2,0,2,6e-06,31
el.wikipedia.org/wiki/Πανεπιστήμιο_Τσχατραπάτι_Σάχου_Τζι_Μαχαράτζ,,2,0,2,6e-06,31
hi.wikipedia.org/wiki/छत्रपति_शाहू_जी_महाराज_विश्वविद्यालय,,2,0,2,6e-06,31
mr.wikipedia.org/wiki/छत्रपती_शाहूजी_महाराज_विद्यापीठ,,2,0,2,6e-06,31
arz.wikipedia.org/wiki/جامعة_شاترافاتى_شهنوجى_مهراج,,2,0,2,6e-06,31
ta.wikipedia.org/wiki/சத்ரபதி_ஷாகுஜி_மகராஜ்_பல்கலைக்கழகம்,,2,0,2,6e-06,31
uk.wikipedia.org/wiki/Університет_Чатрапаті_Шахуджі_Магараджі,,2,0,2,6e-06,31
ur.wikipedia.org/wiki/چھترپتی_شاہو_جی_مہاراج_یونیورسٹی,,2,0,2,6e-06,31
wikidata.org/wiki/Special:EntityPage/Q5094823,,2,0,2,6e-06,31
en.wikipedia.org/wiki/Talk:Chhatrapati_Shahu_Ji_Maharaj_University,,2,0,2,6e-06,31
en.wikipedia.org/w/index.php?title=Chhatrapati_Shahu_Ji_Maharaj_University&action=edit,,2,0,2,6e-06,31
en.wikipedia.org/w/index.php?title=Chhatrapati_Shahu_Ji_Maharaj_University&action=history,,2,0,2,6e-06,31
en.wikipedia.org/wiki/Special:WhatLinksHere/Chhatrapati_Shahu_Ji_Maharaj_University,,2,0,2,6e-06,31
en.wikipedia.org/wiki/Special:RecentChangesLinked/Chhatrapati_Shahu_Ji_Maharaj_University,,2,0,2,6e-06,31
en.wikipedia.org/w/index.php?title=Chhatrapati_Shahu_Ji_Maharaj_University&oldid=1307579521,,2,0,2,6e-06,31
en.wikipedia.org/w/index.php?title=Chhatrapati_Shahu_Ji_Maharaj_University&action=info,,2,0,2,6e-06,31
en.wikipedia.org/w/index.php?title=Chhatrapati_Shahu_Ji_Maharaj_University&printable=yes,,2,0,2,6e-06,31
en.wikipedia.org/wiki/Special:EditPage/Chhatrapati_Shahu_Ji_Maharaj_University,,2,0,2,6e-06,31
"google.com/search?as_eq=wikipedia&q=""Chhatrapati+Shahu+Ji+Maharaj+University""",,2,0,2,6e-06,31
"google.com/search?tbm=nws&q=""Chhatrapati+Shahu+Ji+Maharaj+University""+-wikipedia&tbs=ar:1",,2,0,2,6e-06,31
"google.com/search?&q=""Chhatrapati+Shahu+Ji+Maharaj+University""&tbs=bkt:s&tbm=bks",,2,0,2,6e-06,31
"google.com/search?tbs=bks:1&q=""Chhatrapati+Shahu+Ji+Maharaj+University""+-wikipedia",,2,0,2,6e-06,31
"scholar.google.com/scholar?q=""Chhatrapati+Shahu+Ji+Maharaj+University""",,2,0,2,6e-06,31
"jstor.org/action/doBasicSearch?Query=""Chhatrapati+Shahu+Ji+Maharaj+University""&acc=on&wc=on",,2,0,2,6e-06,31
en.wikipedia.org/wiki/File:Chhatrapati_Shahu_Ji_Maharaj_University_logo.png,,2,0,2,6e-06,31
en.wikipedia.org/wiki/Vinay_Kumar_Pathak,,5,0,5,7e-06,31
csjmu.ac.in/,,2,0,2,6e-06,31
en.wikipedia.org/wiki/File:CSJM_University.jpg,,5,0,5,7e-06,31
en.wikipedia.org/wiki/Collegiate_University,,2,0,2,6e-06,31
en.wikipedia.org/wiki/File:Kanpur_univ_auditorium.JPG,,2,0,2,6e-06,31
en.wikipedia.org/w/index.php?title=Chhatrapati_Shahu_Ji_Maharaj_University&action=edit&section=1,,2,0,2,6e-06,31
en.wikipedia.org/w/index.php?title=Chhatrapati_Shahu_Ji_Maharaj_University&action=edit&section=2,,2,0,2,6e-06,31
en.wikipedia.org/w/index.php?title=Chhatrapati_Shahu_Ji_Maharaj_University&action=edit&section=3,,2,0,2,6e-06,31
"en.wikipedia.org/wiki/DAV_College,_Kanpur",,4,0,4,7e-06,31
en.wikipedia.org/wiki/Vikramajit_Singh_Sanatan_Dharma_College,,3,0,3,7e-06,31
"en.wikipedia.org/wiki/Christ_Church_College,_Kanpur",,4,0,4,7e-06,31
en.wikipedia.org/wiki/Pandit_Prithi_Nath_College,,4,0,4,7e-06,31
en.wikipedia.org/wiki/Chaudhary_Charan_Singh_Post_Graduate_College,,5,0,5,7e-06,31
en.wikipedia.org/wiki/Juhari_Devi_Girls%27_P.G._College,,3,0,3,7e-06,31
en.wikipedia.org/w/index.php?title=Chhatrapati_Shahu_Ji_Maharaj_University&action=edit&section=4,,2,0,2,6e-06,31
en.wikipedia.org/w/index.php?title=Chhatrapati_Shahu_Ji_Maharaj_University&action=edit&section=5,,2,0,2,6e-06,31
en.wikipedia.org/w/index.php?title=Chhatrapati_Shahu_Ji_Maharaj_University&action=edit&section=6,,2,0,2,6e-06,31
en.wikipedia.org/wiki/File:Mech_uiet.jpg,,2,0,2,6e-06,31
en.wikipedia.org/w/index.php?title=Chhatrapati_Shahu_Ji_Maharaj_University&action=edit&section=7,,2,0,2,6e-06,31
en.wikipedia.org/wiki/Category:Chhatrapati_Shahu_Ji_Maharaj_University_alumni,,2,0,2,6e-06,31
en.wikipedia.org/w/index.php?title=Chhatrapati_Shahu_Ji_Maharaj_University&action=edit&section=8,,2,0,2,6e-06,31
en.wikipedia.org/wiki/List_of_presidents_of_India,,4,0,4,6e-06,31
en.wikipedia.org/wiki/Harsh_Vardhan_(Delhi_politician),,4,0,4,7e-06,31
en.wikipedia.org/wiki/Minister_of_Science_and_Technology_(India),,3,0,3,6e-06,31
en.wikipedia.org/wiki/Gopal_Khanna,,2,0,2,6e-06,31
en.wikipedia.org/wiki/Agency_for_Healthcare_Research_and_Quality,,2,0,2,6e-06,31
en.wikipedia.org/wiki/Shivpal_Singh_Yadav,,5,0,5,7e-06,31
en.wikipedia.org/wiki/Uttar_Pradesh_Government,,9,0,9,7e-06,31
en.wikipedia.org/wiki/Anupriya_Patel,,3,0,3,6e-06,31
en.wikipedia.org/wiki/Ram_Gopal_Yadav,,3,0,3,7e-06,31
en.wikipedia.org/wiki/Naresh_Uttam_Patel,,3,0,3,6e-06,31
en.wikipedia.org/wiki/Lalji_Verma,,2,0,2,6e-06,31
en.wikipedia.org/wiki/Nafees_Ahmad,,2,0,2,6e-06,31
en.wikipedia.org/wiki/Harvindar_Kumar_Sahani,,2,0,2,6e-06,31
en.wikipedia.org/wiki/Sarita_Bhadauria,,6,0,6,7e-06,31
en.wikipedia.org/wiki/Adesh_Kumar_Gupta,,2,0,2,6e-06,31
en.wikipedia.org/wiki/Bhartiya_Janta_Party,,4,0,4,6e-06,31
en.wikipedia.org/wiki/Sone_Lal_Patel,,2,0,2,6e-06,31
en.wikipedia.org/wiki/Apna_Dal_(Kamerawadi),,8,0,8,7e-06,31
en.wikipedia.org/wiki/Subhashini_Ali,,3,0,3,6e-06,31
en.wikipedia.org/wiki/Communist_Party_of_India_(Marxist),,8,0,8,7e-06,31
en.wikipedia.org/wiki/Annu_Tandon,,3,0,3,6e-06,31
en.wikipedia.org/wiki/Premdas_Katheria,,3,0,3,6e-06,31
en.wikipedia.org/wiki/Sushila_Saroj,,2,0,2,6e-06,31
en.wikipedia.org/wiki/Ashok_Kumar_Doharey,,3,0,3,6e-06,31
en.wikipedia.org/wiki/Arvind_Pratap,,2,0,2,6e-06,31
en.wikipedia.org/w/index.php?title=Chhatrapati_Shahu_Ji_Maharaj_University&action=edit&section=9,,2,0,2,6e-06,31
en.wikipedia.org/wiki/Renu_Khator,,4,0,4,7e-06,31
en.wikipedia.org/wiki/University_of_Houston_System,,2,0,2,6e-06,31
en.wikipedia.org/wiki/Onkar_Singh,,6,0,6,7e-06,31
en.wikipedia.org/wiki/Uttarakhand_Technical_University,,2,0,2,6e-06,31
en.wikipedia.org/wiki/Raj_Kumar_(professor),,4,0,4,7e-06,31
en.wikipedia.org/wiki/Rajendra_Institute_of_Medical_Sciences,,3,0,3,6e-06,31
en.wikipedia.org/wiki/Rakesh_Bhatnagar,,2,0,2,6e-06,31
en.wikipedia.org/wiki/Ghanshyam_Swarup,,3,0,3,6e-06,31
en.wikipedia.org/w/index.php?title=Chhatrapati_Shahu_Ji_Maharaj_University&action=edit&section=10,,2,0,2,6e-06,31
en.wikipedia.org/wiki/Mohammad_Kaif,,2,0,2,6e-06,31
en.wikipedia.org/wiki/Anny_Divya,,2,0,2,6e-06,31
en.wikipedia.org/wiki/Indira_Gandhi_Rashtriya_Uran_Akademi,,2,0,2,6e-06,31
en.wikipedia.org/wiki/Veena_Sahasrabuddhe,,3,0,3,7e-06,31
en.wikipedia.org/wiki/Rahul_Mishra,,2,0,2,6e-06,31
en.wikipedia.org/w/index.php?title=Chhatrapati_Shahu_Ji_Maharaj_University&action=edit&section=11,,2,0,2,6e-06,31
"en.wikipedia.org/wiki/Faculty_of_Pharmacy,_Uttar_Pradesh_University_of_Medical_Sciences",,3,0,3,6e-06,31
en.wikipedia.org/w/index.php?title=Chhatrapati_Shahu_Ji_Maharaj_University&action=edit&section=12,,2,0,2,6e-06,31
web.archive.org/web/20180604033940/http://www.kanpuruniversity.org/vice_chancellor.htm,,2,0,2,6e-06,31
kanpuruniversity.org/vice_chancellor.htm,,2,0,2,6e-06,31
nirfindia.org/Rankings/2024/PharmacyRanking.html,,3,0,3,6e-06,31
nirfindia.org/Rankings/2024/PharmacyRanking150.html,,3,0,3,6e-06,31
patrika.com/kanpur-news/the-association-of-these-400-colleges-with-kanpur-university-ends-6432791/,,2,0,2,6e-06,31
britannica.com/biography/Ram-Nath-Kovind,,2,0,2,6e-06,31
myneta.info/uttarpradesh2017/candidate.php?candidate_id=4380,,2,0,2,6e-06,31
"cla.purdue.edu/alumni/OurAlumni/Profiles/Khator,_Renu.html",,2,0,2,6e-06,31
en.wikipedia.org/w/index.php?title=Chhatrapati_Shahu_Ji_Maharaj_University&action=edit&section=13,,2,0,2,6e-06,31
csjmu.ac.in/school-of-engineering-and-technology/,,2,0,2,6e-06,31
wikidata.org/wiki/Q5094823,,2,0,2,6e-06,31
isni.org/isni/0000000405065655,,2,0,2,6e-06,31
en.wikipedia.org/wiki/Category:Chhatrapati_Shahu_Ji_Maharaj_University,,3,0,3,7e-06,31
en.wikipedia.org/wiki/Category:Universities_and_colleges_established_in_1966,,3,0,3,6e-06,31
en.wikipedia.org/wiki/Category:1966_establishments_in_Uttar_Pradesh,,2,0,2,6e-06,31
en.wikipedia.org/wiki/Category:Articles_needing_additional_references_from_March_2018,,2,0,2,6e-06,31
en.wikipedia.org/wiki/Category:Articles_lacking_reliable_references_from_June_2016,,2,0,2,6e-06,31
en.wikipedia.org/wiki/Category:Articles_with_unsourced_statements_from_August_2023,,6,0,6,7e-06,31
upload.wikimedia.org/wikipedia/commons/thumb/d/de/CSJM_University.jpg/250px-CSJM_University.jpg,,5,0,5,7e-06,31
upload.wikimedia.org/wikipedia/commons/thumb/3/33/Mech_uiet.jpg/250px-Mech_uiet.jpg,,2,0,2,6e-06,31
en.wikipedia.org/wiki/Chemist,,5,0,5,6e-06,31
en.wikipedia.org/wiki/Natural_science,,19,0,19,7e-06,31
en.wikipedia.org/wiki/Metal,,5,0,5,6e-06,31
en.wikipedia.org/wiki/Acid,,4,0,4,6e-06,31
en.wikipedia.org/wiki/University_of_Cambridge,,22,0,22,7e-06,31
en.wikipedia.org/wiki/American_Chemical_Society,,5,0,5,6e-06,31
en.wikipedia.org/wiki/Royal_Society_of_Chemistry,,5,0,5,6e-06,31
en.wikipedia.org/wiki/Pearson_Education,,5,0,5,6e-06,31
en.wikipedia.org/wiki/Artisan,,5,0,5,6e-06,31
en.wikipedia.org/wiki/Hazardous_waste,,4,0,4,6e-06,31
en.wikipedia.org/wiki/Urban_park,,5,0,5,7e-06,31
en.wikipedia.org/wiki/Institution_of_Engineers_(India),,9,0,9,7e-06,31
en.wikipedia.org/wiki/Carpentry,,5,0,5,6e-06,31
en.wikipedia.org/wiki/Architecture,,14,0,14,7e-06,31
en.wikipedia.org/wiki/Cornerstone,,5,0,5,6e-06,31
en.wikipedia.org/wiki/Language,,6,0,6,7e-06,31
en.wikipedia.org/wiki/Systems_theory,,4,0,4,7e-06,31
en.wikipedia.org/wiki/Information_theory,,6,0,6,7e-06,31
en.wikipedia.org/wiki/Educational_technology,,5,0,5,6e-06,31
en.wikipedia.org/wiki/Public_administration,,22,0,22,7e-06,31
en.wikipedia.org/wiki/Business_administration,,13,0,13,7e-06,31
en.wikipedia.org/wiki/New_Jersey,,7,0,7,7e-06,31
en.wikipedia.org/wiki/Scopus,,10,0,10,7e-06,31
en.wikipedia.org/wiki/South_Korea,,16,0,16,7e-06,31
en.wikipedia.org/wiki/Wikipedia,,11,0,11,7e-06,31
en.wikipedia.org/wiki/Web_of_Science,,7,0,7,6e-06,31
en.wikipedia.org/wiki/Mint_(newspaper),,10,0,10,7e-06,31
en.wikipedia.org/wiki/Dataquest,,4,0,4,6e-06,31
en.wikipedia.org/wiki/Joint_Entrance_Examination,,16,0,16,7e-06,31
en.wikipedia.org/wiki/English_language,,43,0,43,7e-06,31
en.wikipedia.org/wiki/MBA,,10,0,10,7e-06,31
en.wikipedia.org/wiki/Indian_Institute_of_Management_Lucknow,,13,0,13,7e-06,31
en.wikipedia.org/wiki/Category:Pages_using_Sister_project_links_with_wikidata_namespace_mismatch,,3,0,3,6e-06,31
en.wikipedia.org/wiki/Agra,,36,0,36,7e-06,31
en.wikipedia.org/wiki/Bangalore,,23,0,23,7e-06,31
en.wikipedia.org/wiki/Dehradun,,14,0,14,7e-06,31
en.wikipedia.org/wiki/Kochi,,7,0,7,7e-06,31
en.wikipedia.org/wiki/Visakhapatnam,,11,0,11,7e-06,31
en.wikipedia.org/wiki/Nashik,,8,0,8,7e-06,31
en.wikipedia.org/wiki/Coimbatore,,6,0,6,7e-06,31
en.wikipedia.org/wiki/Make_in_India,,8,0,8,6e-06,31
en.wikipedia.org/wiki/Indian_Council_of_Medical_Research,,5,0,5,6e-06,31
en.wikipedia.org/wiki/Tata_Motors,,7,0,7,7e-06,31
en.wikipedia.org/wiki/Mahindra_%26_Mahindra,,5,0,5,7e-06,31
en.wikipedia.org/wiki/Maruti_Suzuki,,5,0,5,7e-06,31
en.wikipedia.org/wiki/Ashok_Leyland,,7,0,7,7e-06,31
en.wikipedia.org/wiki/National_Cadet_Corps_(India),,14,0,14,7e-06,31
en.wikipedia.org/wiki/Hyderabad_Metro,,7,0,7,7e-06,31
en.wikipedia.org/wiki/Hyderabad_Multi-Modal_Transport_System,,8,0,8,7e-06,31
en.wikipedia.org/wiki/Rajiv_Gandhi_International_Cricket_Stadium,,3,0,3,6e-06,31
"en.wikipedia.org/wiki/Lal_Bahadur_Shastri_Stadium,_Hyderabad",,3,0,3,6e-06,31
en.wikipedia.org/wiki/List_of_cities_in_India_by_population,,18,0,18,7e-06,31
en.wikipedia.org/wiki/Bombay_Stock_Exchange,,12,0,12,7e-06,31
en.wikipedia.org/wiki/National_Stock_Exchange_of_India,,13,0,13,7e-06,31
en.wikipedia.org/wiki/Jhansi,,22,0,22,7e-06,31
en.wikipedia.org/wiki/Gorakhpur,,20,0,20,7e-06,31
en.wikipedia.org/wiki/Varanasi,,43,0,43,7e-06,31
en.wikipedia.org/wiki/Baton_(law_enforcement),,2,0,2,6e-06,31
en.wikipedia.org/wiki/Allahabad,,21,0,21,7e-06,31
en.wikipedia.org/wiki/Amar_Ujala,,4,0,4,6e-06,31
en.wikipedia.org/wiki/Meerut,,25,0,25,7e-06,31
en.wikipedia.org/wiki/Bareilly,,20,0,20,7e-06,31
en.wikipedia.org/wiki/Mayawati,,5,0,5,7e-06,31
en.wikipedia.org/wiki/Bahujan_Samaj_Party,,21,0,21,7e-06,31
en.wikipedia.org/wiki/Aligarh,,25,0,25,7e-06,31
en.wikipedia.org/wiki/Moradabad,,16,0,16,7e-06,31
en.wikipedia.org/wiki/Ludhiana,,7,0,7,6e-06,31
en.wikipedia.org/wiki/Nainital,,7,0,7,6e-06,31
en.wikipedia.org/wiki/Muzaffarpur,,4,0,4,6e-06,31
en.wikipedia.org/wiki/Dharamshala,,3,0,3,6e-06,31
en.wikipedia.org/wiki/Mahendra_Mohan_Gupta,,2,0,2,6e-06,31
en.wikipedia.org/wiki/Chief_Minister_of_Uttar_Pradesh,,7,0,7,7e-06,31
en.wikipedia.org/wiki/Rajasthan_Patrika,,3,0,3,6e-06,31
en.wikipedia.org/wiki/Ganga,,10,0,10,7e-06,31
en.wikipedia.org/wiki/Prayagraj,,30,0,30,7e-06,31
en.wikipedia.org/wiki/Paid_news_in_India,,3,0,3,7e-06,31
en.wikipedia.org/wiki/Punjabi_language,,23,0,23,7e-06,31
en.wikipedia.org/wiki/Category:Articles_with_Hindi-language_sources_(hi),,2,0,2,7e-06,31
en.wikipedia.org/wiki/Doctoral_advisor,,6,0,6,7e-06,31
en.wikipedia.org/wiki/University_of_Waterloo,,5,0,5,7e-06,31
en.wikipedia.org/wiki/Professor,,9,0,9,7e-06,31
en.wikipedia.org/wiki/List_of_Nobel_laureates_in_Physics,,4,0,4,6e-06,31
en.wikipedia.org/wiki/J._J._Thomson,,6,0,6,6e-06,31
en.wikipedia.org/wiki/Fashion_design,,6,0,6,7e-06,31
en.wikipedia.org/wiki/Photography,,8,0,8,7e-06,31
en.wikipedia.org/wiki/File:Wikivoyage-Logo-v3-icon.svg,,22,0,22,7e-06,31
en.wikipedia.org/wiki/Christianity,,8,0,8,7e-06,31
en.wikipedia.org/wiki/Academic_journal,,8,0,8,7e-06,31
en.wikipedia.org/wiki/Doctor_of_Science,,7,0,7,6e-06,31
en.wikipedia.org/wiki/Auditorium,,4,0,4,6e-06,31
en.wikipedia.org/wiki/Pharmacy,,10,0,10,7e-06,31
en.wikipedia.org/wiki/Category:Articles_with_unsourced_statements_from_September_2020,,5,0,5,7e-06,31
en.wikipedia.org/wiki/Category:Articles_needing_additional_references_from_April_2008,,3,0,3,6e-06,31
en.wikipedia.org/wiki/Nickel,,7,0,7,7e-06,31
en.wikipedia.org/wiki/Hydrography,,12,0,12,7e-06,31
en.wikipedia.org/wiki/Hindus,,7,0,7,7e-06,31
en.wikipedia.org/wiki/Jains,,2,0,2,6e-06,31
en.wikipedia.org/wiki/Sikhs,,4,0,4,6e-06,31
en.wikipedia.org/wiki/Hinduism,,25,0,25,7e-06,31
en.wikipedia.org/wiki/Vaishnavism,,3,0,3,6e-06,31
en.wikipedia.org/wiki/Vishvakarma,,4,0,4,6e-06,31
en.wikipedia.org/wiki/Dharma,,4,0,4,6e-06,31
en.wikipedia.org/wiki/Yoga,,9,0,9,7e-06,31
en.wikipedia.org/wiki/Holi,,7,0,7,6e-06,31
en.wikipedia.org/wiki/Maha_Shivaratri,,4,0,4,6e-06,31
en.wikipedia.org/wiki/Navaratri,,3,0,3,6e-06,31
en.wikipedia.org/wiki/Ramlila,,3,0,3,7e-06,31
en.wikipedia.org/wiki/Vijayadashami,,4,0,4,6e-06,31
en.wikipedia.org/wiki/Rama_Navami,,4,0,4,6e-06,31
en.wikipedia.org/wiki/Krishna_Janmashtami,,4,0,4,7e-06,31
en.wikipedia.org/wiki/Makar_Sankranti,,5,0,5,7e-06,31
en.wikipedia.org/wiki/Vyasa,,2,0,2,6e-06,31
en.wikipedia.org/wiki/Ravidas,,2,0,2,6e-06,31
en.wikipedia.org/wiki/Ravana,,2,0,2,6e-06,31
en.wikipedia.org/wiki/Myanmar,,9,0,9,6e-06,31
en.wikipedia.org/wiki/Nepal,,19,0,19,7e-06,31
en.wikipedia.org/wiki/Sanskrit_literature,,4,0,4,6e-06,31
en.wikipedia.org/wiki/Akbar,,7,0,7,6e-06,31
en.wikipedia.org/wiki/Haridwar,,8,0,8,6e-06,31
en.wikipedia.org/wiki/Zinc,,4,0,4,6e-06,31
en.wikipedia.org/wiki/Ayodhya,,16,0,16,7e-06,31
en.wikipedia.org/wiki/Maithili_language,,11,0,11,7e-06,31
en.wikipedia.org/wiki/Malayalam_language,,3,0,3,7e-06,31
en.wikipedia.org/wiki/Prayag_Kumbh_Mela,,3,0,3,7e-06,31
en.wikipedia.org/wiki/Hanuman_Jayanti,,3,0,3,6e-06,31
en.wikipedia.org/wiki/Guru_Purnima,,2,0,2,6e-06,31
en.wikipedia.org/wiki/Kartik_Purnima,,2,0,2,6e-06,31
en.wikipedia.org/wiki/Eid_al-Fitr,,3,0,3,6e-06,31
en.wikipedia.org/wiki/Category:Use_Indian_English_from_February_2020,,5,0,5,7e-06,31
upload.wikimedia.org/wikipedia/commons/thumb/b/b7/Om_symbol.svg/20px-Om_symbol.svg.png,,3,0,3,7e-06,31
upload.wikimedia.org/wikipedia/commons/thumb/6/66/Flag_of_Malaysia.svg/40px-Flag_of_Malaysia.svg.png,,4,0,4,6e-06,31
upload.wikimedia.org/wikipedia/commons/thumb/9/9b/Flag_of_Nepal.svg/20px-Flag_of_Nepal.svg.png,,6,0,6,7e-06,31
upload.wikimedia.org/wikipedia/commons/thumb/3/32/Flag_of_Pakistan.svg/40px-Flag_of_Pakistan.svg.png,,6,0,6,6e-06,31
en.wikipedia.org/wiki/Institute_of_Electrical_and_Electronics_Engineers,,6,0,6,7e-06,31
en.wikipedia.org/wiki/Wiley_(publisher),,6,0,6,6e-06,31
en.wikipedia.org/wiki/Wikipedia:Independent_sources,,7,0,7,7e-06,31
en.wikipedia.org/wiki/Corporation,,5,0,5,6e-06,31
en.wikipedia.org/wiki/Unemployment_rate,,2,0,2,6e-06,31
en.wikipedia.org/wiki/Gross_domestic_product,,9,0,9,7e-06,31
en.wikipedia.org/wiki/Wikipedia:Copyrights,,3,0,3,7e-06,31
en.wikipedia.org/wiki/Azerbaijan,,5,0,5,7e-06,31
en.wikipedia.org/wiki/Huns,,2,0,2,6e-06,31
en.wikipedia.org/wiki/Plastic,,5,0,5,6e-06,31
en.wikipedia.org/wiki/Textile_manufacturing,,4,0,4,6e-06,31
en.wikipedia.org/wiki/Steam_locomotive,,2,0,2,6e-06,31
en.wikipedia.org/wiki/Vegetable_oil,,4,0,4,6e-06,31
en.wikipedia.org/wiki/Dyeing,,4,0,4,6e-06,31
en.wikipedia.org/wiki/Paint,,5,0,5,6e-06,31
en.wikipedia.org/wiki/Leather,,7,0,7,6e-06,31
en.wikipedia.org/wiki/Synthetic_fiber,,3,0,3,6e-06,31
en.wikipedia.org/wiki/Fused_quartz,,5,0,5,6e-06,31
en.wikipedia.org/wiki/Foundry,,5,0,5,6e-06,31
en.wikipedia.org/wiki/Taxi,,3,0,3,6e-06,31
en.wikipedia.org/wiki/Financial_services,,4,0,4,6e-06,31
en.wikipedia.org/wiki/Tourism,,2,0,2,6e-06,31
en.wikipedia.org/wiki/Periodical_literature,,4,0,4,6e-06,31
en.wikipedia.org/wiki/Culture,,7,0,7,6e-06,31
en.wikipedia.org/wiki/Nonprofit_organization,,7,0,7,7e-06,31
en.wikipedia.org/wiki/Sanitation,,2,0,2,6e-06,31
en.wikipedia.org/wiki/Cholera,,3,0,3,6e-06,31
commons.wikimedia.org/w/index.php?title=User:Sahitya0000&action=edit&redlink=1,,1,0,1,7e-06,31
en.wikipedia.org/wiki/en:Creative_Commons,,8,0,8,7e-06,31
creativecommons.org/licenses/by-sa/4.0/deed.en,,2,0,2,7e-06,31
creativecommons.org/share-your-work/licensing-considerations/compatible-licenses,,3,0,3,7e-06,31
wikidata.org/wiki/Special:EntityPage/P180,,8,0,8,7e-06,31
wikidata.org/wiki/Special:EntityPage/P170,,7,0,7,7e-06,31
wikidata.org/wiki/Special:EntityPage/P2093,,7,0,7,7e-06,31
wikidata.org/wiki/Special:EntityPage/P2699,,3,0,3,7e-06,31
commons.wikimedia.org/wiki/user:Sahitya0000,,1,0,1,7e-06,31
wikidata.org/wiki/Special:EntityPage/P4174,,6,0,6,7e-06,31
wikidata.org/wiki/Special:CentralAuth?target=Sahitya0000,,1,0,1,7e-06,31
wikidata.org/wiki/Special:EntityPage/P6216,,8,0,8,7e-06,31
wikidata.org/wiki/Special:EntityPage/Q50423863,,4,0,4,7e-06,31
wikidata.org/wiki/Special:EntityPage/P275,,8,0,8,7e-06,31
wikidata.org/wiki/Special:EntityPage/Q18199165,,2,0,2,7e-06,31
wikidata.org/wiki/Special:EntityPage/P7482,,7,0,7,7e-06,31
wikidata.org/wiki/Special:EntityPage/Q66458942,,6,0,6,7e-06,31
wikidata.org/wiki/Special:EntityPage/P571,,7,0,7,7e-06,31
en.wikipedia.org/wiki/User:Sahitya0000,,1,0,1,7e-06,31
upload.wikimedia.org/wikipedia/commons/thumb/1/11/Cc-by_new_white.svg/40px-Cc-by_new_white.svg.png,,4,0,4,7e-06,31
upload.wikimedia.org/wikipedia/commons/thumb/d/df/Cc-sa_white.svg/40px-Cc-sa_white.svg.png,,3,0,3,7e-06,31
commons.wikimedia.org/w/index.php?title=MediaWiki:Filepage.css&action=raw&ctype=text/css,,8,0,8,7e-06,31
en.wikipedia.org/w/index.php?title=Special:CreateAccount&returnto=File%3AIITKLibrary.jpg,,1,0,1,6e-06,31
en.wikipedia.org/w/index.php?title=Special:UserLogin&returnto=File%3AIITKLibrary.jpg,,1,0,1,6e-06,31
en.wikipedia.org/w/index.php?title=File_talk:IITKLibrary.jpg&action=edit&redlink=1,,1,0,1,6e-06,31
en.wikipedia.org/wiki/Special:WhatLinksHere/File:IITKLibrary.jpg,,1,0,1,6e-06,31
en.wikipedia.org/w/index.php?title=File:IITKLibrary.jpg&action=info,,1,0,1,6e-06,31
upload.wikimedia.org/wikipedia/commons/0/03/IITKLibrary.jpg,,1,0,1,6e-06,31
upload.wikimedia.org/wikipedia/commons/thumb/0/03/IITKLibrary.jpg/960px-IITKLibrary.jpg,,1,0,1,6e-06,31
upload.wikimedia.org/wikipedia/commons/thumb/0/03/IITKLibrary.jpg/1024px-IITKLibrary.jpg,,1,0,1,6e-06,31
commons.wikimedia.org/wiki/User:AmarChandra,,1,0,1,6e-06,31
creativecommons.org/licenses/by-sa/2.0/deed.en,,1,0,1,6e-06,31
en.wikipedia.org/wiki/en:GNU_Free_Documentation_License,,1,0,1,6e-06,31
en.wikipedia.org/wiki/en:Free_Software_Foundation,,1,0,1,6e-06,31
"commons.wikimedia.org/wiki/Commons:GNU_Free_Documentation_License,_version_1.2",,1,0,1,6e-06,31
creativecommons.org/licenses/by-sa/3.0/deed.en,,1,0,1,6e-06,31
meta.wikimedia.org/wiki/Licensing_update,,1,0,1,6e-06,31
wikidata.org/wiki/Special:EntityPage/Q50829104,,1,0,1,6e-06,31
wikidata.org/wiki/Special:EntityPage/Q14946043,,1,0,1,6e-06,31
wikidata.org/wiki/Special:EntityPage/Q19068220,,1,0,1,6e-06,31
wikidata.org/wiki/Special:EntityPage/P3575,,3,0,3,7e-06,31
wikidata.org/wiki/Special:EntityPage/P2048,,3,0,3,7e-06,31
wikidata.org/wiki/Special:EntityPage/P2049,,3,0,3,7e-06,31
wikidata.org/wiki/Special:EntityPage/P1163,,6,0,6,7e-06,31
wikidata.org/wiki/Special:EntityPage/P4092,,3,0,3,7e-06,31
wikidata.org/wiki/Special:EntityPage/P459,,3,0,3,7e-06,31
wikidata.org/wiki/Special:EntityPage/Q13414952,,3,0,3,7e-06,31
en.wikipedia.org/wiki/User:AmarChandra,,1,0,1,6e-06,31
en.wikipedia.org/wiki/Education_in_Uttar_Pradesh,,17,0,17,7e-06,31
en.wikipedia.org/wiki/User:Amanbhatia,,1,0,1,6e-06,31
en.wikipedia.org/wiki/User:Aravindreddy96,,1,0,1,6e-06,31
en.wikipedia.org/wiki/User:AyushMukherjee376,,1,0,1,6e-06,31
en.wikipedia.org/wiki/User:Kaajawa,,1,0,1,6e-06,31
en.wikipedia.org/wiki/User:Kakugudiya/sandbox,,2,0,2,7e-06,31
en.wikipedia.org/wiki/User:LearnIndology,,1,0,1,6e-06,31
en.wikipedia.org/wiki/User:Rohitj.iitk,,1,0,1,6e-06,31
en.wikipedia.org/wiki/Wikipedia:Userboxes/Education/India,,1,0,1,6e-06,31
en.wikipedia.org/wiki/Template:User_iitk,,1,0,1,6e-06,31
en.wikipedia.org/wiki/Category:Wikipedians_by_alma_mater:_Indian_Institute_of_Technology_Kanpur,,1,0,1,6e-06,31
de.wikipedia.org/wiki/Benutzer:Carl_Ha/Architektur_XX/Indien,,1,0,1,6e-06,31
es.wikipedia.org/wiki/Racionalismo_(arquitectura),,1,0,1,6e-06,31
es.wikipedia.org/wiki/Arte_de_la_India,,1,0,1,6e-06,31
kn.wikipedia.org/wiki/ಸದಸ್ಯ:Pradeepabk/sandbox,,1,0,1,6e-06,31
pl.wikipedia.org/wiki/Modernizm_poza_Europą_i_Stanami_Zjednoczonymi,,1,0,1,6e-06,31
test.wikipedia.org/wiki/Indiako_Teknologia_Institutuak,,1,0,1,6e-06,31
zh.wikipedia.org/wiki/印度大学列表,,1,0,1,6e-06,31
en.m.wikipedia.org/w/index.php?title=File:IITKLibrary.jpg&mobileaction=toggle_view_mobile,,1,0,1,6e-06,31
upload.wikimedia.org/wikipedia/commons/thumb/2/29/Cc-sa.svg/40px-Cc-sa.svg.png,,1,0,1,6e-06,31
en.wikipedia.org/w/index.php?title=Special:CreateAccount&returnto=File%3AIIT+Kanpur.jpg,,1,0,1,7e-06,31
en.wikipedia.org/w/index.php?title=Special:UserLogin&returnto=File%3AIIT+Kanpur.jpg,,1,0,1,7e-06,31
en.wikipedia.org/w/index.php?title=File_talk:IIT_Kanpur.jpg&action=edit&redlink=1,,1,0,1,7e-06,31
en.wikipedia.org/wiki/Special:WhatLinksHere/File:IIT_Kanpur.jpg,,1,0,1,7e-06,31
en.wikipedia.org/w/index.php?title=File:IIT_Kanpur.jpg&action=info,,1,0,1,7e-06,31
upload.wikimedia.org/wikipedia/commons/7/75/IIT_Kanpur.jpg,,1,0,1,7e-06,31
commons.wikimedia.org/w/index.php?title=User:NiteshSingh6789&action=edit&redlink=1,,4,0,4,7e-06,31
creativecommons.org/publicdomain/zero/1.0/deed.en,,4,0,4,7e-06,31
en.wikipedia.org/wiki/en:public_domain,,4,0,4,7e-06,31
wikidata.org/wiki/Special:EntityPage/P3831,,5,0,5,7e-06,31
wikidata.org/wiki/Special:EntityPage/Q33231,,5,0,5,7e-06,31
wikidata.org/wiki/Special:CentralAuth?target=NiteshSingh6789,,4,0,4,7e-06,31
wikidata.org/wiki/Special:EntityPage/Q88088423,,4,0,4,7e-06,31
wikidata.org/wiki/Special:EntityPage/Q6938433,,4,0,4,7e-06,31
en.wikipedia.org/w/index.php?title=User:NiteshSingh6789&action=edit&redlink=1,,4,0,4,7e-06,31
en.wikipedia.org/wiki/User:Estavrionto/EstaHistory,,1,0,1,7e-06,31
en.m.wikipedia.org/w/index.php?title=File:IIT_Kanpur.jpg&mobileaction=toggle_view_mobile,,1,0,1,7e-06,31
upload.wikimedia.org/wikipedia/commons/thumb/a/a3/Cc.logo.circle.svg/40px-Cc.logo.circle.svg.png,,4,0,4,7e-06,31
upload.wikimedia.org/wikipedia/commons/thumb/5/52/Cc-zero.svg/40px-Cc-zero.svg.png,,4,0,4,7e-06,31
en.wikipedia.org/w/index.php?title=Special:CreateAccount&returnto=File%3AIIT+Kanpur+3.jpg,,1,0,1,7e-06,31
en.wikipedia.org/w/index.php?title=Special:UserLogin&returnto=File%3AIIT+Kanpur+3.jpg,,1,0,1,7e-06,31
en.wikipedia.org/w/index.php?title=File_talk:IIT_Kanpur_3.jpg&action=edit&redlink=1,,1,0,1,7e-06,31
en.wikipedia.org/wiki/Special:WhatLinksHere/File:IIT_Kanpur_3.jpg,,1,0,1,7e-06,31
en.wikipedia.org/w/index.php?title=File:IIT_Kanpur_3.jpg&action=info,,1,0,1,7e-06,31
upload.wikimedia.org/wikipedia/commons/c/c9/IIT_Kanpur_3.jpg,,1,0,1,7e-06,31
upload.wikimedia.org/wikipedia/commons/thumb/c/c9/IIT_Kanpur_3.jpg/800px-IIT_Kanpur_3.jpg,,1,0,1,7e-06,31
upload.wikimedia.org/wikipedia/commons/thumb/c/c9/IIT_Kanpur_3.jpg/330px-IIT_Kanpur_3.jpg,,1,0,1,7e-06,31
upload.wikimedia.org/wikipedia/commons/thumb/c/c9/IIT_Kanpur_3.jpg/640px-IIT_Kanpur_3.jpg,,1,0,1,7e-06,31
en.m.wikipedia.org/w/index.php?title=File:IIT_Kanpur_3.jpg&mobileaction=toggle_view_mobile,,1,0,1,7e-06,31
en.wikipedia.org/wiki/Special:WhatLinksHere/File:Indian_Institute_of_Technology_Kanpur.jpg,,1,0,1,7e-06,31
en.wikipedia.org/w/index.php?title=File:Indian_Institute_of_Technology_Kanpur.jpg&action=info,,1,0,1,7e-06,31
upload.wikimedia.org/wikipedia/commons/e/e8/Indian_Institute_of_Technology_Kanpur.jpg,,1,0,1,7e-06,31
en.wikipedia.org/wiki/Awadh,,29,0,29,7e-06,31
bn.wikipedia.org/wiki/অযোধ্যা_(অঞ্চল),,1,0,1,7e-06,31
hi.wikipedia.org/wiki/कानपुर,,4,0,4,7e-06,31
incubator.wikimedia.org/wiki/Wp/mag/अवध,,1,0,1,7e-06,31
flickr.com/photos/47818146@N05/4385586035/,,1,0,1,7e-06,31
commons.wikimedia.org/wiki/User:Ekabhishek,,1,0,1,7e-06,31
flickr.com/people/47818146@N05,,1,0,1,7e-06,31
creativecommons.org/licenses/by/2.0/deed.en,,1,0,1,7e-06,31
en.wikipedia.org/wiki/Flickr,,1,0,1,7e-06,31
commons.wikimedia.org/wiki/Commons:A,,1,0,1,7e-06,31
commons.wikimedia.org/wiki/Commons:License_review,,1,0,1,7e-06,31
commons.wikimedia.org/wiki/User:File_Upload_Bot_(Magnus_Manske),,1,0,1,7e-06,31
wikidata.org/wiki/Special:EntityPage/P3267,,1,0,1,7e-06,31
flickr.com/people/47818146%40N05,,1,0,1,7e-06,31
wikidata.org/wiki/Special:EntityPage/P1433,,1,0,1,7e-06,31
wikidata.org/wiki/Special:EntityPage/Q103204,,1,0,1,7e-06,31
wikidata.org/wiki/Special:EntityPage/P577,,1,0,1,7e-06,31
wikidata.org/wiki/Special:EntityPage/Q19125117,,1,0,1,7e-06,31
wikidata.org/wiki/Special:EntityPage/P6757,,1,0,1,7e-06,31
wikidata.org/wiki/Special:EntityPage/P6790,,1,0,1,7e-06,31
wikidata.org/wiki/Special:EntityPage/P2151,,1,0,1,7e-06,31
wikidata.org/wiki/Special:EntityPage/P6789,,1,0,1,7e-06,31
wikidata.org/wiki/Special:EntityPage/P31,,1,0,1,7e-06,31
wikidata.org/wiki/Special:EntityPage/Q125191,,1,0,1,7e-06,31
wikidata.org/wiki/Special:EntityPage/Q74228490,,1,0,1,7e-06,31
wikidata.org/wiki/Special:EntityPage/P137,,1,0,1,7e-06,31
wikidata.org/wiki/Special:EntityPage/P973,,1,0,1,7e-06,31
flickr.com/photos/47818146@N05/4385586035,,1,0,1,7e-06,31
wikidata.org/wiki/Special:EntityPage/P12120,,1,0,1,7e-06,31
flickr.com/photo.gne?id=4385586035,,1,0,1,7e-06,31
en.wikipedia.org/w/index.php?title=User:File_Upload_Bot_(Magnus_Manske)&action=edit&redlink=1,,1,0,1,7e-06,31
en.wikipedia.org/wiki/User:Ekabhishek,,2,0,2,7e-06,31
en.wikipedia.org/wiki/FUJIFILM,,1,0,1,7e-06,31
en.wikipedia.org/wiki/FinePix_F31fd,,1,0,1,7e-06,31
en.wikipedia.org/wiki/Shutter_speed,,1,0,1,7e-06,31
en.wikipedia.org/wiki/F-number,,1,0,1,7e-06,31
en.wikipedia.org/wiki/Film_speed,,2,0,2,7e-06,31
en.wikipedia.org/wiki/Focal_length,,1,0,1,7e-06,31
en.wikipedia.org/w/index.php?title=Digital_Camera_FinePix_F31fd_Ver1.00&action=edit&redlink=1,,1,0,1,7e-06,31
en.wikipedia.org/wiki/Exchangeable_image_file_format,,1,0,1,7e-06,31
en.wikipedia.org/wiki/Exposure_compensation,,1,0,1,7e-06,31
en.wikipedia.org/wiki/Metering_mode,,1,0,1,7e-06,31
en.wikipedia.org/wiki/Flash_(photography),,1,0,1,7e-06,31
en.wikipedia.org/wiki/Color_space,,1,0,1,7e-06,31
en.wikipedia.org/wiki/Color_balance,,1,0,1,7e-06,31
en.wikipedia.org/wiki/Acutance,,1,0,1,7e-06,31
en.wikipedia.org/wiki/Special:WhatLinksHere/File:Computer_Center_at_IIT_Kanpur_India1.jpg,,1,0,1,7e-06,31
en.wikipedia.org/w/index.php?title=File:Computer_Center_at_IIT_Kanpur_India1.jpg&action=info,,1,0,1,7e-06,31
upload.wikimedia.org/wikipedia/commons/b/b7/Computer_Center_at_IIT_Kanpur_India1.jpg,,1,0,1,7e-06,31
commons.wikimedia.org/w/index.php?title=User:Dr_Vinamra&action=edit&redlink=1,,1,0,1,7e-06,31
wikidata.org/wiki/Special:CentralAuth?target=Dr%20Vinamra,,1,0,1,7e-06,31
commons.wikimedia.org/wiki/User:Dr_Vinamra,,1,0,1,7e-06,31
en.wikipedia.org/w/index.php?title=User:Dr_Vinamra&action=edit&redlink=1,,1,0,1,7e-06,31
en.wikipedia.org/w/index.php?title=Special:CreateAccount&returnto=File%3AIIT+Kanpur+4.jpg,,1,0,1,7e-06,31
en.wikipedia.org/w/index.php?title=Special:UserLogin&returnto=File%3AIIT+Kanpur+4.jpg,,1,0,1,7e-06,31
en.wikipedia.org/w/index.php?title=File_talk:IIT_Kanpur_4.jpg&action=edit&redlink=1,,1,0,1,7e-06,31
en.wikipedia.org/wiki/Special:WhatLinksHere/File:IIT_Kanpur_4.jpg,,1,0,1,7e-06,31
en.wikipedia.org/w/index.php?title=File:IIT_Kanpur_4.jpg&action=info,,1,0,1,7e-06,31
upload.wikimedia.org/wikipedia/commons/f/fd/IIT_Kanpur_4.jpg,,1,0,1,7e-06,31
upload.wikimedia.org/wikipedia/commons/thumb/f/fd/IIT_Kanpur_4.jpg/800px-IIT_Kanpur_4.jpg,,1,0,1,7e-06,31
upload.wikimedia.org/wikipedia/commons/thumb/f/fd/IIT_Kanpur_4.jpg/330px-IIT_Kanpur_4.jpg,,1,0,1,7e-06,31
upload.wikimedia.org/wikipedia/commons/thumb/f/fd/IIT_Kanpur_4.jpg/640px-IIT_Kanpur_4.jpg,,1,0,1,7e-06,31
en.m.wikipedia.org/w/index.php?title=File:IIT_Kanpur_4.jpg&mobileaction=toggle_view_mobile,,1,0,1,7e-06,31
en.wikipedia.org/wiki/Category:Use_dmy_dates_from_December_2015,,12,0,12,7e-06,31
en.wikipedia.org/wiki/Category:Use_Indian_English_from_December_2015,,13,0,13,7e-06,31
hi.wikipedia.org/wiki/गणेश_शंकर_विद्यार्थी_मेडिकल_कॉलेज,,1,0,1,6e-06,31
ml.wikipedia.org/wiki/ഗണേഷ്_ശങ്കർ_വിദ്യാർത്ഥി_മെമ്മോറിയൽ_മെഡിക്കൽ_കോളേജ്,,1,0,1,6e-06,31
wikidata.org/wiki/Special:EntityPage/Q5520850,,1,0,1,6e-06,31
en.wikipedia.org/wiki/Talk:Ganesh_Shankar_Vidyarthi_Memorial_Medical_College,,1,0,1,6e-06,31
en.wikipedia.org/w/index.php?title=Ganesh_Shankar_Vidyarthi_Memorial_Medical_College&action=edit,,1,0,1,6e-06,31
en.wikipedia.org/w/index.php?title=Ganesh_Shankar_Vidyarthi_Memorial_Medical_College&action=history,,1,0,1,6e-06,31
en.wikipedia.org/wiki/Special:WhatLinksHere/Ganesh_Shankar_Vidyarthi_Memorial_Medical_College,,1,0,1,6e-06,31
en.wikipedia.org/wiki/Special:RecentChangesLinked/Ganesh_Shankar_Vidyarthi_Memorial_Medical_College,,1,0,1,6e-06,31
en.wikipedia.org/w/index.php?title=Ganesh_Shankar_Vidyarthi_Memorial_Medical_College&action=info,,1,0,1,6e-06,31
en.wikipedia.org/w/index.php?title=Ganesh_Shankar_Vidyarthi_Memorial_Medical_College&printable=yes,,1,0,1,6e-06,31
en.wikipedia.org/wiki/File:GSVM_Kanpur.jpg,,1,0,1,6e-06,31
en.wikipedia.org/wiki/Principal_(academia),,8,0,8,7e-06,31
gsvmmedicalcollege.com/,,1,0,1,6e-06,31
en.wikipedia.org/wiki/Medical_college,,2,0,2,6e-06,31
en.wikipedia.org/wiki/Ganesh_Shankar_Vidyarthi,,6,0,6,7e-06,31
en.wikipedia.org/wiki/Freedom_fighters_of_India,,1,0,1,6e-06,31
en.wikipedia.org/wiki/File:Academic_Block_GSVM.jpg,,1,0,1,6e-06,31
en.wikipedia.org/wiki/Lala_Lajpat_Rai_Hospital,,4,0,4,6e-06,31
"en.wikipedia.org/wiki/File:Emergency_Block,_GSVM_Kanpur.jpg",,1,0,1,6e-06,31
"en.wikipedia.org/wiki/File:LPS_Institute_of_Cardiology,_GSVM_Kanpur.jpg",,1,0,1,6e-06,31
en.wikipedia.org/wiki/File:GSVM_Super-speciality_Post-Graduate_Institute.jpg,,1,0,1,6e-06,31
en.wikipedia.org/wiki/Kanpur_University,,4,0,4,7e-06,31
en.wikipedia.org/wiki/File:Gsvm_Main_gate.jpg,,1,0,1,6e-06,31
en.wikipedia.org/wiki/File:Boys_Hostel_1.jpg,,1,0,1,6e-06,31
en.wikipedia.org/wiki/File:Boys_Hostel_1_GSVM.jpg,,1,0,1,6e-06,31
en.wikipedia.org/wiki/Uttar_Pradesh_Provincial_Armed_Constabulary,,1,0,1,6e-06,31
en.wikipedia.org/wiki/Alpha_Hospital_Group,,1,0,1,6e-06,31
en.wikipedia.org/wiki/Minister_of_Health_and_Family_Welfare_(India),,1,0,1,6e-06,31
en.wikipedia.org/wiki/Satendra_Singh_(doctor),,1,0,1,6e-06,31
en.wikipedia.org/wiki/Henry_Viscardi_Achievement_Awards,,1,0,1,6e-06,31
en.wikipedia.org/wiki/Ashutosh_Tewari,,1,0,1,6e-06,31
en.wikipedia.org/wiki/Urology,,1,0,1,6e-06,31
"en.wikipedia.org/wiki/Mount_Sinai_Hospital,_New_York",,1,0,1,6e-06,31
en.wikipedia.org/wiki/Dr._B._C._Roy_Award,,1,0,1,6e-06,31
gsvmmedicalcollege.com/history/,,1,0,1,6e-06,31
timesofindia.indiatimes.com/city/kanpur/sp-mla-beaten-up-by-junior-doctors/articleshow/31186170.cms,,1,0,1,6e-06,31
web.archive.org/web/20180705233532/http://pmssy-mohfw.nic.in/Phase3.aspx,,1,0,1,6e-06,31
pmssy-mohfw.nic.in/Phase3.aspx,,1,0,1,6e-06,31
wikidata.org/wiki/Q5520850,,1,0,1,6e-06,31
isni.org/isni/0000000100251377,,1,0,1,6e-06,31
viaf.org/viaf/149043558,,1,0,1,6e-06,31
id.loc.gov/authorities/n89108651,,1,0,1,6e-06,31
en.wikipedia.org/wiki/Category:Medical_colleges_in_Uttar_Pradesh,,3,0,3,7e-06,31
en.wikipedia.org/wiki/Category:1956_establishments_in_Uttar_Pradesh,,2,0,2,7e-06,31
upload.wikimedia.org/wikipedia/en/thumb/1/1e/GSVM_Kanpur.jpg/250px-GSVM_Kanpur.jpg,,1,0,1,6e-06,31
upload.wikimedia.org/wikipedia/commons/thumb/6/67/Gsvm_Main_gate.jpg/250px-Gsvm_Main_gate.jpg,,1,0,1,6e-06,31
upload.wikimedia.org/wikipedia/commons/thumb/6/6e/Boys_Hostel_1.jpg/250px-Boys_Hostel_1.jpg,,1,0,1,6e-06,31
en.wikipedia.org/wiki/Amritsar,,11,0,11,7e-06,31
en.wikipedia.org/wiki/Ministry_of_Science_and_Technology_(India),,7,0,7,7e-06,31
en.wikipedia.org/wiki/Department_of_Biotechnology,,10,0,10,7e-06,31
en.wikipedia.org/wiki/Vadodara,,9,0,9,7e-06,31
en.wikipedia.org/wiki/Category:Official_website_not_in_Wikidata,,2,0,2,6e-06,31
en.wikipedia.org/wiki/Help:IPA/Hindi_and_Urdu,,15,0,15,7e-06,31
en.wikipedia.org/wiki/Ghee,,6,0,6,7e-06,31
en.wikipedia.org/wiki/Category:Pages_with_Hindi_IPA,,12,0,12,7e-06,31
en.wikipedia.org/w/index.php?title=Special:CreateAccount&returnto=Ganges+Barrage,,1,0,1,6e-06,31
en.wikipedia.org/w/index.php?title=Special:UserLogin&returnto=Ganges+Barrage,,1,0,1,6e-06,31
wikidata.org/wiki/Special:EntityPage/Q5521119,,1,0,1,6e-06,31
en.wikipedia.org/wiki/Talk:Ganges_Barrage,,1,0,1,6e-06,31
en.wikipedia.org/w/index.php?title=Ganges_Barrage&action=edit,,1,0,1,6e-06,31
en.wikipedia.org/w/index.php?title=Ganges_Barrage&action=history,,1,0,1,6e-06,31
en.wikipedia.org/wiki/Special:WhatLinksHere/Ganges_Barrage,,1,0,1,6e-06,31
en.wikipedia.org/wiki/Special:RecentChangesLinked/Ganges_Barrage,,1,0,1,6e-06,31
en.wikipedia.org/w/index.php?title=Ganges_Barrage&oldid=1265313029,,1,0,1,6e-06,31
en.wikipedia.org/w/index.php?title=Ganges_Barrage&action=info,,1,0,1,6e-06,31
en.wikipedia.org/w/index.php?title=Ganges_Barrage&printable=yes,,1,0,1,6e-06,31
en.wikipedia.org/wiki/File:GangaBarrage.jpg,,1,0,1,6e-06,31
en.wikipedia.org/wiki/Special:Map/10/26.5099/80.3186/en,,1,0,1,6e-06,31
en.wikipedia.org/wiki/Ganges_River,,4,0,4,7e-06,31
en.wikipedia.org/wiki/NH_91,,2,0,2,6e-06,31
en.wikipedia.org/wiki/Trans_Ganga_City,,1,0,1,6e-06,31
en.wikipedia.org/w/index.php?title=Ganges_Barrage&action=edit&section=1,,1,0,1,6e-06,31
en.wikipedia.org/w/index.php?title=Ganges_Barrage&action=edit&section=2,,1,0,1,6e-06,31
en.wikipedia.org/w/index.php?title=Ganges_Barrage&action=edit&section=3,,1,0,1,6e-06,31
en.wikipedia.org/wiki/UP_State_Industrial_Development_Corporation,,1,0,1,6e-06,31
en.wikipedia.org/w/index.php?title=Ganges_Barrage&action=edit&section=4,,1,0,1,6e-06,31
en.wikipedia.org/w/index.php?title=Ganges_Barrage&action=edit&section=5,,1,0,1,6e-06,31
en.wikipedia.org/w/index.php?title=Ganges_Barrage&action=edit&section=6,,1,0,1,6e-06,31
en.wikipedia.org/w/index.php?title=Ganges_Barrage&action=edit&section=7,,1,0,1,6e-06,31
en.wikipedia.org/w/index.php?title=Ganges_Barrage&action=edit&section=8,,1,0,1,6e-06,31
web.archive.org/web/20090410005442/http://kanpurcommissioner.up.nic.in/gangabarrage.htm,,1,0,1,6e-06,31
kanpurcommissioner.up.nic.in/gangabarrage.htm,,1,0,1,6e-06,31
pressreader.com/india/hindustan-times-lucknow/20160429/281874412600100,,1,0,1,6e-06,31
timesofindia.indiatimes.com/city/lucknow/Kanpur-to-get-new-bus-station/articleshow/52767500.cms,,1,0,1,6e-06,31
en.wikipedia.org/wiki/Template:Hydrography_of_Uttar_Pradesh,,10,0,10,7e-06,31
en.wikipedia.org/wiki/Template_talk:Hydrography_of_Uttar_Pradesh,,10,0,10,7e-06,31
en.wikipedia.org/wiki/Special:EditPage/Template:Hydrography_of_Uttar_Pradesh,,10,0,10,7e-06,31
en.wikipedia.org/wiki/Ghaghara_River,,14,0,14,7e-06,31
en.wikipedia.org/wiki/Betwa_River,,12,0,12,7e-06,31
en.wikipedia.org/wiki/Dhasan_River,,11,0,11,7e-06,31
en.wikipedia.org/wiki/Jamni_River,,11,0,11,7e-06,31
en.wikipedia.org/wiki/Kanhar_River,,11,0,11,7e-06,31
en.wikipedia.org/wiki/Karmanasa_River,,13,0,13,7e-06,31
en.wikipedia.org/wiki/Ken_River,,11,0,11,7e-06,31
en.wikipedia.org/wiki/Rihand_River,,11,0,11,7e-06,31
en.wikipedia.org/wiki/Son_River,,13,0,13,7e-06,31
en.wikipedia.org/wiki/Tamsa_River,,10,0,10,7e-06,31
en.wikipedia.org/wiki/Assi_River,,10,0,10,7e-06,31
en.wikipedia.org/wiki/Babai_River,,10,0,10,7e-06,31
en.wikipedia.org/wiki/Gaula_River_(India),,10,0,10,7e-06,31
en.wikipedia.org/wiki/Gomti_River,,17,0,17,7e-06,31
en.wikipedia.org/wiki/Hindon_River,,13,0,13,7e-06,31
en.wikipedia.org/wiki/Kukarail_River,,10,0,10,7e-06,31
en.wikipedia.org/wiki/Rohni_River,,10,0,10,7e-06,31
en.wikipedia.org/wiki/Sharda_River,,13,0,13,7e-06,31
en.wikipedia.org/wiki/Varuna_River,,10,0,10,7e-06,31
en.wikipedia.org/wiki/West_Rapti_River,,13,0,13,7e-06,31
en.wikipedia.org/wiki/Barua_Sagar_Tal,,11,0,11,7e-06,31
en.wikipedia.org/wiki/Belasagar_Lake,,11,0,11,7e-06,31
en.wikipedia.org/wiki/Chittaura_Jheel,,11,0,11,7e-06,31
en.wikipedia.org/wiki/Keetham_Lake,,15,0,15,7e-06,31
en.wikipedia.org/wiki/Raja_Ka_Tal,,10,0,10,7e-06,31
en.wikipedia.org/wiki/Phulhar_Lake,,10,0,10,7e-06,31
en.wikipedia.org/wiki/Matatila_Dam,,11,0,11,7e-06,31
en.wikipedia.org/wiki/Parichha_Dam,,11,0,11,7e-06,31
en.wikipedia.org/wiki/Rajghat_Dam,,11,0,11,7e-06,31
en.wikipedia.org/wiki/Rihand_Dam,,11,0,11,7e-06,31
en.wikipedia.org/wiki/Lower_Sharda_Barrage,,10,0,10,7e-06,31
en.wikipedia.org/wiki/Ganges_Canal,,14,0,14,7e-06,31
en.wikipedia.org/wiki/Agra_Canal,,12,0,12,7e-06,31
en.wikipedia.org/wiki/Shahi_Bridge,,10,0,10,7e-06,31
en.wikipedia.org/wiki/Aciravati,,11,0,11,7e-06,31
en.wikipedia.org/wiki/Charmanwati,,10,0,10,7e-06,31
en.wikipedia.org/wiki/Sarasvati_River,,13,0,13,7e-06,31
en.wikipedia.org/wiki/Triveni_Sangam,,13,0,13,7e-06,31
en.wikipedia.org/wiki/Category:Buildings_and_structures_in_Kanpur,,5,0,5,7e-06,31
en.wikipedia.org/wiki/Category:Barrages_in_India,,1,0,1,6e-06,31
en.wikipedia.org/wiki/Category:Weirs,,1,0,1,6e-06,31
en.wikipedia.org/wiki/Category:Dams_in_Uttar_Pradesh,,1,0,1,6e-06,31
en.wikipedia.org/wiki/Category:Bridges_over_the_Ganges,,1,0,1,6e-06,31
en.wikipedia.org/wiki/Category:Dams_completed_in_2000,,1,0,1,6e-06,31
en.wikipedia.org/wiki/Category:2000_establishments_in_Uttar_Pradesh,,5,0,5,7e-06,31
en.wikipedia.org/wiki/Category:Transport_in_Kanpur,,7,0,7,7e-06,31
en.wikipedia.org/wiki/Category:Use_Indian_English_from_August_2017,,4,0,4,7e-06,31
en.wikipedia.org/wiki/Category:Pages_using_infobox_dam_which_are_not_about_dams,,1,0,1,6e-06,31
en.m.wikipedia.org/w/index.php?title=Ganges_Barrage&mobileaction=toggle_view_mobile,,1,0,1,6e-06,31
upload.wikimedia.org/wikipedia/commons/thumb/7/72/GangaBarrage.jpg/250px-GangaBarrage.jpg,,1,0,1,6e-06,31
upload.wikimedia.org/wikipedia/commons/thumb/7/72/GangaBarrage.jpg/960px-GangaBarrage.jpg,,1,0,1,6e-06,31
en.wikipedia.org/wiki/List_of_ministries_and_departments_of_the_Government_of_India,,2,0,2,6e-06,31
en.wikipedia.org/wiki/District_Courts_of_India,,7,0,7,6e-06,31
en.wikipedia.org/wiki/Elections_in_India,,18,0,18,7e-06,31
en.wikipedia.org/wiki/List_of_constituencies_of_the_Lok_Sabha,,19,0,19,7e-06,31
en.wikipedia.org/wiki/2024_Indian_general_election,,11,0,11,7e-06,31
en.wikipedia.org/wiki/Administrative_divisions_of_India,,34,0,34,7e-06,31
en.wikipedia.org/wiki/List_of_state_and_union_territory_capitals_in_India,,22,0,22,7e-06,31
en.wikipedia.org/wiki/List_of_million-plus_urban_agglomerations_in_India,,9,0,9,7e-06,31
en.wikipedia.org/wiki/South_Asia,,7,0,7,6e-06,31
"en.wikipedia.org/wiki/Gilbert_Elliot-Murray-Kynynmound,_4th_Earl_of_Minto",,3,0,3,6e-06,31
en.wikipedia.org/wiki/Union_Public_Service_Commission,,6,0,6,6e-06,31
en.wikipedia.org/wiki/Civil_law_(common_law),,2,0,2,6e-06,31
en.wikipedia.org/wiki/Indian_Penal_Code,,8,0,8,7e-06,31
en.wikipedia.org/wiki/Code_of_Criminal_Procedure_(India),,3,0,3,7e-06,31
en.wikipedia.org/wiki/Attorney_General_of_India,,3,0,3,6e-06,31
en.wikipedia.org/wiki/Comptroller_and_Auditor_General_of_India,,10,0,10,7e-06,31
en.wikipedia.org/wiki/Department_of_Atomic_Energy,,12,0,12,7e-06,31
en.wikipedia.org/wiki/Ministry_of_Food_Processing_Industries,,7,0,7,6e-06,31
en.wikipedia.org/wiki/Ministry_of_Minority_Affairs,,10,0,10,7e-06,31
en.wikipedia.org/wiki/Department_of_Science_and_Technology_(India),,18,0,18,7e-06,31
en.wikipedia.org/wiki/International_Alphabet_of_Sanskrit_Transliteration,,7,0,7,6e-06,31
en.wikipedia.org/wiki/Ex-officio,,3,0,3,6e-06,31
en.wikipedia.org/wiki/Corruption_in_India,,6,0,6,7e-06,31
en.wikipedia.org/wiki/Special:BookSources/978-9339204785,,6,0,6,6e-06,31
en.wikipedia.org/wiki/Special:BookSources/9788125019886,,4,0,4,6e-06,31
en.wikipedia.org/wiki/East_India_Company,,17,0,17,7e-06,31
en.wikipedia.org/wiki/Battle_of_Plassey,,9,0,9,6e-06,31
en.wikipedia.org/wiki/Rail_transport_in_India,,6,0,6,6e-06,31
en.wikipedia.org/wiki/Indo-Gangetic_Plain,,14,0,14,7e-06,31
en.wikipedia.org/wiki/Central_India,,8,0,8,7e-06,31
en.wikipedia.org/wiki/East_India,,6,0,6,6e-06,31
en.wikipedia.org/wiki/South_India,,11,0,11,7e-06,31
en.wikipedia.org/wiki/Law_enforcement_in_India,,6,0,6,7e-06,31
en.wikipedia.org/wiki/List_of_scandals_in_India,,6,0,6,7e-06,31
en.wikipedia.org/wiki/Economy_of_India,,9,0,9,7e-06,31
en.wikipedia.org/wiki/Demographics_of_India,,13,0,13,7e-06,31
en.wikipedia.org/wiki/Economy_of_Uttar_Pradesh,,17,0,17,7e-06,31
en.wikipedia.org/wiki/Automotive_industry_in_India,,7,0,7,7e-06,31
en.wikipedia.org/wiki/Transport_in_India,,8,0,8,7e-06,31
en.wikipedia.org/wiki/Crime_in_India,,6,0,6,7e-06,31
en.wikipedia.org/wiki/Literacy_in_India,,15,0,15,7e-06,31
en.wikipedia.org/wiki/Women_in_India,,11,0,11,7e-06,31
en.wikipedia.org/wiki/Advocate_general_(India),,2,0,2,6e-06,31
"en.wikipedia.org/wiki/Member_of_Parliament,_Lok_Sabha",,16,0,16,7e-06,31
en.wikipedia.org/wiki/Nitin_Gadkari,,5,0,5,7e-06,31
en.wikipedia.org/wiki/Category:Use_Indian_English_from_December_2023,,3,0,3,7e-06,31
en.wikipedia.org/wiki/Planning,,4,0,4,6e-06,31
en.wikipedia.org/wiki/Information_technology,,11,0,11,7e-06,31
en.wikipedia.org/wiki/Council_of_Scientific_and_Industrial_Research,,11,0,11,7e-06,31
en.wikipedia.org/wiki/BITS_Pilani,,5,0,5,7e-06,31
en.wikipedia.org/wiki/Delhi_Metro_Rail_Corporation,,10,0,10,7e-06,31
en.wikipedia.org/wiki/Motilal_Nehru_National_Institute_of_Technology,,13,0,13,7e-06,31
en.wikipedia.org/w/index.php?title=Special:CreateAccount&returnto=H.+K.+Kesavan,,1,0,1,6e-06,31
en.wikipedia.org/w/index.php?title=Special:UserLogin&returnto=H.+K.+Kesavan,,1,0,1,6e-06,31
arz.wikipedia.org/wiki/هيرماجالور_كريشناسوامى_كيشافان,,1,0,1,6e-06,31
wikidata.org/wiki/Special:EntityPage/Q5628337,,1,0,1,6e-06,31
en.wikipedia.org/wiki/H._K._Kesavan,,1,0,1,6e-06,31
en.wikipedia.org/wiki/Talk:H._K._Kesavan,,1,0,1,6e-06,31
en.wikipedia.org/w/index.php?title=H._K._Kesavan&action=edit,,1,0,1,6e-06,31
en.wikipedia.org/w/index.php?title=H._K._Kesavan&action=history,,1,0,1,6e-06,31
en.wikipedia.org/wiki/Special:WhatLinksHere/H._K._Kesavan,,1,0,1,6e-06,31
en.wikipedia.org/wiki/Special:RecentChangesLinked/H._K._Kesavan,,1,0,1,6e-06,31
en.wikipedia.org/w/index.php?title=H._K._Kesavan&oldid=1284650806,,1,0,1,6e-06,31
en.wikipedia.org/w/index.php?title=H._K._Kesavan&action=info,,1,0,1,6e-06,31
en.wikipedia.org/w/index.php?title=H._K._Kesavan&printable=yes,,1,0,1,6e-06,31
en.wikipedia.org/wiki/Special:EditPage/H._K._Kesavan,,1,0,1,6e-06,31
"google.com/search?as_eq=wikipedia&q=""H.+K.+Kesavan""",,1,0,1,6e-06,31
"google.com/search?tbm=nws&q=""H.+K.+Kesavan""+-wikipedia&tbs=ar:1",,1,0,1,6e-06,31
"google.com/search?&q=""H.+K.+Kesavan""&tbs=bkt:s&tbm=bks",,1,0,1,6e-06,31
"google.com/search?tbs=bks:1&q=""H.+K.+Kesavan""+-wikipedia",,1,0,1,6e-06,31
"scholar.google.com/scholar?q=""H.+K.+Kesavan""",,1,0,1,6e-06,31
"jstor.org/action/doBasicSearch?Query=""H.+K.+Kesavan""&acc=on&wc=on",,1,0,1,6e-06,31
en.wikipedia.org/wiki/Indian_name,,2,0,2,6e-06,31
en.wikipedia.org/wiki/Patronymic,,1,0,1,6e-06,31
en.wikipedia.org/wiki/Given_name,,1,0,1,6e-06,31
en.wikipedia.org/wiki/Hiremagalur,,1,0,1,6e-06,31
en.wikipedia.org/wiki/File:HKKesavan2002.jpg,,1,0,1,6e-06,31
"en.wikipedia.org/wiki/Waterloo,_Ontario",,1,0,1,6e-06,31
en.wikipedia.org/wiki/University_Visvesvaraya_College_of_Engineering,,1,0,1,6e-06,31
"en.wikipedia.org/wiki/University_of_Illinois,_Urbana-Champaign",,1,0,1,6e-06,31
en.wikipedia.org/w/index.php?title=Linear_graph_theory&action=edit&redlink=1,,1,0,1,6e-06,31
en.wikipedia.org/w/index.php?title=H._K._Kesavan&action=edit&section=1,,1,0,1,6e-06,31
en.wikipedia.org/wiki/University_of_Illinois,,2,0,2,6e-06,31
en.wikipedia.org/w/index.php?title=H._K._Kesavan&action=edit&section=2,,1,0,1,6e-06,31
en.wikipedia.org/w/index.php?title=H._K._Kesavan&action=edit&section=3,,1,0,1,6e-06,31
en.wikipedia.org/w/index.php?title=H._K._Kesavan&action=edit&section=4,,1,0,1,6e-06,31
en.wikipedia.org/w/index.php?title=H._K._Kesavan&action=edit&section=5,,1,0,1,6e-06,31
en.wikipedia.org/w/index.php?title=H._K._Kesavan&action=edit&section=6,,1,0,1,6e-06,31
en.wikipedia.org/wiki/Vedic,,1,0,1,6e-06,31
en.wikipedia.org/w/index.php?title=H._K._Kesavan&action=edit&section=7,,1,0,1,6e-06,31
theglobeandmail.com/life/facts-and-arguments/lives-lived-hiremagalur-k-kesavan-88/article24486824/,,1,0,1,6e-06,31
sites.google.com/site/hkkesavan/hk-kesavan-publications,,1,0,1,6e-06,31
hkkesavan.com/,,1,0,1,6e-06,31
spiritualeducation.org/people/H.%20K.%20Kesavan,,1,0,1,6e-06,31
en.wikipedia.org/w/index.php?title=H._K._Kesavan&action=edit&section=8,,1,0,1,6e-06,31
ieeexplore.ieee.org/stamp/stamp.jsp?arnumber=4322205,,1,0,1,6e-06,31
wikidata.org/wiki/Q5628337,,1,0,1,6e-06,31
isni.org/isni/0000000117476644,,1,0,1,6e-06,31
viaf.org/viaf/17305699,,1,0,1,6e-06,31
id.oclc.org/worldcat/entity/E39PBJyX4JPPHrPXrgt3BDDg8C,,1,0,1,6e-06,31
d-nb.info/gnd/17410572X,,1,0,1,6e-06,31
id.loc.gov/authorities/n85809141,,1,0,1,6e-06,31
catalogue.bnf.fr/ark:/12148/cb12388262n,,1,0,1,6e-06,31
data.bnf.fr/ark:/12148/cb12388262n,,1,0,1,6e-06,31
nli.org.il/en/authorities/987007441948605171,,1,0,1,6e-06,31
opac.kbr.be/LIBRARY/doc/AUTHORITY/14086374,,1,0,1,6e-06,31
idref.fr/085845787,,1,0,1,6e-06,31
lux.collections.yale.edu/view/person/1d8b9c77-c715-4d9a-a1c0-85c3796a93e2,,1,0,1,6e-06,31
en.wikipedia.org/wiki/Category:University_of_Illinois_alumni,,1,0,1,6e-06,31
en.wikipedia.org/wiki/Category:Michigan_State_University_alumni,,1,0,1,6e-06,31
en.wikipedia.org/wiki/Category:Indian_academics,,1,0,1,6e-06,31
en.wikipedia.org/wiki/Category:Academic_staff_of_the_University_of_Waterloo,,1,0,1,6e-06,31
en.wikipedia.org/wiki/Category:Academic_staff_of_IIT_Kanpur,,2,0,2,7e-06,31
en.wikipedia.org/wiki/Category:1926_births,,1,0,1,6e-06,31
en.wikipedia.org/wiki/Category:2014_deaths,,1,0,1,6e-06,31
en.wikipedia.org/wiki/Category:Indian_expatriates_in_the_United_States,,1,0,1,6e-06,31
en.wikipedia.org/wiki/Category:Indian_expatriates_in_Canada,,1,0,1,6e-06,31
en.wikipedia.org/wiki/Category:Indian_expatriate_academics,,1,0,1,6e-06,31
en.wikipedia.org/wiki/Category:Articles_needing_additional_references_from_April_2018,,1,0,1,6e-06,31
en.wikipedia.org/wiki/Category:Use_dmy_dates_from_April_2018,,2,0,2,7e-06,31
en.wikipedia.org/wiki/Category:Use_Indian_English_from_April_2018,,2,0,2,7e-06,31
en.wikipedia.org/wiki/Category:Articles_with_unsourced_statements_from_September_2021,,1,0,1,6e-06,31
en.m.wikipedia.org/w/index.php?title=H._K._Kesavan&mobileaction=toggle_view_mobile,,1,0,1,6e-06,31
upload.wikimedia.org/wikipedia/commons/thumb/d/df/HKKesavan2002.jpg/250px-HKKesavan2002.jpg,,1,0,1,6e-06,31
en.wikipedia.org/w/index.php?title=Special:CreateAccount&returnto=Help%3AIntroduction,,1,0,1,7e-06,31
en.wikipedia.org/w/index.php?title=Special:UserLogin&returnto=Help%3AIntroduction,,1,0,1,7e-06,31
af.wikipedia.org/wiki/Wikipedia:Welkom_nuwelinge,,1,0,1,7e-06,31
als.wikipedia.org/wiki/Wikipedia:Willkommen,,1,0,1,7e-06,31
ang.wikipedia.org/wiki/Wikipǣdia:Inlǣdung,,1,0,1,7e-06,31
ab.wikipedia.org/wiki/Авикипедиа:Бзиала_шәаабеит,,1,0,1,7e-06,31
ar.wikipedia.org/wiki/مساعدة:مقدمة,,1,0,1,7e-06,31
frp.wikipedia.org/wiki/Vouiquipèdia:Reçua_ux_novéls_vegnus,,1,0,1,7e-06,31
as.wikipedia.org/wiki/ৱিকিপিডিয়া:পৰিচয়_৩,,1,0,1,7e-06,31
av.wikipedia.org/wiki/Википедия:Байбихьи,,1,0,1,7e-06,31
azb.wikipedia.org/wiki/کؤمک:تانیشلیق,,1,0,1,7e-06,31
ban.wikipedia.org/wiki/Wikipédia:Pengantar,,1,0,1,7e-06,31
zh-min-nan.wikipedia.org/wiki/Wikipedia:Hoan-gêng_sin_iōng-chiá,,1,0,1,7e-06,31
map-bms.wikipedia.org/wiki/Wikipedia:Penganter,,1,0,1,7e-06,31
ba.wikipedia.org/wiki/Википедия:Рәхим_итегеҙ,,1,0,1,7e-06,31
bg.wikipedia.org/wiki/Уикипедия:Първи_стъпки,,1,0,1,7e-06,31
bar.wikipedia.org/wiki/Wikipedia:Griaßde,,1,0,1,7e-06,31
bs.wikipedia.org/wiki/Pomoć:Uvod,,1,0,1,7e-06,31
bxr.wikipedia.org/wiki/Википеэди:Морилжо_хайрлыт!,,1,0,1,7e-06,31
ca.wikipedia.org/wiki/Viquipèdia:Introducció,,1,0,1,7e-06,31
"ceb.wikipedia.org/wiki/Wikipedia:Maayong_pag-abot,_higala!",,1,0,1,7e-06,31
cs.wikipedia.org/wiki/Wikipedie:Úvod,,1,0,1,7e-06,31
cy.wikipedia.org/wiki/Wicipedia:Cyflwyniad,,1,0,1,7e-06,31
se.wikipedia.org/wiki/Wikipedia:Bures_boahtin_Wikipediai,,1,0,1,7e-06,31
de.wikipedia.org/wiki/Wikipedia:Starthilfe,,1,0,1,7e-06,31
et.wikipedia.org/wiki/Vikipeedia:Sissejuhatus,,1,0,1,7e-06,31
el.wikipedia.org/wiki/Βοήθεια:Εισαγωγή,,1,0,1,7e-06,31
eo.wikipedia.org/wiki/Vikipedio:Bonvenon_al_Vikipedio,,1,0,1,7e-06,31
eu.wikipedia.org/wiki/Wikipedia:Sarrera,,1,0,1,7e-06,31
fa.wikipedia.org/wiki/راهنما:مقدمه,,1,0,1,7e-06,31
fo.wikipedia.org/wiki/Wikipedia:Vælkomin_nýbyrjari,,1,0,1,7e-06,31
fr.wikipedia.org/wiki/Aide:Premiers_pas,,1,0,1,7e-06,31
ga.wikipedia.org/wiki/Vicipéid:Réamhrá,,1,0,1,7e-06,31
gv.wikipedia.org/wiki/Wikipedia:Roie-raa,,1,0,1,7e-06,31
gd.wikipedia.org/wiki/Uicipeid:Ro-ràdh,,1,0,1,7e-06,31
gl.wikipedia.org/wiki/Axuda:Introdución,,1,0,1,7e-06,31
hy.wikipedia.org/wiki/Վիքիպեդիա:Ներածություն,,1,0,1,7e-06,31
hr.wikipedia.org/wiki/Wikipedija:Dobro_došli,,1,0,1,7e-06,31
gor.wikipedia.org/wiki/Wikipedia:Molumulo,,1,0,1,7e-06,31
id.wikipedia.org/wiki/Wikipedia:Pengantar,,1,0,1,7e-06,31
ia.wikipedia.org/wiki/Wikipedia:Benvenite,,1,0,1,7e-06,31
is.wikipedia.org/wiki/Wikipedia:Kynning,,1,0,1,7e-06,31
he.wikipedia.org/wiki/ויקיפדיה:ברוכים_הבאים,,1,0,1,7e-06,31
jv.wikipedia.org/wiki/Wikipédia:Sugeng_rawuh,,1,0,1,7e-06,31
pam.wikipedia.org/wiki/Wikipedia:Maláus_ko_pû,,1,0,1,7e-06,31
krc.wikipedia.org/wiki/Википедия:Хош_Келигиз!,,1,0,1,7e-06,31
ka.wikipedia.org/wiki/ვიკიპედია:კეთილი_იყოს_თქვენი_მობრძანება,,1,0,1,7e-06,31
ks.wikipedia.org/wiki/مَدَتھ:تَعارُف,,1,0,1,7e-06,31
kk.wikipedia.org/wiki/Уикипедия:Таныстыру,,1,0,1,7e-06,31
ht.wikipedia.org/wiki/Wikipedya:Akèy_nouvo_arivan_yo,,1,0,1,7e-06,31
ku.wikipedia.org/wiki/Wîkîpediya:Gavên_pêşî,,1,0,1,7e-06,31
ky.wikipedia.org/wiki/Жардам:Бет_ачар,,1,0,1,7e-06,31
lld.wikipedia.org/wiki/Aiuto:Prim_vares,,1,0,1,7e-06,31
lad.wikipedia.org/wiki/Ayudo:%27Akdamá,,1,0,1,7e-06,31
lo.wikipedia.org/wiki/ວິກິພີເດຍ:ສອນການໃຊ້ງານ,,1,0,1,7e-06,31
la.wikipedia.org/wiki/Vicipaedia:Salve,,1,0,1,7e-06,31
lv.wikipedia.org/wiki/Vikipēdija:Ievads,,1,0,1,7e-06,31
lb.wikipedia.org/wiki/Wikipedia:Wëllkomm,,1,0,1,7e-06,31
li.wikipedia.org/wiki/Wikipedia:Wilkóm,,1,0,1,7e-06,31
hu.wikipedia.org/wiki/Wikipédia:Bevezetés,,1,0,1,7e-06,31
mai.wikipedia.org/wiki/विकिपिडिया:परिचय,,1,0,1,7e-06,31
mk.wikipedia.org/wiki/Википедија:Вовед,,1,0,1,7e-06,31
mt.wikipedia.org/wiki/Wikipedija:Merħba,,1,0,1,7e-06,31
arz.wikipedia.org/wiki/ويكيبيديا:ترحيب,,1,0,1,7e-06,31
ms.wikipedia.org/wiki/Bantuan:Pengenalan,,1,0,1,7e-06,31
mni.wikipedia.org/wiki/ꯋꯤꯀꯤꯄꯦꯗꯤꯌꯥ:ꯋꯥꯍꯧꯗꯣꯛ,,1,0,1,7e-06,31
mn.wikipedia.org/wiki/Википедиа:Тавтай_морилно_уу,,1,0,1,7e-06,31
my.wikipedia.org/wiki/အကူအညီ:မိတ်ဆက်,,1,0,1,7e-06,31
nl.wikipedia.org/wiki/Help:Inleiding,,1,0,1,7e-06,31
ja.wikipedia.org/wiki/Wikipedia:ウィキペディアへようこそ,,1,0,1,7e-06,31
nap.wikipedia.org/wiki/Ajùto:%27E_primme_passe,,1,0,1,7e-06,31
no.wikipedia.org/wiki/Wikipedia:Introduksjon,,1,0,1,7e-06,31
nn.wikipedia.org/wiki/Wikipedia:Velkomen,,1,0,1,7e-06,31
blk.wikipedia.org/wiki/စွဲးကမ်းကို:မိတ်ဆက်,,1,0,1,7e-06,31
ps.wikipedia.org/wiki/لارښود:پېژند,,1,0,1,7e-06,31
km.wikipedia.org/wiki/ជំនួយ:សេចក្តីផ្តើម,,1,0,1,7e-06,31
nds.wikipedia.org/wiki/Wikipedia:Infos_för_Niege,,1,0,1,7e-06,31
pl.wikipedia.org/wiki/Pomoc:Wstęp,,1,0,1,7e-06,31
ro.wikipedia.org/wiki/Ajutor:Bun_venit,,1,0,1,7e-06,31
rmy.wikipedia.org/wiki/Vikipidiya:Mishto_avilyan,,1,0,1,7e-06,31
qu.wikipedia.org/wiki/Wikipidiya:Allinmi_hamusqaykichik,,1,0,1,7e-06,31
ru.wikipedia.org/wiki/Справка:Введение,,1,0,1,7e-06,31
sa.wikipedia.org/wiki/विकिपीडिया:स्वागतम्,,1,0,1,7e-06,31
sc.wikipedia.org/wiki/Agiudu:Benènnidu,,1,0,1,7e-06,31
"sco.wikipedia.org/wiki/Wikipedia:Walcome,_ane_an_aw",,1,0,1,7e-06,31
scn.wikipedia.org/wiki/Wikipedia:Bimminuti,,1,0,1,7e-06,31
si.wikipedia.org/wiki/උදවු:හැඳින්වීම,,1,0,1,7e-06,31
simple.wikipedia.org/wiki/Wikipedia:Introduction,,1,0,1,7e-06,31
sd.wikipedia.org/wiki/مدد:تعارف,,1,0,1,7e-06,31
sk.wikipedia.org/wiki/Wikipédia:Vitajte_vo_Wikipédii,,1,0,1,7e-06,31
sl.wikipedia.org/wiki/Pomoč:Uvod,,1,0,1,7e-06,31
ckb.wikipedia.org/wiki/ویکیپیدیا:ناساندن,,1,0,1,7e-06,31
sr.wikipedia.org/wiki/Википедија:Добро_дошли,,1,0,1,7e-06,31
su.wikipedia.org/wiki/Wikipedia:Pangwanoh,,1,0,1,7e-06,31
fi.wikipedia.org/wiki/Wikipedia:Tervetuloa_Wikipediaan,,1,0,1,7e-06,31
sv.wikipedia.org/wiki/Wikipedia:Introduktion,,1,0,1,7e-06,31
tl.wikipedia.org/wiki/Wikipedia:Maligayang_pagdating!,,1,0,1,7e-06,31
roa-tara.wikipedia.org/wiki/Aiuto:Bovègne,,1,0,1,7e-06,31
tt.wikipedia.org/wiki/Ярдәм:Википедиягә_рәхим_итегез!,,1,0,1,7e-06,31
shn.wikipedia.org/wiki/ဝီႇၶီႇၽီးတီးယႃး:ႁူဝ်ႁႅၵ်ႈ,,1,0,1,7e-06,31
te.wikipedia.org/wiki/సహాయం:పరిచయం,,1,0,1,7e-06,31
th.wikipedia.org/wiki/วิกิพีเดีย:สอนการใช้งาน,,1,0,1,7e-06,31
tr.wikipedia.org/wiki/Yardım:Giriş,,1,0,1,7e-06,31
udm.wikipedia.org/wiki/Википедия:Нырысьсэ_лыктэмъёслы,,1,0,1,7e-06,31
uk.wikipedia.org/wiki/Довідка:Ознайомлення,,1,0,1,7e-06,31
ug.wikipedia.org/wiki/Wikipedia:خۇش_كېلىپسىز,,1,0,1,7e-06,31
za.wikipedia.org/wiki/Wikipedia:Goekdaej,,1,0,1,7e-06,31
vi.wikipedia.org/wiki/Wikipedia:Chào_mừng_người_mới_đến,,1,0,1,7e-06,31
yi.wikipedia.org/wiki/װיקיפּעדיע:אריינפיר,,1,0,1,7e-06,31
zh.wikipedia.org/wiki/Help:簡介,,1,0,1,7e-06,31
tdd.wikipedia.org/wiki/ᥐᥢ_ᥞᥥᥢᥰ,,1,0,1,7e-06,31
wikidata.org/wiki/Special:EntityPage/Q3945,,1,0,1,7e-06,31
en.wikipedia.org/wiki/Help_talk:Introduction,,1,0,1,7e-06,31
en.wikipedia.org/w/index.php?title=Help:Introduction&action=edit,,1,0,1,7e-06,31
en.wikipedia.org/w/index.php?title=Help:Introduction&action=history,,1,0,1,7e-06,31
en.wikipedia.org/wiki/Special:WhatLinksHere/Help:Introduction,,1,0,1,7e-06,31
en.wikipedia.org/wiki/Special:RecentChangesLinked/Help:Introduction,,1,0,1,7e-06,31
en.wikipedia.org/w/index.php?title=Help:Introduction&oldid=1292068824,,1,0,1,7e-06,31
en.wikipedia.org/w/index.php?title=Help:Introduction&action=info,,1,0,1,7e-06,31
en.wikipedia.org/w/index.php?title=Help:Introduction&printable=yes,,1,0,1,7e-06,31
wikisource.org/wiki/Help:Introduction,,1,0,1,7e-06,31
wikifunctions.org/wiki/Wikifunctions:Introduction,,1,0,1,7e-06,31
en.wikisource.org/wiki/Help:Introduction,,1,0,1,7e-06,31
en.wikiversity.org/wiki/Wikiversity:Welcome,,1,0,1,7e-06,31
en.wikipedia.org/wiki/Wikipedia:Wikipedians,,3,0,3,7e-06,31
en.wikipedia.org/wiki/Help:Introduction_to_Wikipedia,,2,0,2,7e-06,31
en.wikipedia.org/wiki/Help:Introduction_to_policies_and_guidelines/1,,1,0,1,7e-06,31
en.wikipedia.org/wiki/Help:Introduction_to_editing_with_Wiki_Markup/1,,1,0,1,7e-06,31
en.wikipedia.org/wiki/Help:Introduction_to_referencing_with_Wiki_Markup/1,,2,0,2,7e-06,31
en.wikipedia.org/wiki/Help:Introduction_to_images_with_Wiki_Markup/1,,3,0,3,7e-06,31
en.wikipedia.org/wiki/Help:Introduction_to_tables_with_Wiki_Markup/1,,3,0,3,7e-06,31
en.wikipedia.org/wiki/Help:Introduction_to_editing_with_VisualEditor/1,,1,0,1,7e-06,31
en.wikipedia.org/wiki/Help:VisualEditor,,3,0,3,7e-06,31
en.wikipedia.org/wiki/Help:Introduction_to_referencing_with_VisualEditor/1,,1,0,1,7e-06,31
en.wikipedia.org/wiki/Help:Introduction_to_images_with_VisualEditor/1,,1,0,1,7e-06,31
en.wikipedia.org/wiki/Help:Introduction_to_tables_with_VisualEditor/1,,1,0,1,7e-06,31
en.wikipedia.org/wiki/Help:Introduction_to_talk_pages/1,,6,0,6,7e-06,31
en.wikipedia.org/wiki/Help:Introduction_to_navigating_Wikipedia/1,,1,0,1,7e-06,31
en.wikipedia.org/wiki/Help:Introduction_to_the_Manual_of_Style,,1,0,1,7e-06,31
en.wikipedia.org/wiki/Help:Introduction/Conclusion,,1,0,1,7e-06,31
en.wikipedia.org/wiki/Help:Introduction/All,,1,0,1,7e-06,31
en.wikipedia.org/wiki/Wikipedia:Shortcut,,15,0,15,7e-06,31
en.wikipedia.org/wiki/Wikipedia:I,,1,0,1,7e-06,31
en.wikipedia.org/wiki/H:I,,1,0,1,7e-06,31
en.wikipedia.org/wiki/H:INTRO,,1,0,1,7e-06,31
en.wikipedia.org/wiki/Wikipedia:Training/For_students,,1,0,1,7e-06,31
en.wikipedia.org/wiki/Wikipedia:Contributing_to_Wikipedia,,5,0,5,7e-06,31
en.wikipedia.org/wiki/Wikipedia:The_Wikipedia_Adventure,,4,0,4,7e-06,31
en.wikipedia.org/wiki/Help:Getting_started,,5,0,5,7e-06,31
en.wikipedia.org/wiki/Category:Wikipedia_quick_introductions,,2,0,2,7e-06,31
en.wikipedia.org/wiki/Category:Wikipedia_semi-protected_project_pages,,9,0,9,7e-06,31
en.m.wikipedia.org/w/index.php?title=Help:Introduction&mobileaction=toggle_view_mobile,,1,0,1,7e-06,31
en.wikipedia.org/wiki/Wikipedia:Help_desk,,7,0,7,7e-06,31
en.wikipedia.org/wiki/Wikipedia:Teahouse,,6,0,6,7e-06,31
en.wikipedia.org/wiki/Wikipedia:IRC_help_disclaimer,,2,0,2,7e-06,31
en.wikipedia.org/wiki/Wikipedia:WikiProject,,7,0,7,7e-06,31
en.wikipedia.org/wiki/Help:Template,,33,0,33,8e-06,31
en.wikipedia.org/wiki/Wikipedia:Template_documentation,,6,0,6,7e-06,31
en.wikipedia.org/w/index.php?title=Special:UserLogin&returnto=Harcourt+Butler+Technical+University,,3,0,3,6e-06,31
hi.wikipedia.org/wiki/हरकोर्ट_बटलर_प्राविधिक_विश्वविद्यालय,,3,0,3,6e-06,31
wikidata.org/wiki/Special:EntityPage/Q5655014,,3,0,3,6e-06,31
en.wikipedia.org/wiki/Talk:Harcourt_Butler_Technical_University,,3,0,3,6e-06,31
en.wikipedia.org/w/index.php?title=Harcourt_Butler_Technical_University&action=edit,,3,0,3,6e-06,31
en.wikipedia.org/w/index.php?title=Harcourt_Butler_Technical_University&action=history,,3,0,3,6e-06,31
en.wikipedia.org/wiki/Special:WhatLinksHere/Harcourt_Butler_Technical_University,,3,0,3,6e-06,31
en.wikipedia.org/wiki/Special:RecentChangesLinked/Harcourt_Butler_Technical_University,,3,0,3,6e-06,31
en.wikipedia.org/w/index.php?title=Harcourt_Butler_Technical_University&oldid=1309721313,,3,0,3,6e-06,31
en.wikipedia.org/w/index.php?title=Harcourt_Butler_Technical_University&action=info,,3,0,3,6e-06,31
en.wikipedia.org/w/index.php?title=Harcourt_Butler_Technical_University&printable=yes,,3,0,3,6e-06,31
en.wikipedia.org/wiki/File:Harcourt_Butler_Technical_University_Logo_SSH.png,,3,0,3,6e-06,31
en.wikipedia.org/wiki/International_Phonetic_Alphabet,,8,0,8,6e-06,31
en.wikipedia.org/wiki/State_University_(India),,3,0,3,6e-06,31
en.wikipedia.org/wiki/Harcourt_Butler,,5,0,5,7e-06,31
en.wikipedia.org/wiki/Urban_area,,38,0,38,7e-06,31
hbtu.ac.in/,,3,0,3,6e-06,31
"en.wikipedia.org/wiki/Science,_technology,_engineering,_and_mathematics",,9,0,9,7e-06,31
en.wikipedia.org/wiki/Indian_Civil_Service,,3,0,3,6e-06,31
en.wikipedia.org/wiki/Governor,,4,0,4,7e-06,31
en.wikipedia.org/wiki/National_Sugar_Institute,,8,0,8,7e-06,31
en.wikipedia.org/wiki/Edible_oils,,3,0,3,6e-06,31
en.wikipedia.org/w/index.php?title=Harcourt_Butler_Technical_University&action=edit&section=1,,3,0,3,6e-06,31
en.wikipedia.org/w/index.php?title=Harcourt_Butler_Technical_University&action=edit&section=2,,3,0,3,6e-06,31
en.wikipedia.org/wiki/Deputy_commissioner_(India),,3,0,3,6e-06,31
en.wikipedia.org/wiki/Lieutenant_governor,,5,0,5,7e-06,31
en.wikipedia.org/wiki/Sir_John_Hewett,,3,0,3,6e-06,31
en.wikipedia.org/wiki/Knight_Grand_Commander_of_the_Order_of_the_Star_of_India,,3,0,3,6e-06,31
en.wikipedia.org/wiki/Knight_Commander_of_the_Order_of_the_British_Empire,,3,0,3,6e-06,31
en.wikipedia.org/wiki/Companion_of_the_Order_of_the_Indian_Empire,,3,0,3,6e-06,31
en.wikipedia.org/wiki/Royal_Society_of_Painter-Etchers_and_Engravers,,3,0,3,6e-06,31
en.wikipedia.org/wiki/Sugar,,3,0,3,6e-06,31
en.wikipedia.org/wiki/Alkali,,3,0,3,6e-06,31
en.wikipedia.org/wiki/Papermaking,,3,0,3,6e-06,31
en.wikipedia.org/wiki/Textile_bleaching,,3,0,3,6e-06,31
en.wikipedia.org/wiki/Knight_Commander_of_the_Order_of_the_Star_of_India,,3,0,3,6e-06,31
en.wikipedia.org/wiki/Secretary_of_State_for_India,,4,0,4,6e-06,31
en.wikipedia.org/wiki/Morris_Travers,,4,0,4,6e-06,31
en.wikipedia.org/wiki/Fellow_of_the_Royal_Society,,8,0,8,7e-06,31
en.wikipedia.org/wiki/Polytechnic_(United_Kingdom),,4,0,4,6e-06,31
en.wikipedia.org/wiki/India_Office,,4,0,4,6e-06,31
en.wikipedia.org/wiki/Companion_of_the_Order_of_the_Star_of_India,,3,0,3,6e-06,31
en.wikipedia.org/wiki/Officer_of_the_Order_of_the_British_Empire,,3,0,3,6e-06,31
en.wikipedia.org/wiki/Bryce_Chudleigh_Burt,,4,0,4,7e-06,31
en.wikipedia.org/wiki/Order_of_the_British_Empire,,3,0,3,6e-06,31
en.wikipedia.org/wiki/Thomas_Henry_Holland,,3,0,3,6e-06,31
en.wikipedia.org/wiki/Knight_Commander_of_the_Order_of_the_Indian_Empire,,3,0,3,6e-06,31
"en.wikipedia.org/wiki/File:Sir_Harcourt_Butler,_c._1934.png",,3,0,3,6e-06,31
en.wikipedia.org/w/index.php?title=Harcourt_Butler_Technical_University&action=edit&section=3,,3,0,3,6e-06,31
en.wikipedia.org/wiki/List_of_governors_of_the_United_Provinces_of_Agra_and_Oudh,,3,0,3,6e-06,31
en.wikipedia.org/wiki/Fellow_of_the_Institute_of_Chemistry,,3,0,3,6e-06,31
en.wikipedia.org/wiki/Bungalow,,5,0,5,6e-06,31
en.wikipedia.org/wiki/Dye,,3,0,3,6e-06,31
en.wikipedia.org/wiki/Dhaka_College,,3,0,3,6e-06,31
en.wikipedia.org/wiki/C._T._R._Wilson,,3,0,3,6e-06,31
en.wikipedia.org/wiki/Ninhydrin,,3,0,3,6e-06,31
en.wikipedia.org/wiki/Nil_Ratan_Dhar,,3,0,3,6e-06,31
en.wikipedia.org/wiki/File:J.P._Hewett_%26_C.Y._Chintamani.jpg,,3,0,3,6e-06,31
en.wikipedia.org/wiki/C._Y._Chintamani,,3,0,3,6e-06,31
en.wikipedia.org/wiki/Editor-in-Chief,,3,0,3,6e-06,31
en.wikipedia.org/wiki/The_Leader_(Allahabad_newspaper),,5,0,5,7e-06,31
en.wikipedia.org/wiki/Minister_(government),,3,0,3,6e-06,31
en.wikipedia.org/wiki/Knight_Grand_Commander_of_the_Order_of_the_Indian_Empire,,3,0,3,6e-06,31
en.wikipedia.org/wiki/Deputy_Lieutenant,,3,0,3,6e-06,31
en.wikipedia.org/wiki/Fellow_of_the_Royal_Geographical_Society,,3,0,3,6e-06,31
en.wikipedia.org/wiki/Fellow_of_the_Royal_Astronomical_Society,,3,0,3,6e-06,31
en.wikipedia.org/w/index.php?title=Harcourt_Butler_Technical_University&action=edit&section=4,,3,0,3,6e-06,31
en.wikipedia.org/wiki/Nawab,,8,0,8,7e-06,31
en.wikipedia.org/wiki/Muhammad_Ahmad_Said_Khan_Chhatari,,3,0,3,6e-06,31
en.wikipedia.org/wiki/Knight_Grand_Cross_of_the_Order_of_the_British_Empire,,3,0,3,6e-06,31
en.wikipedia.org/wiki/List_of_colonial_governors_of_Burma,,3,0,3,6e-06,31
en.wikipedia.org/wiki/File:HBTI_Old_Pic_v3.jpg,,3,0,3,6e-06,31
en.wikipedia.org/wiki/Textile,,8,0,8,7e-06,31
en.wikipedia.org/wiki/Grading_in_education,,7,0,7,7e-06,31
en.wikipedia.org/wiki/Test_score,,3,0,3,6e-06,31
en.wikipedia.org/wiki/Gilbert_John_Fowler,,4,0,4,6e-06,31
en.wikipedia.org/wiki/Eastern_world,,3,0,3,6e-06,31
en.wikipedia.org/w/index.php?title=Harcourt_Butler_Technical_University&action=edit&section=5,,3,0,3,6e-06,31
en.wikipedia.org/wiki/Jwala_Prasad_Srivastava,,3,0,3,6e-06,31
"en.wikipedia.org/wiki/National_Academy_of_Sciences,_India",,5,0,5,6e-06,31
en.wikipedia.org/wiki/File:E.R._Watson_%26_J.A.H._Duke.JPG,,3,0,3,6e-06,31
en.wikipedia.org/wiki/Rao_Saheb,,3,0,3,6e-06,31
en.wikipedia.org/wiki/Indian_Independence_Act_1947,,6,0,6,6e-06,31
en.wikipedia.org/wiki/Essential_oil,,3,0,3,6e-06,31
en.wikipedia.org/wiki/File:HBTI_Courses_1933-34_v2.png,,3,0,3,6e-06,31
en.wikipedia.org/wiki/Jnan_Chandra_Ghosh,,6,0,6,7e-06,31
en.wikipedia.org/wiki/University_college,,3,0,3,6e-06,31
en.wikipedia.org/wiki/Junior_college,,7,0,7,7e-06,31
en.wikipedia.org/w/index.php?title=Harcourt_Butler_Technical_University&action=edit&section=6,,3,0,3,6e-06,31
en.wikipedia.org/wiki/Chittaranjan_Mitra,,3,0,3,6e-06,31
en.wikipedia.org/wiki/Seminar,,3,0,3,6e-06,31
en.wikipedia.org/wiki/File:CR_Mitra_NKR_CC_BY-SA_3.0_v2.jpg,,3,0,3,6e-06,31
"en.wikipedia.org/wiki/Societies_Registration_Act,_1860",,3,0,3,6e-06,31
en.wikipedia.org/wiki/Director_(education),,5,0,5,6e-06,31
en.wikipedia.org/wiki/ICICI_Bank,,6,0,6,6e-06,31
en.wikipedia.org/wiki/IFCI_Ltd,,4,0,4,6e-06,31
en.wikipedia.org/w/index.php?title=Harcourt_Butler_Technical_University&action=edit&section=7,,3,0,3,6e-06,31
en.wikipedia.org/wiki/Dr._A.P.J._Abdul_Kalam_Technical_University,,11,0,11,7e-06,31
en.wikipedia.org/wiki/Student–teacher_ratio,,4,0,4,6e-06,31
en.wikipedia.org/wiki/Center_of_excellence,,4,0,4,6e-06,31
en.wikipedia.org/w/index.php?title=Harcourt_Butler_Technical_University&action=edit&section=8,,3,0,3,6e-06,31
en.wikipedia.org/wiki/File:HBTI_Main_Building.jpg,,3,0,3,6e-06,31
en.wikipedia.org/wiki/Metropolitan_area,,7,0,7,6e-06,31
en.wikipedia.org/wiki/Kanpur_Zoo,,3,0,3,6e-06,31
en.wikipedia.org/wiki/Barrage_(dam),,5,0,5,6e-06,31
en.wikipedia.org/w/index.php?title=Harcourt_Butler_Technical_University&action=edit&section=9,,3,0,3,6e-06,31
en.wikipedia.org/wiki/Orange_Line_(Kanpur_Metro),,8,0,8,7e-06,31
"en.wikipedia.org/wiki/File:HBTI_Main_Building,_2010.jpg",,3,0,3,6e-06,31
en.wikipedia.org/wiki/Workshop,,3,0,3,6e-06,31
en.wikipedia.org/wiki/Welding,,5,0,5,6e-06,31
en.wikipedia.org/wiki/Machining,,3,0,3,6e-06,31
en.wikipedia.org/wiki/Sheet_Metal,,3,0,3,6e-06,31
en.wikipedia.org/wiki/Blacksmith,,3,0,3,6e-06,31
en.wikipedia.org/wiki/Engineering_fit,,3,0,3,6e-06,31
en.wikipedia.org/wiki/State_of_the_art,,3,0,3,6e-06,31
en.wikipedia.org/wiki/Oil_mill,,3,0,3,6e-06,31
en.wikipedia.org/wiki/Online_Public_Access_Catalog,,3,0,3,6e-06,31
en.wikipedia.org/wiki/Electronic_journal,,3,0,3,6e-06,31
en.wikipedia.org/wiki/J-Gate,,3,0,3,6e-06,31
en.wikipedia.org/wiki/Springer_Nature,,4,0,4,6e-06,31
en.wikipedia.org/wiki/Ebook,,3,0,3,6e-06,31
en.wikipedia.org/wiki/Elsevier,,3,0,3,6e-06,31
en.wikipedia.org/wiki/McGraw_Hill_Education,,3,0,3,6e-06,31
en.wikipedia.org/wiki/E-ShodhSindhu,,3,0,3,6e-06,31
en.wikipedia.org/wiki/National_Digital_Library_of_India,,3,0,3,6e-06,31
en.wikipedia.org/wiki/Content_similarity_detection,,3,0,3,6e-06,31
en.wikipedia.org/wiki/Headquarters,,4,0,4,6e-06,31
en.wikipedia.org/wiki/Alaknanda_River,,5,0,5,6e-06,31
en.wikipedia.org/wiki/Mandakini_river,,3,0,3,6e-06,31
en.wikipedia.org/wiki/Gangotri_glacier,,3,0,3,6e-06,31
en.wikipedia.org/wiki/Bhagirathi_River,,5,0,5,6e-06,31
en.wikipedia.org/wiki/Kaveri,,6,0,6,6e-06,31
en.wikipedia.org/wiki/Sridhara,,3,0,3,6e-06,31
en.wikipedia.org/wiki/Srinivasa_Ramanujan,,3,0,3,6e-06,31
en.wikipedia.org/wiki/Gym,,4,0,4,6e-06,31
en.wikipedia.org/wiki/Cafeteria,,3,0,3,6e-06,31
en.wikipedia.org/wiki/Badminton,,9,0,9,7e-06,31
en.wikipedia.org/wiki/Tennis,,5,0,5,6e-06,31
en.wikipedia.org/wiki/Cricket,,15,0,15,7e-06,31
en.wikipedia.org/wiki/Central_Bank_of_India,,6,0,6,6e-06,31
en.wikipedia.org/wiki/Automated_teller_machine,,4,0,4,6e-06,31
en.wikipedia.org/w/index.php?title=Harcourt_Butler_Technical_University&action=edit&section=10,,3,0,3,6e-06,31
en.wikipedia.org/wiki/Aryabhata,,6,0,6,6e-06,31
en.wikipedia.org/wiki/State_Bank_of_India,,14,0,14,7e-06,31
en.wikipedia.org/wiki/Field_hockey,,13,0,13,7e-06,31
en.wikipedia.org/w/index.php?title=Harcourt_Butler_Technical_University&action=edit&section=11,,3,0,3,6e-06,31
en.wikipedia.org/w/index.php?title=Harcourt_Butler_Technical_University&action=edit&section=12,,3,0,3,6e-06,31
en.wikipedia.org/wiki/List_of_governors_of_Uttar_Pradesh,,15,0,15,7e-06,31
en.wikipedia.org/wiki/Ex_officio_member,,5,0,5,6e-06,31
en.wikipedia.org/wiki/Pro-vice-chancellor,,3,0,3,6e-06,31
en.wikipedia.org/wiki/Registrar_(education),,5,0,5,6e-06,31
en.wikipedia.org/wiki/Comptroller,,3,0,3,6e-06,31
en.wikipedia.org/w/index.php?title=Harcourt_Butler_Technical_University&action=edit&section=13,,3,0,3,6e-06,31
en.wikipedia.org/wiki/Vice_Chancellor,,3,0,3,6e-06,31
en.wikipedia.org/wiki/Human_resources,,6,0,6,7e-06,31
en.wikipedia.org/wiki/Facilitator,,3,0,3,6e-06,31
en.wikipedia.org/wiki/Resource,,3,0,3,6e-06,31
en.wikipedia.org/wiki/Continuing_education,,9,0,9,7e-06,31
en.wikipedia.org/w/index.php?title=Harcourt_Butler_Technical_University&action=edit&section=14,,3,0,3,6e-06,31
en.wikipedia.org/wiki/National_Board_of_Accreditation,,14,0,14,7e-06,31
en.wikipedia.org/wiki/World_Bank,,15,0,15,7e-06,31
en.wikipedia.org/wiki/International_Development_Association,,3,0,3,6e-06,31
en.wikipedia.org/wiki/Technical_Education_Quality_Improvement_Programme,,4,0,4,6e-06,31
en.wikipedia.org/w/index.php?title=Harcourt_Butler_Technical_University&action=edit&section=15,,3,0,3,6e-06,31
en.wikipedia.org/wiki/Science_and_Engineering_Research_Board,,3,0,3,6e-06,31
en.wikipedia.org/wiki/Central_Pollution_Control_Board,,3,0,3,6e-06,31
en.wikipedia.org/wiki/Bhabha_Atomic_Research_Centre,,7,0,7,7e-06,31
en.wikipedia.org/wiki/Canadian_International_Development_Agency,,3,0,3,6e-06,31
en.wikipedia.org/wiki/Shastri_Indo-Canadian_Institute,,4,0,4,6e-06,31
en.wikipedia.org/wiki/Lipid,,3,0,3,6e-06,31
en.wikipedia.org/wiki/Current_Science,,6,0,6,6e-06,31
en.wikipedia.org/w/index.php?title=Harcourt_Butler_Technical_University&action=edit&section=16,,3,0,3,6e-06,31
en.wikipedia.org/wiki/Bachelor_of_Business_Administration,,8,0,8,7e-06,31
en.wikipedia.org/wiki/Master_of_Science,,23,0,23,7e-06,31
en.wikipedia.org/wiki/Master_of_Technology,,15,0,15,7e-06,31
en.wikipedia.org/wiki/Computer_Science_%26_Engineering,,5,0,5,7e-06,31
en.wikipedia.org/wiki/Electronic_Engineering,,3,0,3,6e-06,31
en.wikipedia.org/wiki/Biochemical_Engineering,,4,0,4,6e-06,31
en.wikipedia.org/wiki/Food_Technology,,3,0,3,6e-06,31
en.wikipedia.org/wiki/National_Testing_Agency,,9,0,9,7e-06,31
en.wikipedia.org/wiki/Dual_degree,,4,0,4,6e-06,31
en.wikipedia.org/wiki/Data_Science,,4,0,4,6e-06,31
en.wikipedia.org/w/index.php?title=Harcourt_Butler_Technical_University&action=edit&section=17,,3,0,3,6e-06,31
en.wikipedia.org/w/index.php?title=Harcourt_Butler_Technical_University&action=edit&section=18,,3,0,3,6e-06,31
en.wikipedia.org/wiki/File:HBTU_Centenary_Stamp.jpg,,3,0,3,6e-06,31
en.wikipedia.org/wiki/Century,,3,0,3,6e-06,31
en.wikipedia.org/wiki/Anniversary,,3,0,3,6e-06,31
en.wikipedia.org/wiki/Ceremony,,3,0,3,6e-06,31
en.wikipedia.org/wiki/Centennial,,4,0,4,6e-06,31
en.wikipedia.org/wiki/Anandiben_Patel,,4,0,4,6e-06,31
en.wikipedia.org/wiki/File:HBTU_Centenary_Coin.jpg,,3,0,3,6e-06,31
en.wikipedia.org/wiki/Time_capsule,,3,0,3,6e-06,31
en.wikipedia.org/wiki/Commemorative_stamp,,3,0,3,6e-06,31
en.wikipedia.org/wiki/Face_value,,3,0,3,6e-06,31
en.wikipedia.org/wiki/Color_printing,,3,0,3,6e-06,31
en.wikipedia.org/wiki/Label_(philately),,3,0,3,6e-06,31
en.wikipedia.org/wiki/Commemorative_coin,,3,0,3,6e-06,31
en.wikipedia.org/wiki/Denomination_(currency),,3,0,3,6e-06,31
en.wikipedia.org/wiki/Security_Printing_and_Minting_Corporation_of_India,,5,0,5,6e-06,31
"en.wikipedia.org/wiki/India_Government_Mint,_Kolkata",,5,0,5,6e-06,31
en.wikipedia.org/wiki/Silver,,4,0,4,6e-06,31
en.wikipedia.org/wiki/Obverse_and_reverse,,4,0,4,6e-06,31
en.wikipedia.org/wiki/Uncirculated_coin,,3,0,3,6e-06,31
en.wikipedia.org/wiki/Proof_coinage,,3,0,3,6e-06,31
en.wikipedia.org/w/index.php?title=Harcourt_Butler_Technical_University&action=edit&section=19,,3,0,3,6e-06,31
en.wikipedia.org/w/index.php?title=Harcourt_Butler_Technical_University&action=edit&section=20,,3,0,3,6e-06,31
en.wikipedia.org/w/index.php?title=Harcourt_Butler_Technical_University&action=edit&section=21,,3,0,3,6e-06,31
en.wikipedia.org/wiki/National_Service_Scheme,,11,0,11,7e-06,31
en.wikipedia.org/wiki/Media_(communication),,4,0,4,6e-06,31
en.wikipedia.org/wiki/Literature,,10,0,10,7e-06,31
en.wikipedia.org/wiki/Hobby,,3,0,3,6e-06,31
en.wikipedia.org/w/index.php?title=Harcourt_Butler_Technical_University&action=edit&section=22,,3,0,3,6e-06,31
en.wikipedia.org/w/index.php?title=Harcourt_Butler_Technical_University&action=edit&section=23,,3,0,3,6e-06,31
en.wikipedia.org/w/index.php?title=Harcourt_Butler_Technical_University&action=edit&section=24,,3,0,3,6e-06,31
en.wikipedia.org/wiki/Staff_Selection_Commission,,3,0,3,6e-06,31
en.wikipedia.org/wiki/Public_Sector_Undertakings_in_India,,5,0,5,6e-06,31
en.wikipedia.org/wiki/Uttar_Pradesh_Public_Service_Commission,,3,0,3,6e-06,31
en.wikipedia.org/wiki/Uttarakhand_Public_Service_Commission,,5,0,5,6e-06,31
en.wikipedia.org/wiki/Public_Works_Department_(India),,3,0,3,6e-06,31
en.wikipedia.org/wiki/Rapid_transit,,10,0,10,7e-06,31
en.wikipedia.org/wiki/Uttar_Pradesh_Metro_Rail_Corporation,,7,0,7,7e-06,31
en.wikipedia.org/wiki/Noida_Metro,,10,0,10,7e-06,31
en.wikipedia.org/wiki/Uttar_Pradesh_Power_Corporation_Limited,,6,0,6,7e-06,31
en.wikipedia.org/wiki/Uttar_Pradesh_Rajya_Vidyut_Utpadan_Nigam,,4,0,4,6e-06,31
en.wikipedia.org/wiki/Delhi_Development_Authority,,9,0,9,7e-06,31
en.wikipedia.org/wiki/Uttar_Pradesh_State_Industrial_Development_Corporation,,4,0,4,6e-06,31
en.wikipedia.org/w/index.php?title=Harcourt_Butler_Technical_University&action=edit&section=25,,3,0,3,6e-06,31
en.wikipedia.org/w/index.php?title=Harcourt_Butler_Technical_University&action=edit&section=26,,3,0,3,6e-06,31
en.wikipedia.org/w/index.php?title=Harcourt_Butler_Technical_University&action=edit&section=27,,3,0,3,6e-06,31
en.wikipedia.org/w/index.php?title=Harcourt_Butler_Technical_University&action=edit&section=28,,3,0,3,6e-06,31
en.wikipedia.org/wiki/Keshav_Dev_Malviya,,3,0,3,6e-06,31
en.wikipedia.org/wiki/Second_Nehru_ministry,,3,0,3,6e-06,31
en.wikipedia.org/wiki/Third_Nehru_ministry,,3,0,3,6e-06,31
en.wikipedia.org/wiki/Fourth_Nehru_ministry,,3,0,3,6e-06,31
en.wikipedia.org/wiki/Third_Indira_Gandhi_ministry,,3,0,3,6e-06,31
en.wikipedia.org/wiki/Organizational_founder,,3,0,3,6e-06,31
en.wikipedia.org/wiki/Gandhigram_Rural_Institute,,6,0,6,6e-06,31
en.wikipedia.org/wiki/Jamnalal_Bajaj_Award,,6,0,6,7e-06,31
en.wikipedia.org/wiki/Anil_Khandelwal,,3,0,3,6e-06,31
en.wikipedia.org/wiki/Bank_of_Baroda,,8,0,8,7e-06,31
en.wikipedia.org/wiki/L._William_Seidman,,3,0,3,6e-06,31
en.wikipedia.org/wiki/List_of_lifetime_achievement_awards,,3,0,3,6e-06,31
en.wikipedia.org/wiki/The_Asian_Banker,,3,0,3,6e-06,31
en.wikipedia.org/wiki/Alakh_Pandey,,3,0,3,6e-06,31
en.wikipedia.org/wiki/Physics_Wallah,,3,0,3,6e-06,31
en.wikipedia.org/wiki/Unicorn_(finance),,5,0,5,6e-06,31
en.wikipedia.org/wiki/Dinesh_Agarwal,,3,0,3,6e-06,31
en.wikipedia.org/wiki/IndiaMART,,3,0,3,6e-06,31
en.wikipedia.org/wiki/B2B_e-commerce,,3,0,3,6e-06,31
en.wikipedia.org/wiki/Indian_National_Academy_of_Engineering,,8,0,8,7e-06,31
en.wikipedia.org/wiki/Holkar_Science_College,,3,0,3,6e-06,31
en.wikipedia.org/wiki/Anu_Garg,,3,0,3,6e-06,31
en.wikipedia.org/wiki/Encarta,,3,0,3,6e-06,31
en.wikipedia.org/wiki/Mental_Floss,,3,0,3,6e-06,31
en.wikipedia.org/wiki/Weekly_Reader,,3,0,3,6e-06,31
en.wikipedia.org/w/index.php?title=Harcourt_Butler_Technical_University&action=edit&section=29,,3,0,3,6e-06,31
reubique.com/SHAKESPEAR%20J.H.C..htm,,3,0,3,6e-06,31
myjacobfamily.com/favershamjacobs/georgeallen.htm,,3,0,3,6e-06,31
gray-ons.org/secondsite/g0/p849.htm,,3,0,3,6e-06,31
anthony.sogang.ac.kr/CotesFamilyStory.html,,3,0,3,6e-06,31
thegazette.co.uk/Edinburgh/issue/13547/page/27/data.pdf,,3,0,3,6e-06,31
en.wikipedia.org/wiki/Wye_College,,3,0,3,6e-06,31
bahs.org.uk/AGHR/ARTICLES/36n2a5.pdf,,3,0,3,6e-06,31
en.wikipedia.org/wiki/The_Tribune_(India),,3,0,3,6e-06,31
gracesguide.co.uk/Thermal_Syndicate,,3,0,3,6e-06,31
en.wikipedia.org/wiki/British_Army,,5,0,5,6e-06,31
en.wikipedia.org/wiki/Royal_Engineers,,3,0,3,6e-06,31
thegazette.co.uk/London/issue/37016/supplement/1834/data.pdf,,3,0,3,6e-06,31
en.wikipedia.org/wiki/King_George_V_Silver_Jubilee_Medal,,3,0,3,6e-06,31
glikanpur.com/history.php,,3,0,3,6e-06,31
en.wikipedia.org/w/index.php?title=Harcourt_Butler_Technical_University&action=edit&section=30,,3,0,3,6e-06,31
"en.wikipedia.org/wiki/Motilal_Nehru_National_Institute_of_Technology,_Prayagraj",,4,0,4,6e-06,31
en.wikipedia.org/w/index.php?title=Harcourt_Butler_Technical_University&action=edit&section=31,,3,0,3,6e-06,31
upgovernor.gov.in/en/page/state-universities,,3,0,3,6e-06,31
up.gov.in/en/page/institutions,,3,0,3,6e-06,31
upgovernor.gov.in/en/page/chancellor-role-of-governor,,3,0,3,6e-06,31
upgovernor.gov.in/en/page/vice-chancellors-of-universities,,3,0,3,6e-06,31
igniteengineers.com/15-oldest-engineering-colleges-in-india/,,3,0,3,6e-06,31
click4college.com/articles/oldest-engineering-colleges-india,,3,0,3,6e-06,31
web.archive.org/web/20170124000000/http://14.139.60.153/handle/123456789/675,,3,0,3,6e-06,31
14.139.60.153/handle/123456789/675,,3,0,3,6e-06,31
en.wikipedia.org/wiki/Special:BookSources/978-1-02-108178-0,,3,0,3,6e-06,31
archive.org/details/in.ernet.dli.2015.35184/page/n185/mode/2up,,3,0,3,6e-06,31
archive.org/details/in.ernet.dli.2015.86127,,3,0,3,6e-06,31
new.dli.ernet.in/handle/2015/86127,,3,0,3,6e-06,31
archive.org/details/in.ernet.dli.2015.86330,,3,0,3,6e-06,31
new.dli.ernet.in/handle/2015/86330,,3,0,3,6e-06,31
nsi.gov.in/storage/files/1/Prospectus/prospectus.pdf,,3,0,3,6e-06,31
web.archive.org/web/20150417053756/http://nsi.gov.in/Historical.htm,,3,0,3,6e-06,31
nsi.gov.in/Historical.htm,,3,0,3,6e-06,31
web.archive.org/web/20240825214238/https://nsi.gov.in/history.html,,3,0,3,6e-06,31
nsi.gov.in/history.html,,3,0,3,6e-06,31
abhilekh-patal.in/jspui/handle/123456789/2691688,,3,0,3,6e-06,31
en.wikipedia.org/wiki/National_Archives_of_India,,3,0,3,6e-06,31
reck.ac.in/about-college/,,3,0,3,6e-06,31
recmainpuri.in/about-the-college/,,3,0,3,6e-06,31
shramjeevijournalist.com/mainpuri-kannoj-sonbhdra-new-satra/,,3,0,3,6e-06,31
iitk.ac.in/doaa/convocation/data/Back_in_1960.pdf,,3,0,3,6e-06,31
voxiitk.com/iitk-and-its-beginnings/,,3,0,3,6e-06,31
voxiitk.com/vignettes-of-history-abhay-bhushan-reminisces/,,3,0,3,6e-06,31
iitk.ac.in/mse/history.php,,3,0,3,6e-06,31
archive.org/details/dli.ernet.17264,,3,0,3,6e-06,31
hdl.handle.net/2027%2Fuc1.c2625877,,3,0,3,6e-06,31
hdl.handle.net/2027/uc1.c2625877,,3,0,3,6e-06,31
en.wikipedia.org/wiki/Atul_Chandra_Chatterjee,,3,0,3,6e-06,31
archive.org/details/notesonindustri01chatgoog,,3,0,3,6e-06,31
books.google.com/books?id=wWpXAAAAMAAJ,,3,0,3,6e-06,31
archive.org/details/dli.csl.8179,,3,0,3,6e-06,31
indianculture.gov.in/rarebooks/speeches-made-his-excellency-sir-harcourt-butler,,3,0,3,6e-06,31
scribd.com/document/57136997/Iit-Roorkee-History,,3,0,3,6e-06,31
swetenham.org/getperson.php?personID=I69898&tree=1,,3,0,3,6e-06,31
researchgate.net/publication/360441952,,3,0,3,6e-06,31
doi.org/10.1007%2Fs43539-022-00039-z,,3,0,3,6e-06,31
cag.gov.in/en/former-cag,,3,0,3,6e-06,31
catalog.hathitrust.org/Record/100620831,,3,0,3,6e-06,31
ignca.gov.in/Asi_data/39762.pdf,,3,0,3,6e-06,31
ignca.gov.in/Asi_data/39655.pdf,,3,0,3,6e-06,31
jstor.org/stable/44147021,,3,0,3,6e-06,31
en.wikipedia.org/wiki/Tirthankar_Roy,,3,0,3,6e-06,31
doi.org/10.1017%2FCBO9780511497421,,3,0,3,6e-06,31
en.wikipedia.org/wiki/Special:BookSources/978-0-511-49742-1,,3,0,3,6e-06,31
en.wikipedia.org/wiki/Robert_Montgomery_(civil_servant),,4,0,4,7e-06,31
books.google.com/books?id=9DDRAAAAMAAJ,,3,0,3,6e-06,31
indianculture.gov.in/rarebooks/india-office-list-1916,,3,0,3,6e-06,31
en.wikipedia.org/wiki/Harrison_and_Sons,,3,0,3,6e-06,31
bsi.gov.in/uploads/userfiles/file/Rare%20Books/The%20Office%20List%20For%201919.pdf,,3,0,3,6e-06,31
indianculture.gov.in/rarebooks/india-office-list-1920,,3,0,3,6e-06,31
archive.org/details/in.ernet.dli.2015.533097,,3,0,3,6e-06,31
new.dli.ernet.in/handle/2015/533097,,3,0,3,6e-06,31
indianculture.gov.in/report-indian-industrial-commission-1916-18-4,,3,0,3,6e-06,31
babel.hathitrust.org/cgi/pt?id=coo1.ark:/13960/t2891s305&seq=15,,3,0,3,6e-06,31
indianculture.gov.in/report-indian-industrial-commission-1916-18-0,,3,0,3,6e-06,31
en.wikipedia.org/wiki/James_William_Mollison,,3,0,3,6e-06,31
en.wikipedia.org/wiki/Claud_Mackenzie_Hutchinson,,3,0,3,6e-06,31
doi.org/10.1017%2FS0021859600005256,,3,0,3,6e-06,31
hbtu.ac.in/GO/HISTORY%20BOOK%20HBTU%20KANPUR.pdf,,3,0,3,6e-06,31
jstor.org/stable/1641629,,3,0,3,6e-06,31
ui.adsabs.harvard.edu/abs/1916Sci....44..494.,,3,0,3,6e-06,31
doi.org/10.1126%2Fscience.44.1136.494,,3,0,3,6e-06,31
nature.com/articles/098063a0.pdf,,3,0,3,6e-06,31
doi.org/10.1038%2F098063a0,,3,0,3,6e-06,31
academictree.org/chemistry/peopleinfo.php?pid=724369,,3,0,3,6e-06,31
academictree.org/meteorology/peopleinfo.php?pid=58622,,3,0,3,6e-06,31
archive.org/details/in.ernet.dli.2015.35726,,3,0,3,6e-06,31
insaindia.res.in/BM/BM14_8901.pdf,,3,0,3,6e-06,31
dspace.gipe.ac.in/xmlui/handle/10973/37992,,3,0,3,6e-06,31
en.wikipedia.org/wiki/Gokhale_Institute_of_Politics_and_Economics,,6,0,6,7e-06,31
upgovernor.gov.in/en/article/sir-harcourt-(spencer)-butler,,3,0,3,6e-06,31
bsi.gov.in/uploads/userfiles/file/Rare%20Books/The%20Office%20List%20For%201921.pdf,,3,0,3,6e-06,31
archive.org/details/in.ernet.dli.2015.532997,,3,0,3,6e-06,31
new.dli.ernet.in/handle/2015/532997,,3,0,3,6e-06,31
uptti.ac.in/about-us.php,,3,0,3,6e-06,31
dspace.gipe.ac.in/xmlui/handle/10973/38030,,3,0,3,6e-06,31
web.archive.org/web/20150421005537/http://www.hbti.ac.in/html/history.html,,3,0,3,6e-06,31
hbti.ac.in/html/history.html,,3,0,3,6e-06,31
bsi.gov.in/uploads/userfiles/file/Rare%20Books/The%20India%20Office%20List%20For%201923.pdf,,3,0,3,6e-06,31
archive.org/details/dli.ministry.20703,,3,0,3,6e-06,31
static1.squarespace.com/static/643cdb80e402cd24d01a75fa/t/644449324b13672418a210b8/1682196806345,,3,0,3,6e-06,31
archive.org/details/in.ernet.dli.2015.52060,,3,0,3,6e-06,31
dspace.gipe.ac.in/xmlui/handle/10973/18491,,3,0,3,6e-06,31
researchgate.net/publication/381560438,,3,0,3,6e-06,31
doi.org/10.1007%2Fs43539-024-00126-3,,3,0,3,6e-06,31
archive.org/details/biographicalmemo0000unse_w0v2,,3,0,3,6e-06,31
insaindia.res.in/BM/BM9_8401.pdf,,3,0,3,6e-06,31
ds7-backend.ndl.gov.in:8443/insa/api/core/bitstreams/4bf247db-30b0-4464-a0ee-7d2778b51364/content,,3,0,3,6e-06,31
connect.iisc.ac.in/2020/12/the-science-of-gilbert-fowler/,,3,0,3,6e-06,31
archive.org/details/in.ernet.dli.2015.533008,,3,0,3,6e-06,31
new.dli.ernet.in/handle/2015/533008,,3,0,3,6e-06,31
en.wikipedia.org/wiki/Digital_Library_of_India,,3,0,3,6e-06,31
archive.org/details/in.ernet.dli.2015.85905,,3,0,3,6e-06,31
new.dli.ernet.in/handle/2015/85905,,3,0,3,6e-06,31
archive.org/details/dli.ministry.20976,,3,0,3,6e-06,31
indianculture.gov.in/reports-proceedings/report-industries-reorganization-committee-1934,,3,0,3,6e-06,31
archive.org/details/whos-who_1954,,3,0,3,6e-06,31
archive.org/details/in.ernet.dli.2015.533052,,3,0,3,6e-06,31
nasi.org.in/founder-fellows/,,3,0,3,6e-06,31
nasi.org.in/wp-content/uploads/2020/12/The-Journey-of-NASI-1930-2005.pdf,,3,0,3,6e-06,31
dbc.wroc.pl/Content/30808/PDF/033594.pdf,,3,0,3,6e-06,31
bsi.gov.in/uploads/userfiles/file/Rare%20Books/The%20India%20Office%20List%20For%201924.pdf,,3,0,3,6e-06,31
archive.org/details/in.ernet.dli.2015.222230,,3,0,3,6e-06,31
new.dli.ernet.in/handle/2015/222230,,3,0,3,6e-06,31
archive.org/details/in.ernet.dli.2015.215739,,3,0,3,6e-06,31
new.dli.ernet.in/handle/2015/215739,,3,0,3,6e-06,31
en.wikipedia.org/wiki/James_MacKenna,,3,0,3,6e-06,31
archive.org/details/dli.ministry.20806,,3,0,3,6e-06,31
indianculture.gov.in/rarebooks/report-indian-sugar-committee-1920,,3,0,3,6e-06,31
dfpd.nic.in/Home/ContentManagement?Url=national-sugar-institute.html&ManuId=4&language=1,,3,0,3,6e-06,31
dfpd.gov.in/nationals-sugar-institute/en,,3,0,3,6e-06,31
nsi.rdisl.com/about_us.html,,3,0,3,6e-06,31
hbtu.ac.in/naac/CH/Alumini%20List.pdf,,3,0,3,6e-06,31
twocircles.net/2008aug29/former_director_bits_pilani_c_r_mitra_dead.html,,3,0,3,6e-06,31
en.wikipedia.org/wiki/Indo-Asian_News_Service,,6,0,6,7e-06,31
beb.iitd.ac.in/TK-Ghose-Tribute.pdf,,3,0,3,6e-06,31
endowment.iitd.ac.in/research-prof-t-k-ghose-endowment,,3,0,3,6e-06,31
hbtu.ac.in/wp-content/uploads/2024/11/HBTI_bye_laws.pdf,,3,0,3,6e-06,31
sandpaper.bitsaa.org/archives/pdf/SandpaperSummer2008.pdf,,3,0,3,6e-06,31
doi.org/10.1086%2F507138,,3,0,3,6e-06,31
jstor.org/stable/10.1086/507138,,3,0,3,6e-06,31
stephbti.ac.in/campus-profile.php,,3,0,3,6e-06,31
dst.gov.in/sites/default/files/75-Impactful-Startup-DST-Incubation-Program.pdf,,3,0,3,6e-06,31
en.wikipedia.org/wiki/Special:BookSources/978-8-174-80391-7,,3,0,3,6e-06,31
stephbti.ac.in/governing-bodies.php,,3,0,3,6e-06,31
hbtu.ac.in/naac/Information%20Broucher%202018-19.pdf,,3,0,3,6e-06,31
hbtu.ac.in/wp-content/uploads/2024/10/HBTU-Strategic-Plan.pdf,,3,0,3,6e-06,31
timesofindia.indiatimes.com/articleshow/3789958.cms,,3,0,3,6e-06,31
web.archive.org/web/20110721150033/http://www.hbti.ac.in/doaa/osautonomy.pdf,,3,0,3,6e-06,31
hbti.ac.in/doaa/osautonomy.pdf,,3,0,3,6e-06,31
hindustantimes.com/india/govt-to-grant-autonomy-to-hbti/story-G6L5HnIMPXVzrr4KzJOHcM.html,,3,0,3,6e-06,31
oneindia.com/2008/03/10/hbti-gets-autonomy-to-be-developed-as-centre-of-excellence-1205134524.html,,3,0,3,6e-06,31
hindustantimes.com/india/story-U1hFKBPJwd8KBmWok7MezO.html,,3,0,3,6e-06,31
hindustantimes.com/india/story-zjOe3veyRGjJFhQzc3h3RJ.html,,3,0,3,6e-06,31
thecareertools.wordpress.com/2013/12/06/why-hbti-website-is-with-worst-look-feel-and-functioning/,,3,0,3,6e-06,31
hindustantimes.com/india/story-qgF1pTmSyj7pQVWOFAOVyM.html,,3,0,3,6e-06,31
hindustantimes.com/india/story-Mxxp0f3r8eJZrto9alxkIM.html,,3,0,3,6e-06,31
hindustantimes.com/india/story-eqrwJcwl2Fn6t02SRLE17N.html,,3,0,3,6e-06,31
hindustantimes.com/india/story-KakQMZkYOjNR0LE0ZfADZO.html,,3,0,3,6e-06,31
hindustantimes.com/india/story-wnRgSwOjYMa39mjIGHGssN.html,,3,0,3,6e-06,31
timesofindia.indiatimes.com/city/kanpur/articleshow/20641483.cms,,3,0,3,6e-06,31
hindustantimes.com/india/don-t-meddle-in-fund-management/story-gTRPextpuCtwPc4jzJOiJK_amp.html,,3,0,3,6e-06,31
timesofindia.indiatimes.com/city/kanpur/hbti-gets-new-acting-director/articleshow/29394744.cms,,3,0,3,6e-06,31
timesofindia.indiatimes.com/city/kanpur/HBTI-gets-university-status/articleshow/51736230.cms,,3,0,3,6e-06,31
upvidhai.gov.in/UPCODE/UpCode/ViewAct/459,,3,0,3,6e-06,31
timesofindia.indiatimes.com/city/lucknow/iet-professor-is-hbtus-first-vc/articleshow/54154879.cms,,3,0,3,6e-06,31
archive.org/details/in.ernet.dli.2015.122784,,3,0,3,6e-06,31
hbtu.ac.in/central-library-e-journels/,,3,0,3,6e-06,31
ess.inflibnet.ac.in/eres.php?memID=502,,3,0,3,6e-06,31
en.wikipedia.org/wiki/INFLIBNET_Centre,,3,0,3,6e-06,31
pds.inflibnet.ac.in/members.php,,3,0,3,6e-06,31
otai.org/about-otai/zonal-offices/,,3,0,3,6e-06,31
web.archive.org/web/20120624072145/http://www.leatherindia.org/about-council/contact.asp,,3,0,3,6e-06,31
leatherindia.org/about-council/contact.asp,,3,0,3,6e-06,31
ieindia.org/webui/IEI-Network.aspx,,3,0,3,6e-06,31
iichekanpur.com/,,3,0,3,6e-06,31
pactind.org/aboutus,,3,0,3,6e-06,31
hbtu.ac.in/naac/criterion6/organizational%20setup.pdf,,3,0,3,6e-06,31
ugc.gov.in/universitydetails/university?type=LZ1FUMk6U2JWGNLvhWfVSA==,,3,0,3,6e-06,31
assessmentonline.naac.gov.in/public/index.php/hei_dashboard,,3,0,3,6e-06,31
timesofindia.indiatimes.com/city/lucknow/iit-k-director-to-be-hbtis-mentor/articleshow/1276518.cms,,3,0,3,6e-06,31
dhte.py.gov.in/sites/default/files/minutes8pab020920151.pdf,,3,0,3,6e-06,31
iitg.ac.in/cet/teqip3.html,,3,0,3,6e-06,31
atrium.lib.uoguelph.ca/server/api/core/bitstreams/a05e993e-3b25-408c-86e1-5d2f188b9630/content,,3,0,3,6e-06,31
hbtu.ac.in/naac/annual-report-2021-22.pdf,,3,0,3,6e-06,31
hbtu.ac.in/wp-content/uploads/2024/10/Research-projects.xlsx,,3,0,3,6e-06,31
home.iitk.ac.in/~vyas/rutagweb/hbti_knp.html,,3,0,3,6e-06,31
currentscience.ac.in/Downloads/download_pdf.php?titleid=id_097_03_0304_0306_0,,3,0,3,6e-06,31
jstor.org/stable/24111992,,3,0,3,6e-06,31
hbtu.admissions.nic.in/programs/,,3,0,3,6e-06,31
pib.gov.in/PressReleasePage.aspx?PRID=1594375,,3,0,3,6e-06,31
governancenow.com/news/change-india/kanpur-where-politics-now-joke,,3,0,3,6e-06,31
en.wikipedia.org/wiki/Living_Media_India,,3,0,3,6e-06,31
business-standard.com/article/economy-policy/kanpur-decline-of-an-industrial-hub-112021400057_1.html,,3,0,3,6e-06,31
thecitizen.in/index.php/en/NewsDetail/index/9/8244/Kanpur:-The-Slow-Decline-of-a-Historic-Legacy,,3,0,3,6e-06,31
en.wikipedia.org/wiki/National_Institute_of_Educational_Planning_and_Administration,,7,0,7,7e-06,31
trak.in/tags/business/2007/07/14/top-100-engineering-technology-colleges-institutes-india/,,3,0,3,6e-06,31
admissionsource.wordpress.com/2007/08/02/outlook-top-50-govt-engineering-colleges/,,3,0,3,6e-06,31
worldranking.blogspot.com/2009/04/top-government-engineering-colleges-in.html,,3,0,3,6e-06,31
web.archive.org/web/20100730090341/http://www.outlookindia.com/articlefullwidth.aspx?234822,,3,0,3,6e-06,31
outlookindia.com/articlefullwidth.aspx?234822,,3,0,3,6e-06,31
web.archive.org/web/20080610071623/http://dqindia.ciol.com/content/top_stories/2005/105052301.asp,,3,0,3,6e-06,31
dqindia.ciol.com/content/top_stories/2005/105052301.asp,,3,0,3,6e-06,31
dqindia.com/images06/Complete%20Score%20Card.pdf,,3,0,3,6e-06,31
dqindia.com/dataquest/specials/154885/dq-cmr-t-schools-survey-2012-nurturing-indias-top-tech-talent,,3,0,3,6e-06,31
livemint.com/r/LiveMint/Period1/oldpdf/22eafcc9-0ae8-4d10-8efa-6cb64d3ff467.pdf,,3,0,3,6e-06,31
livemint.com/r/LiveMint/Period1/oldpdf/c44412de-5599-4286-935b-420729bdfc69.pdf,,3,0,3,6e-06,31
outlookindia.com/article/Top-Engineering-Colleges-/281299,,3,0,3,6e-06,31
outlookindia.com/article/Top-Engineering-Colleges/286302,,3,0,3,6e-06,31
myengg.com/engg/info/23184/outlook-india-survey-2013-top-75-engineering-colleges-in-india/,,3,0,3,6e-06,31
pickacollege.digit.in/best-engineering-colleges,,4,0,4,6e-06,31
edu-leaders.com/news/1003796/edu-rand-rankings-for-the-best-engineering-colleges-is-out,,3,0,3,6e-06,31
hbtu.ac.in/centenary-year/,,3,0,3,6e-06,31
pib.gov.in/PressReleasePage.aspx?PRID=1774975,,3,0,3,6e-06,31
ramnathkovind.nic.in/pr251121.html,,3,0,3,6e-06,31
amarujala.com/uttar-pradesh/kanpur/history-of-hbtu-will-be-kept-in-400-kg-capsule,,3,0,3,6e-06,31
numismaticscollections.blogspot.com/2021/11/new-commemorative-coin-hbtu-kanpur.html,,3,0,3,6e-06,31
old.spmcil.com/Interface/product-in-Detail.aspx?sell=201,,3,0,3,6e-06,31
hbtu.ac.in/students-activities-csa/,,3,0,3,6e-06,31
hindustantimes.com/india/hbti-cultural-fest-begins/story-WIu11JBhhAD9CZ3rEtvuVM.html,,3,0,3,6e-06,31
timesofindia.indiatimes.com/city/kanpur/all-sway-to-taal-at-hbti/articleshow/16858894.cms,,3,0,3,6e-06,31
hindustantimes.com/india/india-inspired-first-online-essay-contest/story-wtazQPAEXkvXZzzf0Lv8mN.html,,3,0,3,6e-06,31
hindustantimes.com/india/tech-era-2006-set-to-start-today/story-OOl0ugXy8Si0oRG5Gm8jVL.html,,3,0,3,6e-06,31
timesofindia.indiatimes.com/city/kanpur/hbti-set-to-organise-tech-fest/articleshow/4151700.cms,,3,0,3,6e-06,31
timesofindia.indiatimes.com/city/kanpur/2-day-fest-begins-at-hbti/articleshow/7649384.cms,,3,0,3,6e-06,31
timesofindia.indiatimes.com/city/kanpur/2-day-fest-at-HBTI/articleshow/10362916.cms,,3,0,3,6e-06,31
en.wikipedia.org/wiki/The_Times_Group,,6,0,6,6e-06,31
timesofindia.indiatimes.com/harcourtians-return-it-with-love/articleshow/131922.cms,,3,0,3,6e-06,31
iipfoundationindia.org/hana/,,3,0,3,6e-06,31
timesofindia.indiatimes.com/city/kanpur/alumni-meet-of-hbti-today/articleshow/7001707.cms,,3,0,3,6e-06,31
timesofindia.indiatimes.com/articleshow/7002326.cms,,3,0,3,6e-06,31
hbtu.ac.in/alumni-cell-2/,,3,0,3,6e-06,31
datais.info/loksabha/members/Malaviya+%2C+Shri+Keshav+Dev/9d9d09ebf62f62ead1ac3452d18a314c/,,3,0,3,6e-06,31
geosocindia.com/index.php/jgsi/article/view/65057,,3,0,3,6e-06,31
csvtech.org.in/,,3,0,3,6e-06,31
home.gandhifootprints.org/,,3,0,3,6e-06,31
sourcewatch.org/index.php?title=Devendra_Kumar,,3,0,3,6e-06,31
thebetterindia.com/107275/dr-devendra-kumar-jamnalal-bajaj-foundation/,,3,0,3,6e-06,31
en.wikipedia.org/wiki/The_Better_India,,4,0,4,6e-06,31
jamnalalbajajfoundation.org/Media/pdf/JBA_1998_Bio_Devendra_Kumar.pdf,,3,0,3,6e-06,31
businesstoday.intoday.in/story/anil-k.-khandelwal-book-dare-to-lead-review/1/17512.html,,3,0,3,6e-06,31
moneycontrol.com/news-topic/bank-of-baroda-cmd-anil-khandelwal/,,3,0,3,6e-06,31
asianbankerawards.com/leadership/winners.php,,3,0,3,6e-06,31
asianbankerawards.com/leadership/gallery-2008.php,,3,0,3,6e-06,31
insider.finology.in/entrepreneurship/physics-wallah-become-a-unicorn,,3,0,3,6e-06,31
corporate.indiamart.com/board-members/,,3,0,3,6e-06,31
dineshagarwal.com/,,3,0,3,6e-06,31
eoiparis.gov.in/page/g2b-and-b2b-portals/,,3,0,3,6e-06,31
web.iitd.ac.in/~kkpant/biosketch.html,,3,0,3,6e-06,31
educationcongress.org/kk-pant.php,,3,0,3,6e-06,31
lms.holkar.org/images/Despande%20Award_2025_Advt.pdf,,3,0,3,6e-06,31
wordsmith.org/awad/about.html,,3,0,3,6e-06,31
nas.org/blogs/article/the_philomath_speaks_an_interview_with_anu_garg,,3,0,3,6e-06,31
en.wikipedia.org/wiki/National_Association_of_Scholars,,3,0,3,6e-06,31
nytimes.com/2002/11/28/technology/a-word-of-the-day-keeps-banality-at-bay.html,,3,0,3,6e-06,31
wordsmith.org/awad/books.html,,3,0,3,6e-06,31
wordsmith.org/anu/,,3,0,3,6e-06,31
en.wikipedia.org/w/index.php?title=Harcourt_Butler_Technical_University&action=edit&section=32,,3,0,3,6e-06,31
indiagovtmint.in/en/product/harcourt-butler-technical-university-kanpur-centen-unsc/,,3,0,3,6e-06,31
twitter.com/hbtukanpur,,3,0,3,6e-06,31
instagram.com/hbtuofficial/,,3,0,3,6e-06,31
youtube.com/channel/UCTjOa_N11IF5iYJ0m4vFdtw,,3,0,3,6e-06,31
"en.wikipedia.org/wiki/National_Portrait_Gallery,_London",,3,0,3,6e-06,31
npg.org.uk/collections/search/person/mp56192/sir-spencer-harcourt-butler,,3,0,3,6e-06,31
npg.org.uk/collections/search/person/mp80233/sir-john-prescott-hewett,,3,0,3,6e-06,31
npg.org.uk/collections/search/person/mp86451/nawab-sir-muhammad-ahmad-said-khan-chhatari,,3,0,3,6e-06,31
npg.org.uk/collections/search/person/mp102881/sir-edwin-henry-de-vere-atkinson,,3,0,3,6e-06,31
npg.org.uk/collections/search/person/mp126763/sir-claude-fraser-de-la-fosse,,3,0,3,6e-06,31
npg.org.uk/collections/search/person/mp60398/sir-robert-woodburn-gillan,,3,0,3,6e-06,31
wikidata.org/wiki/Q5655014,,3,0,3,6e-06,31
isni.org/isni/0000000122273155,,3,0,3,6e-06,31
viaf.org/viaf/149033560,,3,0,3,6e-06,31
id.loc.gov/authorities/n88184580,,3,0,3,6e-06,31
en.wikipedia.org/wiki/Category:Government_universities_and_colleges_in_India,,7,0,7,7e-06,31
en.wikipedia.org/wiki/Category:State_universities_in_India,,3,0,3,6e-06,31
en.wikipedia.org/wiki/Category:Universities_and_colleges_in_Uttar_Pradesh,,3,0,3,6e-06,31
en.wikipedia.org/wiki/Category:Universities_and_colleges_established_in_1921,,3,0,3,6e-06,31
en.wikipedia.org/wiki/Category:1921_establishments_in_India,,3,0,3,6e-06,31
en.wikipedia.org/wiki/Category:Schools_in_Colonial_India,,3,0,3,6e-06,31
en.wikipedia.org/wiki/Category:Pages_using_Template:Post-nominals_with_customized_linking,,4,0,4,6e-06,31
upload.wikimedia.org/wikipedia/commons/thumb/c/cf/HBTI_Old_Pic_v3.jpg/250px-HBTI_Old_Pic_v3.jpg,,3,0,3,6e-06,31
en.wikipedia.org/wiki/Islam,,12,0,12,7e-06,31
en.wikipedia.org/wiki/Zoroastrianism,,7,0,7,6e-06,31
en.wikipedia.org/wiki/Public_company,,4,0,4,6e-06,31
en.wikipedia.org/wiki/Public_limited_company,,3,0,3,6e-06,31
en.wikipedia.org/w/index.php?title=Special:CreateAccount&returnto=IIT+Kanpur+metro+station,,1,0,1,6e-06,31
en.wikipedia.org/w/index.php?title=Special:UserLogin&returnto=IIT+Kanpur+metro+station,,1,0,1,6e-06,31
hi.wikipedia.org/wiki/आई_आई_टी_कानपुर_मेट्रो_स्टेशन,,1,0,1,6e-06,31
wikidata.org/wiki/Special:EntityPage/Q110300579,,1,0,1,6e-06,31
en.wikipedia.org/wiki/Talk:IIT_Kanpur_metro_station,,1,0,1,6e-06,31
en.wikipedia.org/w/index.php?title=IIT_Kanpur_metro_station&action=edit,,1,0,1,6e-06,31
en.wikipedia.org/w/index.php?title=IIT_Kanpur_metro_station&action=history,,1,0,1,6e-06,31
en.wikipedia.org/wiki/Special:WhatLinksHere/IIT_Kanpur_metro_station,,1,0,1,6e-06,31
en.wikipedia.org/wiki/Special:RecentChangesLinked/IIT_Kanpur_metro_station,,1,0,1,6e-06,31
en.wikipedia.org/w/index.php?title=IIT_Kanpur_metro_station&oldid=1294542323,,1,0,1,6e-06,31
en.wikipedia.org/w/index.php?title=IIT_Kanpur_metro_station&action=info,,1,0,1,6e-06,31
en.wikipedia.org/w/index.php?title=IIT_Kanpur_metro_station&printable=yes,,1,0,1,6e-06,31
en.wikipedia.org/wiki/File:Lucknow_Metro.jpg,,2,0,2,6e-06,31
en.wikipedia.org/wiki/File:IIT_Kanpur_metro_station.jpg,,4,0,4,7e-06,31
en.wikipedia.org/wiki/Side_platform,,1,0,1,6e-06,31
en.wikipedia.org/wiki/Kanpur_Central_metro_station,,3,0,3,7e-06,31
en.wikipedia.org/wiki/Elevated,,1,0,1,6e-06,31
en.wikipedia.org/wiki/Double-track_railway,,1,0,1,6e-06,31
en.wikipedia.org/wiki/Third_rail,,2,0,2,7e-06,31
en.wikipedia.org/wiki/Kalyanpur_metro_station,,2,0,2,7e-06,31
en.wikipedia.org/wiki/Template:Railway_line_legend,,6,0,6,7e-06,31
en.wikipedia.org/wiki/Kalianpur_railway_station,,3,0,3,7e-06,31
en.wikipedia.org/wiki/SPM_Hospital_metro_station,,2,0,2,7e-06,31
en.wikipedia.org/wiki/Vishwavidyalaya_Kanpur_metro_station,,2,0,2,7e-06,31
en.wikipedia.org/wiki/Gurudev_Chauraha_metro_station,,2,0,2,7e-06,31
en.wikipedia.org/wiki/Geeta_Nagar_metro_station,,2,0,2,7e-06,31
en.wikipedia.org/wiki/Rawatpur_metro_station,,2,0,2,7e-06,31
en.wikipedia.org/wiki/Rawatpur_railway_station,,4,0,4,7e-06,31
en.wikipedia.org/wiki/LLR_Hospital_metro_station,,2,0,2,7e-06,31
en.wikipedia.org/wiki/Moti_Jheel_metro_station,,2,0,2,7e-06,31
en.wikipedia.org/wiki/Chunniganj_metro_station,,2,0,2,7e-06,31
en.wikipedia.org/wiki/Naveen_Market_metro_station,,2,0,2,7e-06,31
en.wikipedia.org/wiki/Bada_Chauraha_metro_station,,2,0,2,7e-06,31
en.wikipedia.org/wiki/Nayaganj_metro_station,,2,0,2,7e-06,31
en.wikipedia.org/wiki/Jhakarkati_Bus_Terminal_metro_station,,2,0,2,7e-06,31
en.wikipedia.org/wiki/Bus,,3,0,3,7e-06,31
en.wikipedia.org/wiki/Transport_Nagar_metro_station_(Kanpur),,2,0,2,7e-06,31
en.wikipedia.org/wiki/Bara_Devi_metro_station,,2,0,2,7e-06,31
en.wikipedia.org/wiki/Kidwai_Nagar_metro_station,,3,0,3,7e-06,31
en.wikipedia.org/wiki/Vasant_Vihar_metro_station_(Kanpur),,2,0,2,7e-06,31
en.wikipedia.org/wiki/Baudh_Nagar_metro_station,,2,0,2,7e-06,31
en.wikipedia.org/wiki/Naubasta_metro_station,,2,0,2,7e-06,31
en.wikipedia.org/wiki/Special:Map/14/26.509495/80.248132/en,,1,0,1,6e-06,31
en.wikipedia.org/w/index.php?title=IIT_Kanpur_metro_station&action=edit&section=1,,1,0,1,6e-06,31
en.wikipedia.org/wiki/Template:Railway_track_legend,,1,0,1,6e-06,31
en.wikipedia.org/wiki/Accessibility,,1,0,1,6e-06,31
en.wikipedia.org/w/index.php?title=IIT_Kanpur_metro_station&action=edit&section=2,,1,0,1,6e-06,31
en.wikipedia.org/w/index.php?title=IIT_Kanpur_metro_station&action=edit&section=,,1,0,1,6e-06,31
en.wikipedia.org/w/index.php?title=IIT_Kanpur_metro_station&action=edit&section=3,,1,0,1,6e-06,31
en.wikipedia.org/wiki/List_of_Kanpur_Metro_stations,,1,0,1,6e-06,31
en.wikipedia.org/wiki/List_of_metro_systems,,1,0,1,6e-06,31
en.wikipedia.org/wiki/Rapid_transit_in_India,,1,0,1,6e-06,31
en.wikipedia.org/w/index.php?title=IIT_Kanpur_metro_station&action=edit&section=4,,1,0,1,6e-06,31
urbanrail.net/as/in/kanpur/kanpur.htm,,1,0,1,6e-06,31
en.wikipedia.org/w/index.php?title=IIT_Kanpur_metro_station&action=edit&section=5,,1,0,1,6e-06,31
lmrcl.com/kanpur-metro/station-info,,1,0,1,6e-06,31
en.wikipedia.org/wiki/Template:Kanpur_Metro,,2,0,2,7e-06,31
en.wikipedia.org/wiki/Template_talk:Kanpur_Metro,,2,0,2,7e-06,31
en.wikipedia.org/wiki/Special:EditPage/Template:Kanpur_Metro,,2,0,2,7e-06,31
en.wikipedia.org/wiki/File:Train_station.svg,,4,0,4,7e-06,31
en.wikipedia.org/wiki/Template:UttarPradesh-railstation-stub,,4,0,4,7e-06,31
en.wikipedia.org/wiki/Template_talk:UttarPradesh-railstation-stub,,4,0,4,7e-06,31
en.wikipedia.org/wiki/Special:EditPage/Template:UttarPradesh-railstation-stub,,4,0,4,7e-06,31
en.wikipedia.org/wiki/Category:Kanpur_Metro_stations,,1,0,1,6e-06,31
en.wikipedia.org/wiki/Category:Railway_stations_in_India_opened_in_2021,,1,0,1,6e-06,31
en.wikipedia.org/wiki/Category:2021_establishments_in_Uttar_Pradesh,,2,0,2,7e-06,31
en.wikipedia.org/wiki/Category:Uttar_Pradesh_railway_station_stubs,,4,0,4,7e-06,31
en.wikipedia.org/wiki/Category:Use_dmy_dates_from_December_2021,,2,0,2,6e-06,31
en.wikipedia.org/wiki/Category:Use_Indian_English_from_December_2021,,2,0,2,7e-06,31
en.wikipedia.org/wiki/Category:Articles_using_Infobox_station_with_markup_inside_name,,3,0,3,7e-06,31
en.wikipedia.org/wiki/Category:Articles_using_Infobox_station_with_links_or_images_inside_name,,2,0,2,7e-06,31
en.wikipedia.org/wiki/Category:Articles_using_Infobox_station_with_markup_inside_type,,1,0,1,6e-06,31
en.wikipedia.org/wiki/Category:Articles_using_Infobox_station_with_images_inside_type,,6,0,6,7e-06,31
en.wikipedia.org/wiki/Category:Articles_to_be_expanded_from_August_2023,,1,0,1,6e-06,31
en.wikipedia.org/wiki/Category:Articles_with_empty_sections_from_August_2023,,1,0,1,6e-06,31
en.m.wikipedia.org/w/index.php?title=IIT_Kanpur_metro_station&mobileaction=toggle_view_mobile,,1,0,1,6e-06,31
upload.wikimedia.org/wikipedia/commons/thumb/f/fe/Lucknow_Metro.jpg/40px-Lucknow_Metro.jpg,,2,0,2,6e-06,31
upload.wikimedia.org/wikipedia/commons/thumb/6/6c/UPMRC.svg/20px-UPMRC.svg.png,,4,0,4,7e-06,31
upload.wikimedia.org/wikipedia/commons/thumb/2/23/BSicon_BAHN.svg/20px-BSicon_BAHN.svg.png,,1,0,1,6e-06,31
upload.wikimedia.org/wikipedia/commons/thumb/d/da/BSicon_BUS2.svg/20px-BSicon_BUS2.svg.png,,1,0,1,6e-06,31
upload.wikimedia.org/wikipedia/commons/thumb/1/1e/BSicon_vCONTgfa.svg/20px-BSicon_vCONTgfa.svg.png,,1,0,1,6e-06,31
upload.wikimedia.org/wikipedia/commons/thumb/3/39/BSicon_cPLT.svg/20px-BSicon_cPLT.svg.png,,1,0,1,6e-06,31
upload.wikimedia.org/wikipedia/commons/thumb/4/4f/BSicon_vSTR.svg/20px-BSicon_vSTR.svg.png,,1,0,1,6e-06,31
upload.wikimedia.org/wikipedia/commons/thumb/1/13/BSicon_vCONTgfe.svg/20px-BSicon_vCONTgfe.svg.png,,1,0,1,6e-06,31
upload.wikimedia.org/wikipedia/commons/thumb/2/28/Train_station.svg/60px-Train_station.svg.png,,4,0,4,7e-06,31
en.wikipedia.org/wiki/List_of_magazines_by_circulation,,3,0,3,7e-06,31
web.archive.org/web/20140407092737/http://mruc.net/irs2012q1-topline-findings.pdf,,2,0,2,7e-06,31
en.wikipedia.org/wiki/Category:English-language_magazines_published_in_India,,2,0,2,7e-06,31
en.wikipedia.org/wiki/Category:News_magazines_published_in_India,,2,0,2,7e-06,31
en.wikipedia.org/wiki/Category:Weekly_magazines_published_in_India,,2,0,2,7e-06,31
en.wikipedia.org/wiki/Category:Use_dmy_dates_from_July_2018,,9,0,9,7e-06,31
en.wikipedia.org/wiki/Category:Use_Indian_English_from_July_2018,,8,0,8,7e-06,31
en.wikipedia.org/wiki/ISO_15919,,12,0,12,7e-06,31
en.wikipedia.org/wiki/Registrar_General_and_Census_Commissioner_of_India,,17,0,17,7e-06,31
en.wikipedia.org/wiki/Category:Technical_universities_and_colleges_in_India,,9,0,9,7e-06,31
en.wikipedia.org/wiki/Ahmedabad,,18,0,18,7e-06,31
en.wikipedia.org/wiki/Udaipur,,8,0,8,7e-06,31
en.wikipedia.org/wiki/Jaipur,,17,0,17,7e-06,31
en.wikipedia.org/wiki/India_Meteorological_Department,,6,0,6,6e-06,31
en.wikipedia.org/wiki/India_TV,,3,0,3,6e-06,31
en.wikipedia.org/wiki/WION_(TV_channel),,3,0,3,6e-06,31
en.wikipedia.org/wiki/High_courts_of_India,,5,0,5,6e-06,31
en.wikipedia.org/wiki/District_courts_of_India,,4,0,4,6e-06,31
en.wikipedia.org/wiki/Armoured_Vehicles_Nigam_Limited,,7,0,7,7e-06,31
en.wikipedia.org/wiki/Sepoy,,3,0,3,6e-06,31
en.wikipedia.org/wiki/Sowar,,3,0,3,6e-06,31
"en.wikipedia.org/wiki/Gaya,_India",,4,0,4,6e-06,31
en.wikipedia.org/wiki/Mathura,,25,0,25,7e-06,31
en.wikipedia.org/wiki/National_Capital_Region_(India),,9,0,9,7e-06,31
upload.wikimedia.org/wikipedia/en/thumb/f/f3/Flag_of_Russia.svg/40px-Flag_of_Russia.svg.png,,7,0,7,7e-06,31
en.wikipedia.org/wiki/Demonym,,9,0,9,7e-06,31
en.wikipedia.org/wiki/List_of_countries_and_dependencies_by_population,,2,0,2,6e-06,31
en.wikipedia.org/wiki/Human_Development_Index,,4,0,4,6e-06,31
en.wikipedia.org/wiki/Telephone_numbers_in_India,,4,0,4,6e-06,31
en.wikipedia.org/wiki/ISO_3166-2:IN,,2,0,2,6e-06,31
en.wikipedia.org/wiki/Taj_Mahal,,8,0,8,7e-06,31
en.wikipedia.org/wiki/Agra_Fort,,6,0,6,7e-06,31
en.wikipedia.org/wiki/Rajput,,7,0,7,7e-06,31
"en.wikipedia.org/wiki/James_Broun-Ramsay,_1st_Marquess_of_Dalhousie",,5,0,5,6e-06,31
en.wikipedia.org/wiki/Religious_violence_in_India,,2,0,2,6e-06,31
en.wikipedia.org/wiki/Caste-related_violence_in_India,,4,0,4,6e-06,31
en.wikipedia.org/wiki/Monsoon,,5,0,5,6e-06,31
en.wikipedia.org/wiki/Habitat,,2,0,2,6e-06,31
en.wikipedia.org/wiki/Bird,,2,0,2,6e-06,31
en.wikipedia.org/wiki/Gharial,,3,0,3,6e-06,31
en.wikipedia.org/wiki/Crocodilian,,3,0,3,6e-06,31
en.wikipedia.org/wiki/List_of_Ramsar_sites_in_India,,5,0,5,7e-06,31
en.wikipedia.org/wiki/Ramsar_Convention,,3,0,3,6e-06,31
en.wikipedia.org/wiki/1957_Indian_general_election,,8,0,8,7e-06,31
en.wikipedia.org/wiki/1962_Indian_general_election,,8,0,8,7e-06,31
en.wikipedia.org/wiki/1967_Indian_general_election,,7,0,7,7e-06,31
en.wikipedia.org/wiki/1971_Indian_general_election,,7,0,7,7e-06,31
en.wikipedia.org/wiki/1977_Indian_general_election,,7,0,7,7e-06,31
en.wikipedia.org/wiki/Janata_Party,,17,0,17,7e-06,31
en.wikipedia.org/wiki/1984_Indian_general_election,,7,0,7,7e-06,31
en.wikipedia.org/wiki/Janata_Dal,,15,0,15,7e-06,31
en.wikipedia.org/wiki/1989_Indian_general_election,,7,0,7,7e-06,31
en.wikipedia.org/wiki/1991_Indian_general_election,,8,0,8,7e-06,31
en.wikipedia.org/wiki/1996_Indian_general_election,,8,0,8,7e-06,31
en.wikipedia.org/wiki/1998_Indian_general_election,,7,0,7,7e-06,31
en.wikipedia.org/wiki/2004_Indian_general_election,,6,0,6,7e-06,31
en.wikipedia.org/wiki/2009_Indian_general_election,,4,0,4,7e-06,31
en.wikipedia.org/wiki/Fundamental_rights_in_India,,2,0,2,6e-06,31
en.wikipedia.org/wiki/Net_domestic_product,,2,0,2,6e-06,31
en.wikipedia.org/wiki/2011_Census_of_India,,6,0,6,7e-06,31
en.wikipedia.org/wiki/Srinagar,,8,0,8,7e-06,31
en.wikipedia.org/wiki/Pulses,,3,0,3,6e-06,31
en.wikipedia.org/wiki/Kabaddi,,6,0,6,6e-06,31
en.wikipedia.org/wiki/India_national_cricket_team,,2,0,2,6e-06,31
en.wikipedia.org/wiki/Ethnologue,,8,0,8,7e-06,31
en.wikipedia.org/wiki/Vascular_plant,,2,0,2,6e-06,31
en.wikipedia.org/wiki/Census_of_India,,4,0,4,7e-06,31
censusindia.gov.in/2011-prov-results/paper2/data_files/india/Rural_Urban_2011.pdf,,2,0,2,6e-06,31
en.wikipedia.org/wiki/ABC-CLIO,,6,0,6,6e-06,31
whc.unesco.org/en/list/252,,2,0,2,6e-06,31
en.wikipedia.org/wiki/University_of_Colorado_Boulder_Libraries,,2,0,2,6e-06,31
en.wikipedia.org/wiki/OpenStreetMap,,3,0,3,6e-06,31
en.wikipedia.org/wiki/Template:States_and_union_territories_of_India,,2,0,2,6e-06,31
en.wikipedia.org/wiki/Template_talk:States_and_union_territories_of_India,,2,0,2,6e-06,31
en.wikipedia.org/wiki/Special:EditPage/Template:States_and_union_territories_of_India,,2,0,2,6e-06,31
en.wikipedia.org/wiki/Federated_state,,2,0,2,6e-06,31
en.wikipedia.org/wiki/Category:Historical_Indian_regions,,2,0,2,6e-06,31
en.wikipedia.org/wiki/Category:Presidencies_of_British_India,,2,0,2,6e-06,31
en.wikipedia.org/wiki/Armenia,,4,0,4,6e-06,31
en.wikipedia.org/wiki/Georgia_(country),,6,0,6,7e-06,31
en.wikipedia.org/wiki/Category:Countries_and_territories_where_Hindi_is_an_official_language,,2,0,2,6e-06,31
upload.wikimedia.org/wikipedia/commons/thumb/f/f3/Gnome-globe.svg/20px-Gnome-globe.svg.png,,2,0,2,6e-06,31
upload.wikimedia.org/wikipedia/commons/thumb/c/ca/Flag_of_Iran.svg/40px-Flag_of_Iran.svg.png,,3,0,3,6e-06,31
upload.wikimedia.org/wikipedia/commons/thumb/2/2f/Flag_of_Armenia.svg/40px-Flag_of_Armenia.svg.png,,3,0,3,6e-06,31
upload.wikimedia.org/wikipedia/commons/thumb/b/b4/Flag_of_Turkey.svg/40px-Flag_of_Turkey.svg.png,,2,0,2,6e-06,31
"en.wikipedia.org/wiki/Kota,_Rajasthan",,13,0,13,7e-06,31
en.wikipedia.org/wiki/Category:Articles_with_unsourced_statements_from_January_2025,,7,0,7,7e-06,31
en.wikipedia.org/wiki/Districts_of_India,,10,0,10,7e-06,31
en.wikipedia.org/wiki/Tehsil,,15,0,15,7e-06,31
en.wikipedia.org/wiki/Adhkatiya_Kala_Khas,,16,0,16,7e-06,31
en.wikipedia.org/wiki/Aharak,,16,0,16,7e-06,31
"en.wikipedia.org/wiki/Ahiran,_Pindra",,16,0,16,7e-06,31
"en.wikipedia.org/wiki/Ahirani,_Pindra",,16,0,16,7e-06,31
en.wikipedia.org/wiki/Ajaipur,,16,0,16,7e-06,31
en.wikipedia.org/wiki/Akorha,,16,0,16,7e-06,31
"en.wikipedia.org/wiki/Amilo,_Varanasi",,16,0,16,7e-06,31
en.wikipedia.org/wiki/Deorai,,16,0,16,7e-06,31
en.wikipedia.org/wiki/Eshipur,,16,0,16,7e-06,31
en.wikipedia.org/wiki/Janakpatti,,16,0,16,7e-06,31
en.wikipedia.org/wiki/Kathiraon,,16,0,16,7e-06,31
"en.wikipedia.org/wiki/Kuri,_Varanasi",,16,0,16,7e-06,31
en.wikipedia.org/wiki/Phoolpur,,16,0,16,7e-06,31
en.wikipedia.org/wiki/Tisaura,,16,0,16,7e-06,31
en.wikipedia.org/wiki/Aily,,16,0,16,7e-06,31
en.wikipedia.org/wiki/Aitha,,16,0,16,7e-06,31
en.wikipedia.org/wiki/Akhari,,16,0,16,7e-06,31
en.wikipedia.org/wiki/Amaut,,16,0,16,7e-06,31
en.wikipedia.org/wiki/Amawar,,16,0,16,7e-06,31
en.wikipedia.org/wiki/Araji_Line,,16,0,16,7e-06,31
en.wikipedia.org/wiki/Babhanpura,,16,0,16,7e-06,31
en.wikipedia.org/wiki/Chadpur,,16,0,16,7e-06,31
en.wikipedia.org/wiki/Dabethuwa,,16,0,16,7e-06,31
en.wikipedia.org/wiki/Jayapur,,16,0,16,7e-06,31
en.wikipedia.org/wiki/Khanzadipur,,16,0,16,7e-06,31
en.wikipedia.org/wiki/Lamhi,,16,0,16,7e-06,31
en.wikipedia.org/wiki/Mehdiganj,,16,0,16,7e-06,31
en.wikipedia.org/wiki/Vyaspur,,16,0,16,7e-06,31
en.wikipedia.org/wiki/Uttar_Pradesh_Legislative_Assembly,,27,0,27,7e-06,31
en.wikipedia.org/wiki/Babatpur_railway_station,,10,0,10,7e-06,31
en.wikipedia.org/wiki/Bhulanpur_railway_station,,10,0,10,7e-06,31
en.wikipedia.org/wiki/Kashi_railway_station,,10,0,10,7e-06,31
en.wikipedia.org/wiki/Varanasi_Junction_railway_station,,11,0,11,7e-06,31
en.wikipedia.org/wiki/Varanasi_City_railway_station,,10,0,10,7e-06,31
en.wikipedia.org/wiki/Varanasi_Metro,,9,0,9,7e-06,31
en.wikipedia.org/wiki/Gunpowder,,2,0,2,6e-06,31
en.wikipedia.org/wiki/Jabalpur,,9,0,9,7e-06,31
en.wikipedia.org/wiki/Heavy_Vehicles_Factory,,5,0,5,7e-06,31
en.wikipedia.org/wiki/Shahjahanpur,,5,0,5,6e-06,31
en.wikipedia.org/wiki/Ghaziabad,,25,0,25,7e-06,31
en.wikipedia.org/wiki/Ordnance_Factory_Medak,,3,0,3,6e-06,31
en.wikipedia.org/wiki/Vehicle_Factory_Jabalpur,,3,0,3,6e-06,31
en.wikipedia.org/wiki/Hero_MotoCorp,,6,0,6,7e-06,31
en.wikipedia.org/w/index.php?title=Special:CreateAccount&returnto=Inext,,1,0,1,7e-06,31
en.wikipedia.org/w/index.php?title=Special:UserLogin&returnto=Inext,,1,0,1,7e-06,31
bn.wikipedia.org/wiki/এনেক্সট,,1,0,1,7e-06,31
nl.wikipedia.org/wiki/Inext,,1,0,1,7e-06,31
wikidata.org/wiki/Special:EntityPage/Q3809113,,1,0,1,7e-06,31
en.wikipedia.org/wiki/Talk:Inext,,1,0,1,7e-06,31
en.wikipedia.org/w/index.php?title=Inext&action=edit,,1,0,1,7e-06,31
en.wikipedia.org/w/index.php?title=Inext&action=history,,1,0,1,7e-06,31
en.wikipedia.org/wiki/Special:WhatLinksHere/Inext,,1,0,1,7e-06,31
en.wikipedia.org/wiki/Special:RecentChangesLinked/Inext,,1,0,1,7e-06,31
en.wikipedia.org/w/index.php?title=Inext&oldid=1282236079,,1,0,1,7e-06,31
en.wikipedia.org/w/index.php?title=Inext&action=info,,1,0,1,7e-06,31
en.wikipedia.org/w/index.php?title=Special:QrCode&url=https%3A%2F%2Fen.wikipedia.org%2Fwiki%2FInext,,1,0,1,7e-06,31
en.wikipedia.org/w/index.php?title=Special:DownloadAsPdf&page=Inext&action=show-download-screen,,1,0,1,7e-06,31
en.wikipedia.org/w/index.php?title=Inext&printable=yes,,1,0,1,7e-06,31
inextepaper.jagran.com/,,1,0,1,7e-06,31
en.wikipedia.org/wiki/Ranchi,,10,0,10,7e-06,31
en.wikipedia.org/w/index.php?title=Inext&action=edit&section=1,,1,0,1,7e-06,31
indianmediaobserver.com/modules.php?name=News&file=article&sid=1283,,1,0,1,7e-06,31
web.archive.org/web/20070315194204/http://www.indianmediaobserver.com/modules.php?name=News,,1,0,1,7e-06,31
en.wikipedia.org/wiki/Category:Bilingual_newspapers,,1,0,1,7e-06,31
en.wikipedia.org/wiki/Category:Newspapers_established_in_2006,,1,0,1,7e-06,31
en.wikipedia.org/wiki/Category:2006_establishments_in_Uttar_Pradesh,,2,0,2,7e-06,31
en.m.wikipedia.org/w/index.php?title=Inext&mobileaction=toggle_view_mobile,,1,0,1,7e-06,31
en.wikipedia.org/wiki/Raipur,,12,0,12,7e-06,31
"en.wikipedia.org/wiki/Indian_Institute_of_Information_Technology,_Lucknow",,6,0,6,7e-06,31
en.wikipedia.org/wiki/Surat,,9,0,9,7e-06,31
en.wikipedia.org/wiki/Raebareli,,7,0,7,7e-06,31
en.wikipedia.org/wiki/Rajkot,,8,0,8,7e-06,31
en.wikipedia.org/wiki/Rishikesh,,8,0,8,7e-06,31
en.wikipedia.org/wiki/Silchar,,5,0,5,6e-06,31
en.wikipedia.org/wiki/Vijayawada,,8,0,8,7e-06,31
en.wikipedia.org/wiki/Faridabad,,13,0,13,7e-06,31
en.wikipedia.org/wiki/International_airport,,3,0,3,6e-06,31
en.wikipedia.org/wiki/New_Delhi_Railway_Station,,3,0,3,6e-06,31
en.wikipedia.org/wiki/Delhi_Metro,,13,0,13,7e-06,31
en.wikipedia.org/wiki/Delhi_Airport_Metro_Express,,5,0,5,6e-06,31
en.wikipedia.org/wiki/Yellow_Line_(Delhi_Metro),,5,0,5,6e-06,31
en.wikipedia.org/wiki/Delhi–Alwar_Regional_Rapid_Transit_System,,6,0,6,7e-06,31
en.wikipedia.org/wiki/Haryana_Orbital_Rail_Corridor,,4,0,4,6e-06,31
en.wikipedia.org/wiki/Magenta_Line_(Delhi_Metro),,5,0,5,6e-06,31
en.wikipedia.org/wiki/Blue_Line_(Delhi_Metro),,6,0,6,7e-06,31
en.wikipedia.org/wiki/Rapid_Metro_Gurgaon,,8,0,8,7e-06,31
en.wikipedia.org/wiki/Delhi–Jaipur_line,,4,0,4,6e-06,31
en.wikipedia.org/wiki/Faridabad–Noida–Ghaziabad_Expressway,,2,0,2,6e-06,31
en.wikipedia.org/wiki/Delhi_Transport_Corporation,,7,0,7,7e-06,31
en.wikipedia.org/wiki/National_Capital_Region_Transport_Corporation,,4,0,4,6e-06,31
en.wikipedia.org/wiki/Mehrauli,,6,0,6,6e-06,31
en.wikipedia.org/wiki/National_Police_Memorial_(India),,6,0,6,7e-06,31
"en.wikipedia.org/wiki/Connaught_Place,_New_Delhi",,7,0,7,6e-06,31
en.wikipedia.org/wiki/South_Delhi_district,,6,0,6,6e-06,31
en.wikipedia.org/wiki/Greater_Noida,,15,0,15,7e-06,31
en.wikipedia.org/wiki/Dadri,,6,0,6,6e-06,31
en.wikipedia.org/wiki/Delhi_Junction_railway_station,,6,0,6,6e-06,31
en.wikipedia.org/wiki/Delhi_Suburban_Railway,,11,0,11,7e-06,31
en.wikipedia.org/wiki/Category:20th-century_architecture_in_India,,5,0,5,7e-06,31
en.wikipedia.org/wiki/Category:Articles_with_unsourced_statements_from_June_2025,,5,0,5,6e-06,31
en.wikipedia.org/w/index.php?title=Special:CreateAccount&returnto=Jajmau,,1,0,1,6e-06,31
en.wikipedia.org/w/index.php?title=Special:UserLogin&returnto=Jajmau,,1,0,1,6e-06,31
bh.wikipedia.org/wiki/जाजमऊ,,1,0,1,6e-06,31
hi.wikipedia.org/wiki/जाजमऊ,,1,0,1,6e-06,31
kn.wikipedia.org/wiki/ಜಾಜ್ಮೌ,,1,0,1,6e-06,31
ta.wikipedia.org/wiki/யாச்சுமவு,,1,0,1,6e-06,31
ur.wikipedia.org/wiki/جاجمئو,,1,0,1,6e-06,31
wikidata.org/wiki/Special:EntityPage/Q6124373,,1,0,1,6e-06,31
en.wikipedia.org/wiki/Talk:Jajmau,,1,0,1,6e-06,31
en.wikipedia.org/w/index.php?title=Jajmau&action=edit,,1,0,1,6e-06,31
en.wikipedia.org/w/index.php?title=Jajmau&action=history,,1,0,1,6e-06,31
en.wikipedia.org/wiki/Special:WhatLinksHere/Jajmau,,1,0,1,6e-06,31
en.wikipedia.org/wiki/Special:RecentChangesLinked/Jajmau,,1,0,1,6e-06,31
en.wikipedia.org/w/index.php?title=Jajmau&oldid=1296200111,,1,0,1,6e-06,31
en.wikipedia.org/w/index.php?title=Jajmau&action=info,,1,0,1,6e-06,31
en.wikipedia.org/w/index.php?title=Special:QrCode&url=https%3A%2F%2Fen.wikipedia.org%2Fwiki%2FJajmau,,1,0,1,6e-06,31
en.wikipedia.org/w/index.php?title=Special:DownloadAsPdf&page=Jajmau&action=show-download-screen,,1,0,1,6e-06,31
en.wikipedia.org/w/index.php?title=Jajmau&printable=yes,,1,0,1,6e-06,31
commons.wikimedia.org/wiki/Category:Jajmau,,1,0,1,6e-06,31
geohack.toolforge.org/geohack.php?pagename=Jajmau&params=26.46_N_80.35_E_type:city_region:IN-UP,,1,0,1,6e-06,31
en.wikipedia.org/wiki/Special:EditPage/Jajmau,,1,0,1,6e-06,31
"google.com/search?as_eq=wikipedia&q=""Jajmau""",,1,0,1,6e-06,31
"google.com/search?tbm=nws&q=""Jajmau""+-wikipedia&tbs=ar:1",,1,0,1,6e-06,31
"google.com/search?&q=""Jajmau""&tbs=bkt:s&tbm=bks",,1,0,1,6e-06,31
"google.com/search?tbs=bks:1&q=""Jajmau""+-wikipedia",,1,0,1,6e-06,31
"scholar.google.com/scholar?q=""Jajmau""",,1,0,1,6e-06,31
"jstor.org/action/doBasicSearch?Query=""Jajmau""&acc=on&wc=on",,1,0,1,6e-06,31
en.wikipedia.org/wiki/Urdu_language,,6,0,6,7e-06,31
en.wikipedia.org/wiki/Kannauji_language,,13,0,13,7e-06,31
en.wikipedia.org/wiki/Maharajpur_(Uttar_Pradesh_Assembly_constituency),,1,0,1,6e-06,31
en.wikipedia.org/wiki/Unnao_(Assembly_constituency),,1,0,1,6e-06,31
en.wikipedia.org/wiki/Industrial_suburb,,1,0,1,6e-06,31
en.wikipedia.org/wiki/Kanpur_metropolitan_area,,4,0,4,7e-06,31
en.wikipedia.org/w/index.php?title=Jajmau&action=edit&section=1,,1,0,1,6e-06,31
en.wiktionary.org/wiki/मर्यादा,,1,0,1,6e-06,31
en.wikipedia.org/wiki/Madhuca_longifolia,,1,0,1,6e-06,31
en.wikipedia.org/w/index.php?title=Jajmau&action=edit&section=2,,1,0,1,6e-06,31
en.wikipedia.org/w/index.php?title=Jajmau&action=edit&section=3,,1,0,1,6e-06,31
en.wikipedia.org/wiki/Maurya,,1,0,1,6e-06,31
en.wikipedia.org/w/index.php?title=Jajmau&action=edit&section=4,,1,0,1,6e-06,31
worldweather.org/066/c00532.htm,,1,0,1,6e-06,31
en.wikipedia.org/w/index.php?title=Jajmau&action=edit&section=5,,1,0,1,6e-06,31
en.wikipedia.org/w/index.php?title=Jajmau&action=edit&section=6,,1,0,1,6e-06,31
en.wikipedia.org/wiki/Hebron,,1,0,1,6e-06,31
en.wikipedia.org/w/index.php?title=Jajmau&action=edit&section=7,,1,0,1,6e-06,31
indiaenvironmentportal.org.in/media/iep/infographics/Can%20we%20save%20Ganga/index.htm,,1,0,1,6e-06,31
books.google.com/books?id=PwdDAAAAYAAJ,,1,0,1,6e-06,31
articles.timesofindia.indiatimes.com/2009-09-17/kanpur/28109321_1_excavation-mauryan-period-bricks,,1,0,1,6e-06,31
dnaindia.com/scitech/report_artefacts-of-pre-muaryan-times-discovered-at-jajmau_1361609,,1,0,1,6e-06,31
en.wikipedia.org/wiki/DNA_(newspaper),,1,0,1,6e-06,31
censusindiamaps.net/page/Religion_WhizMap1/housemap.htm,,1,0,1,6e-06,31
en.m.wikipedia.org/w/index.php?title=Jajmau&mobileaction=toggle_view_mobile,,1,0,1,6e-06,31
en.wikipedia.org/w/index.php?title=Special:CreateAccount&returnto=JK+Temple,,1,0,1,6e-06,31
en.wikipedia.org/w/index.php?title=Special:UserLogin&returnto=JK+Temple,,1,0,1,6e-06,31
"hi.wikipedia.org/wiki/राधा_कृष्ण_मंदिर,_कानपुर",,1,0,1,6e-06,31
wikidata.org/wiki/Special:EntityPage/Q12449469,,1,0,1,6e-06,31
en.wikipedia.org/wiki/Talk:JK_Temple,,1,0,1,6e-06,31
en.wikipedia.org/w/index.php?title=JK_Temple&action=edit,,1,0,1,6e-06,31
en.wikipedia.org/w/index.php?title=JK_Temple&action=history,,1,0,1,6e-06,31
en.wikipedia.org/wiki/Special:WhatLinksHere/JK_Temple,,1,0,1,6e-06,31
en.wikipedia.org/wiki/Special:RecentChangesLinked/JK_Temple,,1,0,1,6e-06,31
en.wikipedia.org/w/index.php?title=JK_Temple&oldid=1288167184,,1,0,1,6e-06,31
en.wikipedia.org/w/index.php?title=JK_Temple&action=info,,1,0,1,6e-06,31
en.wikipedia.org/w/index.php?title=Special:DownloadAsPdf&page=JK_Temple&action=show-download-screen,,1,0,1,6e-06,31
en.wikipedia.org/w/index.php?title=JK_Temple&printable=yes,,1,0,1,6e-06,31
commons.wikimedia.org/wiki/Category:JK_Temple,,1,0,1,6e-06,31
geohack.toolforge.org/geohack.php?pagename=JK_Temple&params=26.473_N_80.307_E_type:landmark,,1,0,1,6e-06,31
en.wikipedia.org/wiki/File:JKTemple.JPG,,2,0,2,7e-06,31
en.wikipedia.org/wiki/List_of_religions_and_spiritual_traditions,,2,0,2,6e-06,31
"en.wikipedia.org/wiki/Kanpur,_India",,3,0,3,7e-06,31
en.wikipedia.org/wiki/Mandapa,,1,0,1,6e-06,31
en.wikipedia.org/wiki/Radha_Krishna,,1,0,1,6e-06,31
en.wikipedia.org/w/index.php?title=JK_Temple&action=edit&section=1,,1,0,1,6e-06,31
en.wikipedia.org/wiki/Singhania_family,,1,0,1,6e-06,31
en.wikipedia.org/wiki/JK_Organisation,,1,0,1,6e-06,31
en.wikipedia.org/w/index.php?title=JK_Temple&action=edit&section=2,,1,0,1,6e-06,31
en.wikipedia.org/w/index.php?title=JK_Temple&action=edit&section=3,,1,0,1,6e-06,31
en.wikipedia.org/wiki/File:JK_temple.JPG,,1,0,1,6e-06,31
en.wikipedia.org/w/index.php?title=JK_Temple&action=edit&section=4,,1,0,1,6e-06,31
en.wikipedia.org/w/index.php?title=JK_Temple&action=edit&section=5,,1,0,1,6e-06,31
en.wikipedia.org/w/index.php?title=JK_Temple&action=edit&section=6,,1,0,1,6e-06,31
en.wikipedia.org/w/index.php?title=JK_Temple&action=edit&section=7,,1,0,1,6e-06,31
zeenews.india.com/entertainment/travel/feature/top-enchanting-places-to-visit-in-kanpur_1869682.htm,,1,0,1,6e-06,31
kanpuronline.in/city-guide/jk-temple-in-kanpur,,1,0,1,6e-06,31
jktrust.org/who_we_are.php,,1,0,1,6e-06,31
mapsofindia.com/kanpur/places-of-interest/j-k-temple.html,,1,0,1,6e-06,31
kanpurcity.com/about/citymn3.html,,1,0,1,6e-06,31
ixigo.com/jk-temple-kanpur-india-ne-1634166,,1,0,1,6e-06,31
en.wikipedia.org/wiki/Category:Religious_buildings_and_structures_in_Kanpur,,2,0,2,6e-06,31
en.m.wikipedia.org/w/index.php?title=JK_Temple&mobileaction=toggle_view_mobile,,1,0,1,6e-06,31
upload.wikimedia.org/wikipedia/commons/thumb/3/35/JKTemple.JPG/250px-JKTemple.JPG,,2,0,2,7e-06,31
upload.wikimedia.org/wikipedia/commons/thumb/c/cc/JK_temple.JPG/250px-JK_temple.JPG,,1,0,1,6e-06,31
en.wikipedia.org/wiki/Category:Use_dmy_dates_from_July_2019,,7,0,7,7e-06,31
en.wikipedia.org/w/index.php?title=Special:CreateAccount&returnto=Kalyanpur%2C+Uttar+Pradesh,,2,0,2,6e-06,31
en.wikipedia.org/w/index.php?title=Special:UserLogin&returnto=Kalyanpur%2C+Uttar+Pradesh,,2,0,2,6e-06,31
"bh.wikipedia.org/wiki/कल्याणपुर,_उत्तर_प्रदेश",,2,0,2,6e-06,31
ceb.wikipedia.org/wiki/Kaliānpur_(lungsod),,2,0,2,6e-06,31
"hi.wikipedia.org/wiki/कल्याणपुर,_कानपुर",,2,0,2,6e-06,31
sv.wikipedia.org/wiki/Kaliānpur,,2,0,2,6e-06,31
wikidata.org/wiki/Special:EntityPage/Q6355006,,2,0,2,6e-06,31
"en.wikipedia.org/wiki/Talk:Kalyanpur,_Uttar_Pradesh",,2,0,2,6e-06,31
"en.wikipedia.org/w/index.php?title=Kalyanpur,_Uttar_Pradesh&action=edit",,2,0,2,6e-06,31
"en.wikipedia.org/w/index.php?title=Kalyanpur,_Uttar_Pradesh&action=history",,2,0,2,6e-06,31
"en.wikipedia.org/wiki/Special:WhatLinksHere/Kalyanpur,_Uttar_Pradesh",,2,0,2,6e-06,31
"en.wikipedia.org/wiki/Special:RecentChangesLinked/Kalyanpur,_Uttar_Pradesh",,2,0,2,6e-06,31
"en.wikipedia.org/w/index.php?title=Kalyanpur,_Uttar_Pradesh&oldid=1271441066",,2,0,2,6e-06,31
"en.wikipedia.org/w/index.php?title=Kalyanpur,_Uttar_Pradesh&action=info",,2,0,2,6e-06,31
"en.wikipedia.org/w/index.php?title=Kalyanpur,_Uttar_Pradesh&printable=yes",,2,0,2,6e-06,31
"refill.toolforge.org/ng/result.php?page=Kalyanpur,_Uttar_Pradesh&defaults=y",,2,0,2,6e-06,31
"citations.toolforge.org/process_page.php?edit=automated_tools&slow=1&page=Kalyanpur,_Uttar_Pradesh",,2,0,2,6e-06,31
"en.wikipedia.org/wiki/Special:EditPage/Kalyanpur,_Uttar_Pradesh",,2,0,2,6e-06,31
"google.com/search?as_eq=wikipedia&q=""Kalyanpur%2C+Uttar+Pradesh""",,2,0,2,6e-06,31
"google.com/search?tbm=nws&q=""Kalyanpur%2C+Uttar+Pradesh""+-wikipedia&tbs=ar:1",,2,0,2,6e-06,31
"google.com/search?&q=""Kalyanpur%2C+Uttar+Pradesh""&tbs=bkt:s&tbm=bks",,2,0,2,6e-06,31
"google.com/search?tbs=bks:1&q=""Kalyanpur%2C+Uttar+Pradesh""+-wikipedia",,2,0,2,6e-06,31
"scholar.google.com/scholar?q=""Kalyanpur%2C+Uttar+Pradesh""",,2,0,2,6e-06,31
"jstor.org/action/doBasicSearch?Query=""Kalyanpur%2C+Uttar+Pradesh""&acc=on&wc=on",,2,0,2,6e-06,31
en.wikipedia.org/wiki/List_of_RTO_districts_in_India,,3,0,3,7e-06,31
up.gov.in/,,7,0,7,7e-06,31
upavp.in/post/en-kanpur-Schemes,,2,0,2,6e-06,31
"en.wikipedia.org/w/index.php?title=Kalyanpur,_Uttar_Pradesh&action=edit&section=1",,2,0,2,6e-06,31
en.wikipedia.org/wiki/Indian_rebellion_of_1857,,2,0,2,6e-06,31
en.wikipedia.org/wiki/Bahadur_Shah_II,,4,0,4,6e-06,31
en.wikipedia.org/wiki/Azimullah_Khan,,5,0,5,7e-06,31
en.wikipedia.org/wiki/British_India,,9,0,9,7e-06,31
"en.wikipedia.org/w/index.php?title=Kalyanpur,_Uttar_Pradesh&action=edit&section=2",,2,0,2,6e-06,31
en.wikipedia.org/wiki/Mathura_Junction_railway_station,,8,0,8,7e-06,31
"en.wikipedia.org/w/index.php?title=Kalyanpur,_Uttar_Pradesh&action=edit&section=3",,2,0,2,6e-06,31
"en.wikipedia.org/w/index.php?title=Kalyanpur,_Uttar_Pradesh&action=edit&section=4",,2,0,2,6e-06,31
en.wikipedia.org/wiki/Naramau,,2,0,2,6e-06,31
"en.wikipedia.org/w/index.php?title=Kalyanpur,_Uttar_Pradesh&action=edit&section=5",,2,0,2,6e-06,31
sites.google.com/site/tropicalplantresearch/,,2,0,2,6e-06,31
tropicalplantresearch.com/,,2,0,2,6e-06,31
"en.wikipedia.org/w/index.php?title=Kalyanpur,_Uttar_Pradesh&action=edit&section=6",,2,0,2,6e-06,31
en.wikipedia.org/wiki/Kalyanpur_railway_station,,8,0,8,7e-06,31
en.wikipedia.org/wiki/Metre_gauge,,2,0,2,6e-06,31
en.wikipedia.org/wiki/Broad_gauge,,4,0,4,6e-06,31
en.wikipedia.org/wiki/Safipur,,3,0,3,6e-06,31
"en.wikipedia.org/w/index.php?title=Kalyanpur,_Uttar_Pradesh&action=edit&section=7",,2,0,2,6e-06,31
"en.wikipedia.org/wiki/Saratoga_Springs,_New_York",,2,0,2,6e-06,31
"en.wikipedia.org/wiki/Princeton,_New_Jersey",,6,0,6,6e-06,31
"en.wikipedia.org/w/index.php?title=Kalyanpur,_Uttar_Pradesh&action=edit&section=8",,2,0,2,6e-06,31
en.wikipedia.org/wiki/Help:Multilingual_support_(Indic),,5,0,5,7e-06,31
en.wikipedia.org/wiki/Mojibake,,5,0,5,7e-06,31
en.wikipedia.org/wiki/George_Otto_Trevelyan,,2,0,2,6e-06,31
en.wikipedia.org/wiki/Special:BookSources/81-7223-018-4,,2,0,2,6e-06,31
mainlesson.com/display.php?author=gilliat&book=mutiny&story=cawnpur,,2,0,2,6e-06,31
books.google.com/books?id=DS--7UwOQ_8C,,2,0,2,6e-06,31
en.wikipedia.org/wiki/Special:BookSources/9780850452594,,2,0,2,6e-06,31
web.archive.org/web/20220401041310/https://www.wikivillage.in/block/uttar-pradesh/kanpur/kalyanpur,,2,0,2,6e-06,31
wikivillage.in/block/uttar-pradesh/kanpur/kalyanpur,,2,0,2,6e-06,31
techkriti.org/exhibitions/exhibitions/citycluster-avatarts/,,2,0,2,6e-06,31
web.archive.org/web/20160324230247/http://www.iitk.ac.in/infocell/Archive/dirjan1/techkriti99.html,,2,0,2,6e-06,31
iitk.ac.in/infocell/Archive/dirjan1/techkriti99.html,,2,0,2,6e-06,31
"en.wikipedia.org/w/index.php?title=Kalyanpur,_Uttar_Pradesh&action=edit&section=9",,2,0,2,6e-06,31
en.wiktionary.org/wiki/Special:Search/Kanpur,,2,0,2,6e-06,31
commons.wikimedia.org/wiki/Category:Kanpur,,5,0,5,7e-06,31
en.wikinews.org/wiki/Special:Search/Kanpur,,2,0,2,6e-06,31
en.wikiquote.org/wiki/Special:Search/Kanpur,,2,0,2,6e-06,31
en.wikisource.org/wiki/Special:Search/Kanpur,,2,0,2,6e-06,31
en.wikibooks.org/wiki/Special:Search/Kanpur,,2,0,2,6e-06,31
en.wikiversity.org/wiki/Special:Search/Kanpur,,2,0,2,6e-06,31
web.archive.org/web/20110903013316/http://www.upelections.co.in/,,3,0,3,7e-06,31
upelections.co.in/uttar-pradesh-assembly-constituencies/kalyanpur,,2,0,2,6e-06,31
kanpurcity.co.in/,,2,0,2,6e-06,31
kanpur.nic.in/,,2,0,2,6e-06,31
en.wikipedia.org/wiki/Category:Articles_needing_cleanup_from_August_2022,,5,0,5,7e-06,31
en.wikipedia.org/wiki/Category:Articles_needing_additional_references_from_August_2008,,2,0,2,6e-06,31
en.wikipedia.org/wiki/Category:Use_British_English_from_September_2013,,4,0,4,6e-06,31
en.wikipedia.org/wiki/Category:Use_dmy_dates_from_January_2024,,4,0,4,6e-06,31
en.wikipedia.org/wiki/Category:Articles_with_unsourced_statements_from_September_2012,,3,0,3,6e-06,31
en.wikipedia.org/wiki/Category:Articles_with_dead_external_links_from_February_2020,,6,0,6,7e-06,31
"en.m.wikipedia.org/w/index.php?title=Kalyanpur,_Uttar_Pradesh&mobileaction=toggle_view_mobile",,2,0,2,6e-06,31
en.wikipedia.org/wiki/Honda,,4,0,4,6e-06,31
en.wikipedia.org/wiki/Internet_Archive,,7,0,7,6e-06,31
en.wikipedia.org/w/index.php?title=Special:CreateAccount&returnto=Kanpur,,2,0,2,6e-06,31
en.wikipedia.org/w/index.php?title=Special:UserLogin&returnto=Kanpur,,2,0,2,6e-06,31
af.wikipedia.org/wiki/Kanpur,,2,0,2,6e-06,31
ast.wikipedia.org/wiki/Kanpur,,2,0,2,6e-06,31
az.wikipedia.org/wiki/Kanpur,,2,0,2,6e-06,31
bn.wikipedia.org/wiki/কানপুর,,2,0,2,6e-06,31
zh-min-nan.wikipedia.org/wiki/Kanpur_(siâⁿ),,2,0,2,6e-06,31
be.wikipedia.org/wiki/Канпур,,2,0,2,6e-06,31
bh.wikipedia.org/wiki/कानपुर,,2,0,2,6e-06,31
bg.wikipedia.org/wiki/Канпур,,2,0,2,6e-06,31
br.wikipedia.org/wiki/Kanpur,,2,0,2,6e-06,31
bxr.wikipedia.org/wiki/Канпур,,2,0,2,6e-06,31
ca.wikipedia.org/wiki/Kanpur,,2,0,2,6e-06,31
ceb.wikipedia.org/wiki/Kānpur_(lungsod),,2,0,2,6e-06,31
cs.wikipedia.org/wiki/Kánpur,,2,0,2,6e-06,31
da.wikipedia.org/wiki/Kanpur,,2,0,2,6e-06,31
dty.wikipedia.org/wiki/कानपुर,,2,0,2,6e-06,31
el.wikipedia.org/wiki/Κανπούρ,,2,0,2,6e-06,31
es.wikipedia.org/wiki/Kanpur,,3,0,3,6e-06,31
eo.wikipedia.org/wiki/Kanpur,,2,0,2,6e-06,31
eu.wikipedia.org/wiki/Kanpur,,2,0,2,6e-06,31
fa.wikipedia.org/wiki/کان‌پور,,2,0,2,6e-06,31
hif.wikipedia.org/wiki/Kanpur,,2,0,2,6e-06,31
fr.wikipedia.org/wiki/Kanpur,,3,0,3,7e-06,31
ga.wikipedia.org/wiki/Kanpur,,2,0,2,6e-06,31
gl.wikipedia.org/wiki/Kanpur,,2,0,2,6e-06,31
gu.wikipedia.org/wiki/કાનપુર,,2,0,2,6e-06,31
ko.wikipedia.org/wiki/칸푸르,,3,0,3,7e-06,31
ha.wikipedia.org/wiki/Kanpur,,2,0,2,6e-06,31
hy.wikipedia.org/wiki/Կանպուր,,2,0,2,6e-06,31
hr.wikipedia.org/wiki/Kanpur,,2,0,2,6e-06,31
bpy.wikipedia.org/wiki/কানপুর,,2,0,2,6e-06,31
id.wikipedia.org/wiki/Kanpur,,2,0,2,6e-06,31
os.wikipedia.org/wiki/Канпур,,2,0,2,6e-06,31
is.wikipedia.org/wiki/Kanpur,,2,0,2,6e-06,31
it.wikipedia.org/wiki/Kanpur,,3,0,3,7e-06,31
he.wikipedia.org/wiki/קאנפור,,2,0,2,6e-06,31
kn.wikipedia.org/wiki/ಕಾನ್ಪುರ,,2,0,2,6e-06,31
pam.wikipedia.org/wiki/Kanpur,,2,0,2,6e-06,31
ka.wikipedia.org/wiki/კანპური,,2,0,2,6e-06,31
kw.wikipedia.org/wiki/Kanpur,,2,0,2,6e-06,31
sw.wikipedia.org/wiki/Kanpur,,2,0,2,6e-06,31
ky.wikipedia.org/wiki/Канпер,,2,0,2,6e-06,31
lld.wikipedia.org/wiki/Kanpur,,2,0,2,6e-06,31
lv.wikipedia.org/wiki/Kānpura,,2,0,2,6e-06,31
lt.wikipedia.org/wiki/Kanpuras,,2,0,2,6e-06,31
hu.wikipedia.org/wiki/Kánpur,,2,0,2,6e-06,31
mai.wikipedia.org/wiki/कानपुर,,2,0,2,6e-06,31
mg.wikipedia.org/wiki/Kanpur,,2,0,2,6e-06,31
ml.wikipedia.org/wiki/കാൺപൂർ,,3,0,3,7e-06,31
mi.wikipedia.org/wiki/Kanpur,,2,0,2,6e-06,31
mr.wikipedia.org/wiki/कानपूर,,3,0,3,7e-06,31
xmf.wikipedia.org/wiki/კანპური,,2,0,2,6e-06,31
arz.wikipedia.org/wiki/كانبور,,2,0,2,6e-06,31
mzn.wikipedia.org/wiki/کانپور,,2,0,2,6e-06,31
"ms.wikipedia.org/wiki/Kanpur,_Kanpur_Nagar",,2,0,2,6e-06,31
mn.wikipedia.org/wiki/Канпур,,2,0,2,6e-06,31
nl.wikipedia.org/wiki/Kanpur_(stad),,2,0,2,6e-06,31
ne.wikipedia.org/wiki/कानपुर,,2,0,2,6e-06,31
new.wikipedia.org/wiki/कानपुर,,2,0,2,6e-06,31
ja.wikipedia.org/wiki/カーンプル,,2,0,2,6e-06,31
ce.wikipedia.org/wiki/Канпур,,2,0,2,6e-06,31
frr.wikipedia.org/wiki/Kanpur,,2,0,2,6e-06,31
no.wikipedia.org/wiki/Kanpur,,3,0,3,7e-06,31
mhr.wikipedia.org/wiki/Канпур,,2,0,2,6e-06,31
or.wikipedia.org/wiki/କାନପୁର,,2,0,2,6e-06,31
uz.wikipedia.org/wiki/Kanpur,,2,0,2,6e-06,31
pa.wikipedia.org/wiki/ਕਾਨਪੁਰ,,3,0,3,7e-06,31
pnb.wikipedia.org/wiki/کانپور,,3,0,3,7e-06,31
ps.wikipedia.org/wiki/کانپور,,2,0,2,6e-06,31
pl.wikipedia.org/wiki/Kanpur,,2,0,2,6e-06,31
pt.wikipedia.org/wiki/Kanpur,,3,0,3,7e-06,31
ro.wikipedia.org/wiki/Kanpur,,2,0,2,6e-06,31
ru.wikipedia.org/wiki/Канпур,,2,0,2,6e-06,31
sa.wikipedia.org/wiki/कानपुरम्,,2,0,2,6e-06,31
sat.wikipedia.org/wiki/ᱠᱟᱱᱯᱩᱨ,,2,0,2,6e-06,31
sco.wikipedia.org/wiki/Kanpur,,2,0,2,6e-06,31
simple.wikipedia.org/wiki/Kanpur,,2,0,2,6e-06,31
sr.wikipedia.org/wiki/Канпур,,2,0,2,6e-06,31
fi.wikipedia.org/wiki/Kanpur,,2,0,2,6e-06,31
sv.wikipedia.org/wiki/Kanpur,,2,0,2,6e-06,31
tl.wikipedia.org/wiki/Kanpur,,3,0,3,7e-06,31
ta.wikipedia.org/wiki/கான்பூர்,,3,0,3,7e-06,31
tt.wikipedia.org/wiki/Канпур,,2,0,2,6e-06,31
te.wikipedia.org/wiki/కాన్పూరు,,3,0,3,7e-06,31
th.wikipedia.org/wiki/กานปุระ,,2,0,2,6e-06,31
tr.wikipedia.org/wiki/Kanpur,,2,0,2,6e-06,31
tw.wikipedia.org/wiki/Kanpur,,2,0,2,6e-06,31
uk.wikipedia.org/wiki/Канпур,,2,0,2,6e-06,31
ur.wikipedia.org/wiki/کان_پور,,2,0,2,6e-06,31
vi.wikipedia.org/wiki/Kanpur,,2,0,2,6e-06,31
vo.wikipedia.org/wiki/Kanpur,,2,0,2,6e-06,31
war.wikipedia.org/wiki/Kanpur,,2,0,2,6e-06,31
wuu.wikipedia.org/wiki/坎普尔,,2,0,2,6e-06,31
zh-yue.wikipedia.org/wiki/坎浦,,2,0,2,6e-06,31
zh.wikipedia.org/wiki/坎普尔,,2,0,2,6e-06,31
tly.wikipedia.org/wiki/Kanpur,,2,0,2,6e-06,31
wikidata.org/wiki/Special:EntityPage/Q66568,,2,0,2,6e-06,31
en.wikipedia.org/wiki/Talk:Kanpur,,2,0,2,6e-06,31
en.wikipedia.org/w/index.php?title=Kanpur&action=edit,,3,0,3,6e-06,31
en.wikipedia.org/w/index.php?title=Kanpur&action=history,,2,0,2,6e-06,31
en.wikipedia.org/wiki/Special:WhatLinksHere/Kanpur,,2,0,2,6e-06,31
en.wikipedia.org/wiki/Special:RecentChangesLinked/Kanpur,,2,0,2,6e-06,31
en.wikipedia.org/w/index.php?title=Kanpur&oldid=1309516278,,2,0,2,6e-06,31
en.wikipedia.org/w/index.php?title=Kanpur&action=info,,2,0,2,6e-06,31
en.wikipedia.org/w/index.php?title=Special:QrCode&url=https%3A%2F%2Fen.wikipedia.org%2Fwiki%2FKanpur,,2,0,2,6e-06,31
en.wikipedia.org/w/index.php?title=Special:DownloadAsPdf&page=Kanpur&action=show-download-screen,,2,0,2,6e-06,31
en.wikipedia.org/w/index.php?title=Kanpur&printable=yes,,2,0,2,6e-06,31
en.wikivoyage.org/wiki/Kanpur,,2,0,2,6e-06,31
geohack.toolforge.org/geohack.php?pagename=Kanpur&params=26.449923_N_80.331874_E_type:city_region:IN,,2,0,2,6e-06,31
en.wikipedia.org/wiki/Metropolis,,2,0,2,6e-06,31
en.wikipedia.org/wiki/File:J.K._Temple_(cropped).jpg,,2,0,2,6e-06,31
en.wikipedia.org/wiki/File:Kanpur_Boat_Club_1.jpg,,3,0,3,6e-06,31
en.wikipedia.org/wiki/File:Kanpur_Central_Railway_Station_Building_(Cant_Side_View).jpg,,3,0,3,6e-06,31
en.wikipedia.org/wiki/File:Kanpur_Memorial_Church.jpg,,4,0,4,7e-06,31
en.wikipedia.org/wiki/File:Green_Park_International_Stadium_Kanpur.jpg,,4,0,4,6e-06,31
en.wikipedia.org/wiki/File:Kanpur_Skyscrapers.jpg,,2,0,2,6e-06,31
en.wikipedia.org/wiki/Divisions_of_Uttar_Pradesh,,10,0,10,7e-06,31
en.wikipedia.org/wiki/Kanpur_Division,,2,0,2,6e-06,31
en.wikipedia.org/wiki/Kanpur_Nagar_District,,3,0,3,6e-06,31
en.wikipedia.org/wiki/Municipal_Corporation,,3,0,3,6e-06,31
en.wikipedia.org/wiki/Kanpur_Municipal_Corporation,,9,0,9,7e-06,31
en.wikipedia.org/wiki/List_of_mayors_of_Kanpur,,2,0,2,6e-06,31
en.wikipedia.org/wiki/Municipal_commissioner,,2,0,2,6e-06,31
en.wikipedia.org/wiki/Indian_Administrative_Services,,2,0,2,6e-06,31
en.wikipedia.org/wiki/Human_sex_ratio,,7,0,7,7e-06,31
en.wikipedia.org/wiki/Female,,8,0,8,7e-06,31
en.wikipedia.org/wiki/Male,,8,0,8,7e-06,31
en.wikipedia.org/wiki/Cricket_field,,2,0,2,6e-06,31
en.wikipedia.org/wiki/Rapid_Transit,,3,0,3,6e-06,31
en.wikipedia.org/wiki/File:UPMRC.svg,,3,0,3,6e-06,31
en.wikipedia.org/wiki/Domestic_Airport,,2,0,2,6e-06,31
kanpurnagar.nic.in/,,3,0,3,6e-06,31
upload.wikimedia.org/wikipedia/commons/transcoded/d/d7/Kanpur.ogg/Kanpur.ogg.mp3,,2,0,2,6e-06,31
en.wikipedia.org/wiki/File:Kanpur.ogg,,2,0,2,6e-06,31
en.wikipedia.org/wiki/Western_world,,4,0,4,6e-06,31
en.wikipedia.org/wiki/Garrison,,4,0,4,6e-06,31
"en.wikipedia.org/wiki/Z_Square_Mall,_Kanpur",,3,0,3,6e-06,31
en.wikipedia.org/wiki/List_of_most_populous_metropolitan_areas_in_India,,2,0,2,6e-06,31
en.wikipedia.org/w/index.php?title=Kanpur&action=edit&section=1,,2,0,2,6e-06,31
en.wikipedia.org/wiki/Sachendi,,2,0,2,6e-06,31
en.wikipedia.org/wiki/Karna,,2,0,2,6e-06,31
en.wikipedia.org/wiki/Kalpi,,8,0,8,7e-06,31
en.wikipedia.org/wiki/Mihir_Bhoja,,2,0,2,6e-06,31
en.wikipedia.org/wiki/Shuja-ud-Daula,,4,0,4,6e-06,31
en.wikipedia.org/wiki/Nawab_of_Awadh,,9,0,9,7e-06,31
en.wikipedia.org/wiki/Oudh_State,,7,0,7,7e-06,31
en.wikipedia.org/wiki/Saadat_Ali_Khan_II,,2,0,2,6e-06,31
en.wikipedia.org/wiki/Indigo_dye,,2,0,2,6e-06,31
"en.wikipedia.org/wiki/Sir_Alexander_MacRobert,_1st_Baronet",,2,0,2,6e-06,31
en.wikipedia.org/wiki/Façade,,2,0,2,6e-06,31
en.wikipedia.org/wiki/Palace_of_Westminster,,2,0,2,6e-06,31
en.wikipedia.org/wiki/Big_Ben,,2,0,2,6e-06,31
en.wikipedia.org/wiki/McRobertganj,,2,0,2,6e-06,31
en.wikipedia.org/w/index.php?title=Kanpur&action=edit&section=2,,2,0,2,6e-06,31
en.wikipedia.org/wiki/File:Kanpur_from_the_river.jpg,,2,0,2,6e-06,31
en.wikipedia.org/wiki/Nana_Saheb_Peshwa_II,,5,0,5,7e-06,31
en.wikipedia.org/wiki/James_George_Smith_Neill,,4,0,4,6e-06,31
en.wikipedia.org/wiki/Cawnpore_Massacre,,2,0,2,6e-06,31
en.wikipedia.org/w/index.php?title=Kanpur&action=edit&section=3,,2,0,2,6e-06,31
en.wikipedia.org/wiki/File:Ganga_Barrage_Kanpur.jpg,,2,0,2,6e-06,31
geohack.toolforge.org/geohack.php?pagename=Kanpur&params=26.449923_N_80.331874_E_,,2,0,2,6e-06,31
en.wikipedia.org/wiki/Sati_Chaura_Ghat,,2,0,2,6e-06,31
en.wikipedia.org/w/index.php?title=Kanpur&action=edit&section=4,,2,0,2,6e-06,31
en.wikipedia.org/wiki/Climate_of_Uttar_Pradesh,,3,0,3,6e-06,31
en.wikipedia.org/wiki/Humid_subtropical_climate,,5,0,5,6e-06,31
en.wikipedia.org/wiki/Semi-arid_climate,,4,0,4,6e-06,31
en.wikipedia.org/wiki/Köppen_climate_classification,,6,0,6,6e-06,31
en.wikipedia.org/wiki/Relative_humidity,,6,0,6,6e-06,31
en.wikipedia.org/w/index.php?title=Kanpur&action=edit&section=5,,2,0,2,6e-06,31
en.wikipedia.org/wiki/Islam_in_Uttar_Pradesh,,12,0,12,7e-06,31
en.wikipedia.org/wiki/Ethnic_communities_in_Kanpur,,2,0,2,6e-06,31
en.wikipedia.org/wiki/List_of_people_from_Kanpur,,3,0,3,7e-06,31
en.wikipedia.org/wiki/Fire_temple,,2,0,2,6e-06,31
en.wikipedia.org/wiki/Muslims,,7,0,7,7e-06,31
en.wikipedia.org/w/index.php?title=Kanpur&action=edit&section=6,,2,0,2,6e-06,31
en.wikipedia.org/wiki/Divisional_Commissioner,,5,0,5,7e-06,31
en.wikipedia.org/wiki/District_Magistrate,,5,0,5,7e-06,31
en.wikipedia.org/wiki/Inspector-general_of_police,,3,0,3,6e-06,31
en.wikipedia.org/wiki/Mayor,,2,0,2,6e-06,31
en.wikipedia.org/wiki/Pramila_Pandey,,2,0,2,6e-06,31
en.wikipedia.org/w/index.php?title=Kanpur&action=edit&section=7,,2,0,2,6e-06,31
en.wikipedia.org/w/index.php?title=Kanpur&action=edit&section=8,,2,0,2,6e-06,31
en.wikipedia.org/w/index.php?title=Kanpur&action=edit&section=9,,2,0,2,6e-06,31
en.wikipedia.org/wiki/Divisional_commissioner_(India),,2,0,2,6e-06,31
en.wikipedia.org/wiki/District_collector_(India),,2,0,2,6e-06,31
en.wikipedia.org/wiki/District_collector,,6,0,6,7e-06,31
en.wikipedia.org/wiki/Sub-Divisional_Magistrate,,4,0,4,6e-06,31
en.wikipedia.org/w/index.php?title=Kanpur&action=edit&section=10,,2,0,2,6e-06,31
en.wikipedia.org/wiki/File:Kanpur_Boat_Club_2.jpg,,2,0,2,6e-06,31
en.wikipedia.org/wiki/Kannur_Municipality,,2,0,2,6e-06,31
en.wikipedia.org/wiki/Municipal_Commissioner_(India),,3,0,3,6e-06,31
en.wikipedia.org/wiki/Health,,3,0,3,6e-06,31
en.wikipedia.org/w/index.php?title=Kanpur&action=edit&section=11,,2,0,2,6e-06,31
"en.wikipedia.org/wiki/Code_of_Criminal_Procedure,_1973",,2,0,2,6e-06,31
en.wikipedia.org/w/index.php?title=Kanpur&action=edit&section=12,,2,0,2,6e-06,31
en.wikipedia.org/wiki/Kanpur_Police,,2,0,2,6e-06,31
en.wikipedia.org/wiki/Provincial_Police_Service_(Uttar_Pradesh),,2,0,2,6e-06,31
en.wikipedia.org/w/index.php?title=Kanpur&action=edit&section=13,,2,0,2,6e-06,31
en.wikipedia.org/w/index.php?title=Kanpur&action=edit&section=14,,2,0,2,6e-06,31
en.wikipedia.org/wiki/Ward_(electoral_subdivision),,2,0,2,6e-06,31
en.wikipedia.org/wiki/Councillor,,2,0,2,6e-06,31
en.wikipedia.org/wiki/Jagatvir_Singh_Drona,,3,0,3,6e-06,31
en.wikipedia.org/w/index.php?title=Kanpur&action=edit&section=15,,2,0,2,6e-06,31
en.wikipedia.org/wiki/Template:Harvard_citation_documentation,,2,0,2,6e-06,31
"en.wikipedia.org/wiki/Member_of_parliament,_Lok_Sabha",,3,0,3,6e-06,31
en.wikipedia.org/wiki/Satyadev_Pachauri,,4,0,4,6e-06,31
en.wikipedia.org/w/index.php?title=Kanpur&action=edit&section=16,,2,0,2,6e-06,31
en.wikipedia.org/wiki/Kanpur_Electricity_Supply_Company,,4,0,4,7e-06,31
en.wikipedia.org/w/index.php?title=Kanpur&action=edit&section=17,,2,0,2,6e-06,31
en.wikipedia.org/wiki/File:Kanpur_Central_Station.jpg,,2,0,2,6e-06,31
en.wikipedia.org/wiki/File:Kanpur_Airport_2.jpg,,4,0,4,6e-06,31
en.wikipedia.org/w/index.php?title=Kanpur&action=edit&section=18,,2,0,2,6e-06,31
en.wikipedia.org/wiki/File:Kanpur_Airport_3.jpg,,4,0,4,6e-06,31
en.wikipedia.org/w/index.php?title=Kanpur&action=edit&section=19,,2,0,2,6e-06,31
en.wikipedia.org/wiki/Allahabad_railway_division,,3,0,3,6e-06,31
en.wikipedia.org/wiki/North_Central_Railway_zone,,14,0,14,7e-06,31
en.wikipedia.org/wiki/North_Central_Railway,,9,0,9,7e-06,31
en.wikipedia.org/wiki/North_Eastern_Railway_Zone,,2,0,2,6e-06,31
en.wikipedia.org/wiki/Mandhana_Junction_railway_station,,10,0,10,7e-06,31
en.wikipedia.org/wiki/Brahmavart_railway_station,,8,0,8,7e-06,31
en.wikipedia.org/wiki/Panki_Dham_railway_station,,2,0,2,6e-06,31
en.wikipedia.org/wiki/Kanpur_Bridge_Left_Bank_railway_station,,10,0,10,7e-06,31
en.wikipedia.org/wiki/Northern_Railway_zone,,12,0,12,7e-06,31
en.wikipedia.org/w/index.php?title=Kanpur&action=edit&section=20,,2,0,2,6e-06,31
en.wikipedia.org/wiki/Mohania,,3,0,3,6e-06,31
en.wikipedia.org/wiki/Aurangabad,,3,0,3,6e-06,31
en.wikipedia.org/wiki/Palsit,,3,0,3,6e-06,31
en.wikipedia.org/wiki/Asansol,,8,0,8,7e-06,31
en.wikipedia.org/wiki/Porbandar,,2,0,2,6e-06,31
en.wikipedia.org/wiki/Shivpuri,,3,0,3,6e-06,31
en.wikipedia.org/wiki/Alipurduar,,2,0,2,6e-06,31
en.wikipedia.org/wiki/Gangotri_Dham,,2,0,2,6e-06,31
en.wikipedia.org/wiki/Bijnore,,2,0,2,6e-06,31
"en.wikipedia.org/wiki/Hamirpur,_Uttar_Pradesh",,2,0,2,6e-06,31
en.wikipedia.org/wiki/Mahoba,,4,0,4,6e-06,31
en.wikipedia.org/wiki/Chhatarpur,,2,0,2,6e-06,31
en.wikipedia.org/wiki/Lakhnadon,,2,0,2,6e-06,31
"en.wikipedia.org/wiki/Sultanpur,_Uttar_Pradesh",,3,0,3,6e-06,31
en.wikipedia.org/wiki/Shahganj,,2,0,2,6e-06,31
en.wikipedia.org/wiki/Azamgarh,,3,0,3,6e-06,31
en.wikipedia.org/wiki/Gaura_Barhaj,,2,0,2,6e-06,31
"en.wikipedia.org/wiki/Siwan,_Bihar",,3,0,3,6e-06,31
en.wikipedia.org/wiki/Awadh_Expressway,,2,0,2,6e-06,31
en.wikipedia.org/wiki/Mainpuri,,9,0,9,7e-06,31
en.wikipedia.org/wiki/Bulandshahr,,6,0,6,7e-06,31
en.wikipedia.org/wiki/Hapur,,2,0,2,6e-06,31
en.wikipedia.org/wiki/Ganga_Expressway,,4,0,4,6e-06,31
en.wikipedia.org/wiki/Ballia,,4,0,4,6e-06,31
"en.wikipedia.org/wiki/Outer_Ring_Road,_Kanpur",,2,0,2,6e-06,31
en.wikipedia.org/wiki/Uttar_Pradesh_State_Road_Transport_Corporation,,11,0,11,7e-06,31
en.wikipedia.org/w/index.php?title=Kanpur&action=edit&section=21,,2,0,2,6e-06,31
en.wikipedia.org/w/index.php?title=Kanpur&action=edit&section=,,2,0,2,6e-06,31
en.wikipedia.org/w/index.php?title=Kanpur&action=edit&section=22,,2,0,2,6e-06,31
en.wikipedia.org/w/index.php?title=Kanpur&action=edit&section=23,,2,0,2,6e-06,31
en.wikipedia.org/w/index.php?title=Axis_Institute_of_Technology_And_Management&action=edit&redlink=1,,2,0,2,6e-06,31
en.wikipedia.org/w/index.php?title=Kanpur&action=edit&section=24,,2,0,2,6e-06,31
en.wikipedia.org/w/index.php?title=Kanpur&action=edit&section=25,,2,0,2,6e-06,31
en.wikipedia.org/wiki/Lala_Kamlapat_Singhania,,3,0,3,7e-06,31
en.wikipedia.org/wiki/Padampat_Singhania,,3,0,3,7e-06,31
en.wikipedia.org/wiki/Giriraj_Kishore_(writer),,2,0,2,6e-06,31
en.wikipedia.org/wiki/Irshad_Mirza,,3,0,3,7e-06,31
en.wikipedia.org/wiki/Gaurav_Khanna,,2,0,2,6e-06,31
en.wikipedia.org/wiki/Rajeev_Shukla,,2,0,2,6e-06,31
en.wikipedia.org/wiki/Kamal_Nath,,2,0,2,6e-06,31
en.wikipedia.org/wiki/Tanmay_Srivastava,,2,0,2,6e-06,31
en.wikipedia.org/w/index.php?title=Kanpur&action=edit&section=26,,2,0,2,6e-06,31
en.wikipedia.org/wiki/Akbarpur_Lok_Sabha_constituency,,15,0,15,7e-06,31
en.wikipedia.org/wiki/List_of_cities_in_Uttar_Pradesh,,4,0,4,6e-06,31
en.wikipedia.org/wiki/List_of_renamed_Indian_public_places,,2,0,2,6e-06,31
en.wikipedia.org/wiki/List_of_twin_towns_and_sister_cities_in_India,,3,0,3,6e-06,31
en.wikipedia.org/wiki/Largest_Indian_cities_by_GDP,,2,0,2,6e-06,31
en.wikipedia.org/w/index.php?title=Kanpur&action=edit&section=27,,2,0,2,6e-06,31
iloveindia.com/travel/kanpur/index.html,,2,0,2,6e-06,31
web.archive.org/web/20121122112235/http://www.iloveindia.com/travel/kanpur/index.html,,2,0,2,6e-06,31
facts-about-india.com/nick-name-indian-places.php,,2,0,2,6e-06,31
web.archive.org/web/20120221230304/http://www.facts-about-india.com/nick-name-indian-places.php,,2,0,2,6e-06,31
census2011.co.in/census/city/131-kanpur.html,,2,0,2,6e-06,31
web.archive.org/web/20170525141614/http://nclm.nic.in/shared/linkimages/NCLM52ndReport.pdf,,5,0,5,7e-06,31
nclm.nic.in/shared/linkimages/NCLM52ndReport.pdf,,6,0,6,7e-06,31
updes.up.nic.in/updes/data/sdiaryenglish/files/diary%20eng%202021_merged.pdf,,3,0,3,6e-06,31
updes.up.nic.in/esd/Book/DDP2020-21(T)MARCH22%20%20new%20web.pdf,,3,0,3,6e-06,31
ssca.org.in/media/4_2016_HDI_t1hcMZm.pdf,,2,0,2,6e-06,31
search.worldcat.org/issn/2454-7395,,2,0,2,6e-06,31
web.archive.org/web/20180619103221/http://www.ssca.org.in/media/4_2016_HDI_t1hcMZm.pdf,,2,0,2,6e-06,31
ethnologue.com/language/awa,,2,0,2,6e-06,31
kanpurdehat.nic.in/about-district/,,2,0,2,6e-06,31
web.archive.org/web/20200718042102/http://www.klpl.in/aboutus.html,,2,0,2,6e-06,31
klpl.in/aboutus.html,,2,0,2,6e-06,31
ramblinginthecity.com/tag/kanpur/,,2,0,2,6e-06,31
transindiatravels.com/uttar-pradesh/kanpur/tourist-places-to-visit-in-kanpur/,,2,0,2,6e-06,31
journeymart.com/de/india/uttar-pradesh/kanpur-history.aspx,,2,0,2,6e-06,31
dspace.wbpublibnet.gov.in:8080/jspui/bitstream/10689/26681/8/Chapter%207_479-525p.pdf,,2,0,2,6e-06,31
kanpurnagar.nic.in/history/,,2,0,2,6e-06,31
archive.org/details/historicinciden00braigoog,,3,0,3,6e-06,31
archive.org/details/historicinciden00braigoog/page/n328,,3,0,3,6e-06,31
en.wikipedia.org/wiki/Special:BookSources/978-1-135-72312-5,,3,0,3,6e-06,31
en.wikipedia.org/wiki/Special:BookSources/978-81-230-0093-0,,2,0,2,6e-06,31
en.wikipedia.org/wiki/William_Dalrymple_(historian),,3,0,3,6e-06,31
fallingrain.com/world/IN/09/Kanpur.html,,2,0,2,6e-06,31
imdpune.gov.in/library/public/Climatological%20Tables%201991-2020.pdf,,3,0,3,6e-06,31
censusindia.gov.in/nada/index.php/catalog/11394/download/14507/DDW09C-01%20MDDS.XLS,,11,0,11,7e-06,31
kanpursmartcity.org/about-us,,2,0,2,6e-06,31
censusindia.gov.in/2011-prov-results/paper2/data_files/India2/Table_2_PR_Cities_1Lakh_and_Above.pdf,,3,0,3,6e-06,31
censusindia.gov.in/2011-prov-results/paper2/data_files/india2/Million_Plus_UAs_Cities_2011.pdf,,2,0,2,6e-06,31
censusindia.gov.in/nada/index.php/catalog/10235/download/13347/DDW-C16-TOWN-STMT-MDDS-0900.XLSX,,4,0,4,6e-06,31
uphome.gov.in/DM-UP-Contact.htm,,4,0,4,6e-06,31
en.wikipedia.org/wiki/Department_of_Home_(Uttar_Pradesh),,5,0,5,7e-06,31
web.archive.org/web/20170816061300/http://uphome.gov.in/DM-UP-Contact.htm,,3,0,3,6e-06,31
web.archive.org/web/20110210045547/http://niyuktionline.up.nic.in/DOCUMENTS/DMCFileCurrent.aspx,,3,0,3,6e-06,31
niyuktionline.up.nic.in/DOCUMENTS/DMCFileCurrent.aspx,,3,0,3,6e-06,31
kanpurnagar.nic.in/Admin.htm,,3,0,3,6e-06,31
web.archive.org/web/20170815045033/http://kanpurnagar.nic.in/Admin.htm,,2,0,2,6e-06,31
uppolice.gov.in/frmOfficials.aspx?zoneknp&cd=NgAxADIA,,2,0,2,6e-06,31
en.wikipedia.org/wiki/Uttar_Pradesh_Police,,13,0,13,7e-06,31
web.archive.org/web/20170817041339/https://uppolice.gov.in/frmOfficials.aspx?zoneknp&cd=NgAxADIA,,2,0,2,6e-06,31
uppolice.gov.in/frmOfficials.aspx?rangeknp&cd=NgAxADkA,,2,0,2,6e-06,31
web.archive.org/web/20170817042105/https://uppolice.gov.in/frmOfficials.aspx?rangeknp&cd=NgAxADkA,,2,0,2,6e-06,31
kdaindia.co.in/contact.aspx,,3,0,3,6e-06,31
web.archive.org/web/20170817034724/http://www.kdaindia.co.in/contact.aspx,,2,0,2,6e-06,31
niyuktionline.up.nic.in/ias/iaslist_posting.aspx?id1=MCMwIzQ0,,2,0,2,6e-06,31
kmc.up.nic.in/,,3,0,3,7e-06,31
web.archive.org/web/20120413165642/http://kmc.up.nic.in/,,2,0,2,6e-06,31
kmc.up.nic.in/Contacts.htm,,2,0,2,6e-06,31
web.archive.org/web/20170817035547/http://kmc.up.nic.in/Contacts.htm,,2,0,2,6e-06,31
web.archive.org/web/20110211210127/http://niyuktionline.up.nic.in/pcs/pcs_hod.aspx,,2,0,2,6e-06,31
niyuktionline.up.nic.in/pcs/pcs_hod.aspx,,2,0,2,6e-06,31
allahabadhighcourt.in/District/KanpurNagar.htm,,2,0,2,6e-06,31
web.archive.org/web/20170817122327/http://www.allahabadhighcourt.in/District/KanpurNagar.htm,,2,0,2,6e-06,31
web.archive.org/web/20150218194818/http://jnnurm.nic.in/wp-content/uploads/2010/12/CDP_Kanpur.pdf,,2,0,2,6e-06,31
jnnurm.nic.in/wp-content/uploads/2010/12/CDP_Kanpur.pdf,,2,0,2,6e-06,31
up.gov.in/upconstitution.aspx,,4,0,4,6e-06,31
web.archive.org/web/20170831000649/http://up.gov.in/upconstitution.aspx,,3,0,3,6e-06,31
en.wikipedia.org/wiki/Special:BookSources/978-8170993810,,5,0,5,6e-06,31
kanpurnagar.nic.in/WorkDistribution/WorkDistribution.htm,,2,0,2,6e-06,31
web.archive.org/web/20180213091756/http://kanpurnagar.nic.in/WorkDistribution/WorkDistribution.htm,,2,0,2,6e-06,31
shodhganga.inflibnet.ac.in/bitstream/10603/223280/10/10_chapter%204.pdf,,2,0,2,6e-06,31
censusindia.gov.in/2011census/dchb/DCHB.html,,2,0,2,6e-06,31
kdaindia.co.in/aboutkda.aspx,,3,0,3,6e-06,31
web.archive.org/web/20170809132436/http://www.kdaindia.co.in/aboutkda.aspx,,2,0,2,6e-06,31
kdaindia.co.in/en/contact.php,,2,0,2,6e-06,31
indiaenvironmentportal.org.in/files/CDP_Kanpur.pdf,,2,0,2,6e-06,31
uppolice.gov.in/frmOfficials.aspx?kanpurngr&cd=NgA2ADIA,,2,0,2,6e-06,31
web.archive.org/web/20170817042131/https://uppolice.gov.in/frmOfficials.aspx?kanpurngr&cd=NgA2ADIA,,2,0,2,6e-06,31
kmc.up.nic.in/mayor_corporators.htm,,2,0,2,6e-06,31
web.archive.org/web/20201225184506/https://ccs.in/sites/all/books/com_books/ward-power.pdf,,2,0,2,6e-06,31
ccs.in/sites/all/books/com_books/ward-power.pdf,,2,0,2,6e-06,31
kmc.up.nic.in/PDF_Files/Chapter%2013%20-%20Part1%20Institutional%20frame%20work.pdf,,2,0,2,6e-06,31
shodhganga.inflibnet.ac.in/bitstream/10603/45951/13/13_chapter%205.pdf,,2,0,2,6e-06,31
uptownplanning.gov.in/post/en/introduction-of-development-area-kanpur,,2,0,2,6e-06,31
newsclick.in/UP-state-power-employees-protest-against-privatisation-PuVVNL,,2,0,2,6e-06,31
upenergy.in/uppcl/en/page/agencies-under-the-administrative-control,,2,0,2,6e-06,31
web.archive.org/web/20200919045427/http://upfireservice.gov.in/upfire/,,2,0,2,6e-06,31
upfireservice.gov.in/upfire/,,2,0,2,6e-06,31
jalkalkanpur.in/AboutUs,,2,0,2,6e-06,31
"web.archive.org/web/20201025163004/http://jn.upsdc.gov.in/page/en/about-jal-nigam,-uttar-pradesh",,2,0,2,6e-06,31
"jn.upsdc.gov.in/page/en/about-jal-nigam,-uttar-pradesh",,2,0,2,6e-06,31
rcueslucknow.org/jnnurm/Kanpur/9%20Chapter%209%20Municipal%20Services.pdf,,2,0,2,6e-06,31
avenuemail.in/opinion/the-water-crisis-is-another-alarm-bell/152016/,,2,0,2,6e-06,31
projectstoday.com/News/Sewage-treatment-plant-worth-Rs-81625-cr-to-come-up-in-Kanpur,,2,0,2,6e-06,31
cdn.cseindia.org/userfiles/kanpur_municipal_corporation.pdf,,2,0,2,6e-06,31
downtoearth.org.in/coverage/a-miserable-place-to-live-10170,,2,0,2,6e-06,31
indianexpress.com/news/kanpur-to-get-outer-ring-road-to-bypass-traf/739887/,,2,0,2,6e-06,31
invest.up.gov.in/wp-content/uploads/2024/09/Kanpur_250924.pdf,,2,0,2,6e-06,31
updes.up.nic.in/esd/reports/dbank_march21/Diary%202020(English).pdf,,2,0,2,6e-06,31
csg.csail.mit.edu/Dahl/kiapbooklet.pdf,,7,0,7,7e-06,31
web.archive.org/web/20110812034015/http://csg.csail.mit.edu/Dahl/kiapbooklet.pdf,,2,0,2,6e-06,31
ugc.ac.in/privateuniversitylist.aspx?id=33&Unitype=3,,2,0,2,6e-06,31
web.archive.org/web/20170907080541/http://www.ugc.ac.in/privateuniversitylist.aspx?id=33&Unitype=3,,2,0,2,6e-06,31
en.wikipedia.org/w/index.php?title=Kanpur&action=edit&section=28,,2,0,2,6e-06,31
en.wikisource.org/wiki/1911_Encyclopædia_Britannica/Cawnpore,,2,0,2,6e-06,31
web.archive.org/web/20160303193735/http://kmc.up.nic.in/,,3,0,3,6e-06,31
en.wikipedia.org/wiki/Template:Million-plus_agglomerations_in_India,,3,0,3,6e-06,31
en.wikipedia.org/wiki/Template_talk:Million-plus_agglomerations_in_India,,3,0,3,6e-06,31
en.wikipedia.org/wiki/Special:EditPage/Template:Million-plus_agglomerations_in_India,,3,0,3,6e-06,31
en.wikipedia.org/wiki/Northern_Zonal_Council,,3,0,3,6e-06,31
en.wikipedia.org/wiki/Central_Zonal_Council,,3,0,3,6e-06,31
en.wikipedia.org/wiki/Eastern_Zonal_Council,,3,0,3,6e-06,31
en.wikipedia.org/wiki/Western_Zonal_Council,,3,0,3,6e-06,31
en.wikipedia.org/wiki/Vasai-Virar,,3,0,3,6e-06,31
en.wikipedia.org/wiki/Southern_Zonal_Council,,3,0,3,6e-06,31
en.wikipedia.org/wiki/Thrissur,,4,0,4,7e-06,31
en.wikipedia.org/wiki/Kannur,,5,0,5,7e-06,31
en.wikipedia.org/wiki/Kollam,,3,0,3,6e-06,31
en.wikipedia.org/wiki/Template:Uttar_Pradesh,,12,0,12,7e-06,31
en.wikipedia.org/wiki/Template_talk:Uttar_Pradesh,,12,0,12,7e-06,31
en.wikipedia.org/wiki/Special:EditPage/Template:Uttar_Pradesh,,12,0,12,7e-06,31
en.wikipedia.org/wiki/Category:Uttar_Pradesh,,12,0,12,7e-06,31
en.wikipedia.org/wiki/History_of_Uttar_Pradesh,,14,0,14,7e-06,31
en.wikipedia.org/wiki/Geography_of_Uttar_Pradesh,,12,0,12,7e-06,31
en.wikipedia.org/wiki/Culture_of_Uttar_Pradesh,,12,0,12,7e-06,31
en.wikipedia.org/wiki/Architecture_of_Uttar_Pradesh,,12,0,12,7e-06,31
en.wikipedia.org/wiki/Tourism_in_Uttar_Pradesh,,12,0,12,7e-06,31
en.wikipedia.org/wiki/Demographics_of_Uttar_Pradesh,,13,0,13,7e-06,31
en.wikipedia.org/wiki/Uttar_Pradesh_Legislative_Council,,12,0,12,7e-06,31
en.wikipedia.org/wiki/List_of_chief_ministers_of_Uttar_Pradesh,,12,0,12,7e-06,31
en.wikipedia.org/wiki/Emblem_of_Uttar_Pradesh,,12,0,12,7e-06,31
en.wikipedia.org/wiki/Purvanchal,,19,0,19,7e-06,31
en.wikipedia.org/wiki/Western_Uttar_Pradesh,,16,0,16,7e-06,31
en.wikipedia.org/wiki/Administrative_divisions_of_Uttar_Pradesh,,12,0,12,7e-06,31
en.wikipedia.org/wiki/Agra_division,,14,0,14,7e-06,31
en.wikipedia.org/wiki/Aligarh_division,,13,0,13,7e-06,31
en.wikipedia.org/wiki/Azamgarh_division,,13,0,13,7e-06,31
en.wikipedia.org/wiki/Bareilly_division,,16,0,16,7e-06,31
en.wikipedia.org/wiki/Basti_division,,13,0,13,7e-06,31
en.wikipedia.org/wiki/Chitrakoot_division,,13,0,13,7e-06,31
en.wikipedia.org/wiki/Devipatan_division,,13,0,13,7e-06,31
en.wikipedia.org/wiki/Moradabad_division,,13,0,13,7e-06,31
en.wikipedia.org/wiki/List_of_districts_of_Uttar_Pradesh,,12,0,12,7e-06,31
"en.wikipedia.org/wiki/Banda_district,_India",,12,0,12,7e-06,31
en.wikipedia.org/wiki/Budaun_district,,21,0,21,7e-06,31
en.wikipedia.org/wiki/Ghaziabad_district,,12,0,12,7e-06,31
en.wikipedia.org/wiki/List_of_cities_in_Uttar_Pradesh_by_population,,13,0,13,7e-06,31
en.wikipedia.org/wiki/Saharanpur,,18,0,18,7e-06,31
en.wikipedia.org/wiki/Vrindavan,,14,0,14,7e-06,31
en.wikipedia.org/wiki/Baghirua,,12,0,12,7e-06,31
en.wikipedia.org/wiki/Baliakheri,,12,0,12,7e-06,31
"en.wikipedia.org/wiki/Bhelupur,_Varanasi",,12,0,12,7e-06,31
en.wikipedia.org/wiki/Harora_Aht.,,12,0,12,7e-06,31
en.wikipedia.org/wiki/Harora_Must.,,12,0,12,7e-06,31
"en.wikipedia.org/wiki/Jafarabad,_Uttar_Pradesh",,12,0,12,7e-06,31
"en.wikipedia.org/wiki/Raghunathpur,_Uttar_Pradesh",,12,0,12,7e-06,31
en.wikipedia.org/wiki/Rajesultanpur,,13,0,13,7e-06,31
wikidata.org/wiki/Q66568,,2,0,2,6e-06,31
viaf.org/viaf/153615067,,2,0,2,6e-06,31
id.oclc.org/worldcat/entity/E39PBJjmTyM4bMd8TM9rwDW4bd,,2,0,2,6e-06,31
d-nb.info/gnd/4029504-7,,2,0,2,6e-06,31
id.loc.gov/authorities/n81066200,,2,0,2,6e-06,31
aleph.nkp.cz/F/?func=find-c&local_base=aut&ccl_term=ica=ge543061&CON_LNG=ENG,,2,0,2,6e-06,31
nli.org.il/en/authorities/987007564520605171,,2,0,2,6e-06,31
musicbrainz.org/area/9d9d2f21-a6b0-45e9-8de1-b2ad4586eb6b,,2,0,2,6e-06,31
islamansiklopedisi.org.tr/kanpur,,2,0,2,6e-06,31
lux.collections.yale.edu/view/place/491fda01-cfb7-422a-9fc3-6cf578950dc8,,2,0,2,6e-06,31
en.wikipedia.org/wiki/Category:Cities_in_Uttar_Pradesh,,6,0,6,7e-06,31
en.wikipedia.org/wiki/Category:Metropolitan_cities_in_India,,2,0,2,6e-06,31
en.wikipedia.org/wiki/Category:Smart_cities_in_India,,2,0,2,6e-06,31
en.wikipedia.org/wiki/Category:CS1_uses_Hindi-language_script_(hi),,6,0,6,7e-06,31
en.wikipedia.org/wiki/Category:Use_dmy_dates_from_June_2025,,5,0,5,6e-06,31
en.wikipedia.org/wiki/Category:Pages_using_infobox_settlement_with_possible_nickname_list,,2,0,2,6e-06,31
en.wikipedia.org/wiki/Category:Pages_using_infobox_settlement_with_unknown_parameters,,3,0,3,7e-06,31
en.wikipedia.org/wiki/Category:Pages_with_plain_IPA,,9,0,9,6e-06,31
en.wikipedia.org/wiki/Category:All_articles_with_broken_links_to_citations,,2,0,2,6e-06,31
en.wikipedia.org/wiki/Category:Articles_to_be_expanded_from_January_2024,,2,0,2,6e-06,31
en.wikipedia.org/wiki/Category:Articles_with_unsourced_statements_from_November_2024,,5,0,5,7e-06,31
en.m.wikipedia.org/w/index.php?title=Kanpur&mobileaction=toggle_view_mobile,,2,0,2,6e-06,31
upload.wikimedia.org/wikipedia/commons/thumb/9/9f/Kanpur_Airport_2.jpg/250px-Kanpur_Airport_2.jpg,,4,0,4,6e-06,31
upload.wikimedia.org/wikipedia/commons/thumb/f/f4/Kanpur_Airport_3.jpg/250px-Kanpur_Airport_3.jpg,,4,0,4,6e-06,31
upload.wikimedia.org/wikipedia/commons/thumb/7/76/Pfeil_oben.svg/20px-Pfeil_oben.svg.png,,11,0,11,7e-06,31
upload.wikimedia.org/wikipedia/commons/thumb/8/85/Pfeil_links.svg/20px-Pfeil_links.svg.png,,11,0,11,7e-06,31
upload.wikimedia.org/wikipedia/commons/thumb/c/c5/Pfeil_rechts.svg/20px-Pfeil_rechts.svg.png,,11,0,11,7e-06,31
upload.wikimedia.org/wikipedia/commons/thumb/c/c3/Pfeil_unten.svg/20px-Pfeil_unten.svg.png,,11,0,11,7e-06,31
en.wikipedia.org/wiki/National_Chambal_Sanctuary,,7,0,7,7e-06,31
en.wikipedia.org/w/index.php?title=Special:UserLogin&returnto=Kanpur+Nagar+Police+Commissionerate,,1,0,1,6e-06,31
wikidata.org/wiki/Special:EntityPage/Q107108496,,1,0,1,6e-06,31
en.wikipedia.org/wiki/Kanpur_Nagar_Police_Commissionerate,,1,0,1,6e-06,31
en.wikipedia.org/wiki/Talk:Kanpur_Nagar_Police_Commissionerate,,1,0,1,6e-06,31
en.wikipedia.org/w/index.php?title=Kanpur_Nagar_Police_Commissionerate&action=edit,,1,0,1,6e-06,31
en.wikipedia.org/w/index.php?title=Kanpur_Nagar_Police_Commissionerate&action=history,,1,0,1,6e-06,31
en.wikipedia.org/wiki/Special:WhatLinksHere/Kanpur_Nagar_Police_Commissionerate,,1,0,1,6e-06,31
en.wikipedia.org/wiki/Special:RecentChangesLinked/Kanpur_Nagar_Police_Commissionerate,,1,0,1,6e-06,31
en.wikipedia.org/w/index.php?title=Kanpur_Nagar_Police_Commissionerate&oldid=1239446845,,1,0,1,6e-06,31
en.wikipedia.org/w/index.php?title=Kanpur_Nagar_Police_Commissionerate&action=info,,1,0,1,6e-06,31
en.wikipedia.org/w/index.php?title=Kanpur_Nagar_Police_Commissionerate&printable=yes,,1,0,1,6e-06,31
en.wikipedia.org/wiki/Special:EditPage/Kanpur_Nagar_Police_Commissionerate,,1,0,1,6e-06,31
"google.com/search?as_eq=wikipedia&q=""Kanpur+Nagar+Police+Commissionerate""",,1,0,1,6e-06,31
"google.com/search?tbm=nws&q=""Kanpur+Nagar+Police+Commissionerate""+-wikipedia&tbs=ar:1",,1,0,1,6e-06,31
"google.com/search?&q=""Kanpur+Nagar+Police+Commissionerate""&tbs=bkt:s&tbm=bks",,1,0,1,6e-06,31
"google.com/search?tbs=bks:1&q=""Kanpur+Nagar+Police+Commissionerate""+-wikipedia",,1,0,1,6e-06,31
"scholar.google.com/scholar?q=""Kanpur+Nagar+Police+Commissionerate""",,1,0,1,6e-06,31
"jstor.org/action/doBasicSearch?Query=""Kanpur+Nagar+Police+Commissionerate""&acc=on&wc=on",,1,0,1,6e-06,31
en.wikipedia.org/wiki/File:Uttar_Pradesh_Logo.png,,1,0,1,6e-06,31
en.wikipedia.org/wiki/File:Uttar_Pradesh_Police_Flag.svg,,1,0,1,6e-06,31
en.wikipedia.org/wiki/Law_enforcement_agency,,1,0,1,6e-06,31
en.wikipedia.org/wiki/Commissioner_of_Police,,1,0,1,6e-06,31
en.wikipedia.org/wiki/Additional_director_general_of_police,,1,0,1,6e-06,31
en.wikipedia.org/w/index.php?title=Kanpur_Nagar_Police_Commissionerate&action=edit&section=1,,1,0,1,6e-06,31
en.wikipedia.org/wiki/Superintendent_of_police_(India),,2,0,2,6e-06,31
en.wikipedia.org/wiki/Additional_superintendent_of_police,,1,0,1,6e-06,31
en.wikipedia.org/wiki/Deputy_superintendent_of_police,,2,0,2,6e-06,31
en.wikipedia.org/w/index.php?title=Kanpur_Nagar_Police_Commissionerate&action=edit&section=2,,1,0,1,6e-06,31
en.wikipedia.org/w/index.php?title=Kanpur_Nagar_Police_Commissionerate&action=edit&section=3,,1,0,1,6e-06,31
en.wikipedia.org/w/index.php?title=Kanpur_Nagar_Police_Commissionerate&action=edit&section=4,,1,0,1,6e-06,31
en.wikipedia.org/wiki/Asim_Arun,,1,0,1,6e-06,31
en.wikipedia.org/w/index.php?title=Kanpur_Nagar_Police_Commissionerate&action=edit&section=5,,1,0,1,6e-06,31
en.wikipedia.org/wiki/Inspector_General_of_Police,,1,0,1,6e-06,31
en.wikipedia.org/wiki/Assistant_Commissioner_of_Police,,1,0,1,6e-06,31
en.wikipedia.org/wiki/Assistant_superintendent,,1,0,1,6e-06,31
en.wikipedia.org/w/index.php?title=Assistant_Radio_Officer&action=edit&redlink=1,,1,0,1,6e-06,31
en.wikipedia.org/wiki/Police_Inspector,,1,0,1,6e-06,31
en.wikipedia.org/wiki/Sub-Inspector,,1,0,1,6e-06,31
en.wikipedia.org/wiki/Head_Constable,,1,0,1,6e-06,31
en.wikipedia.org/wiki/Police_Constable,,1,0,1,6e-06,31
en.wikipedia.org/w/index.php?title=Kanpur_Nagar_Police_Commissionerate&action=edit&section=6,,1,0,1,6e-06,31
en.wikipedia.org/wiki/Bidhnu,,2,0,2,6e-06,31
en.wikipedia.org/w/index.php?title=Kanpur_Nagar_Police_Commissionerate&action=edit&section=7,,1,0,1,6e-06,31
en.wikipedia.org/wiki/Lucknow_City_Police,,1,0,1,6e-06,31
en.wikipedia.org/w/index.php?title=Kanpur_Nagar_Police_Commissionerate&action=edit&section=8,,1,0,1,6e-06,31
uppolice.gov.in/frmOfficials.aspx?commknp&cd=NAA1ADEANgA%3D,,1,0,1,6e-06,31
en.wikipedia.org/w/index.php?title=Kanpur_Nagar_Police_Commissionerate&action=edit&section=9,,1,0,1,6e-06,31
en.wikipedia.org/wiki/Template:Law_enforcement_in_India,,1,0,1,6e-06,31
en.wikipedia.org/wiki/Template_talk:Law_enforcement_in_India,,1,0,1,6e-06,31
en.wikipedia.org/wiki/Special:EditPage/Template:Law_enforcement_in_India,,1,0,1,6e-06,31
en.wikipedia.org/wiki/List_of_amendments_of_the_Constitution_of_India,,2,0,2,6e-06,31
en.wikipedia.org/wiki/Directive_Principles,,1,0,1,6e-06,31
en.wikipedia.org/wiki/Bharatiya_Sakshya_Adhiniyam,,1,0,1,6e-06,31
en.wikipedia.org/wiki/Capital_punishment_in_India,,1,0,1,6e-06,31
en.wikipedia.org/wiki/Cognisable_offence,,1,0,1,6e-06,31
en.wikipedia.org/wiki/Personal_law,,1,0,1,6e-06,31
en.wikipedia.org/wiki/Modern_Hindu_law,,1,0,1,6e-06,31
en.wikipedia.org/wiki/Christian_personal_law,,1,0,1,6e-06,31
en.wikipedia.org/wiki/Muslim_Personal_Law,,1,0,1,6e-06,31
en.wikipedia.org/wiki/Hindu_Personal_Law,,1,0,1,6e-06,31
en.wikipedia.org/wiki/History_of_Indian_law,,1,0,1,6e-06,31
en.wikipedia.org/wiki/List_of_sitting_judges_of_High_Courts_of_India,,1,0,1,6e-06,31
en.wikipedia.org/wiki/Chief_Judicial_Magistrate_Court,,1,0,1,6e-06,31
en.wikipedia.org/wiki/District_Munsiff_Court,,1,0,1,6e-06,31
en.wikipedia.org/wiki/Subordinate_judge,,1,0,1,6e-06,31
en.wikipedia.org/wiki/Judicial_activism_in_India,,1,0,1,6e-06,31
en.wikipedia.org/wiki/Department_of_Home_(Bihar),,1,0,1,6e-06,31
en.wikipedia.org/wiki/Department_of_Home_(Kerala),,1,0,1,6e-06,31
en.wikipedia.org/wiki/Ministry_of_Home_Affairs_Government_of_Maharashtra,,1,0,1,6e-06,31
"en.wikipedia.org/wiki/Department_of_Home,_Prohibition_and_Excise",,1,0,1,6e-06,31
en.wikipedia.org/wiki/Department_of_Home_and_Confidential,,2,0,2,6e-06,31
en.wikipedia.org/wiki/Department_of_Home_(West_Bengal),,1,0,1,6e-06,31
en.wikipedia.org/wiki/Indian_police_ranks,,1,0,1,6e-06,31
en.wikipedia.org/wiki/Commissioner_of_Police_(India),,1,0,1,6e-06,31
en.wikipedia.org/wiki/Director_general_of_police,,2,0,2,6e-06,31
en.wikipedia.org/wiki/List_of_cases_of_police_brutality_in_India,,1,0,1,6e-06,31
en.wikipedia.org/wiki/Police_Complaints_Authority_(India),,1,0,1,6e-06,31
en.wikipedia.org/wiki/Child_sexual_abuse_laws_in_India,,1,0,1,6e-06,31
en.wikipedia.org/wiki/Violence_against_women_in_India,,1,0,1,6e-06,31
en.wikipedia.org/wiki/Mass_surveillance_in_India,,1,0,1,6e-06,31
en.wikipedia.org/wiki/Rape_in_India,,1,0,1,6e-06,31
en.wikipedia.org/wiki/Suicide_in_India,,1,0,1,6e-06,31
en.wikipedia.org/wiki/Organised_crime_in_India,,1,0,1,6e-06,31
en.wikipedia.org/wiki/Drug_policy_of_India,,1,0,1,6e-06,31
en.wikipedia.org/wiki/Indian_black_money,,1,0,1,6e-06,31
en.wikipedia.org/wiki/Hawala,,1,0,1,6e-06,31
en.wikipedia.org/wiki/Terrorism_in_India,,2,0,2,6e-06,31
en.wikipedia.org/wiki/Legal_education_in_India,,2,0,2,6e-06,31
en.wikipedia.org/wiki/Template:Law_enforcement_agencies_of_India,,1,0,1,6e-06,31
en.wikipedia.org/wiki/Category:Kanpur_Nagar_district,,13,0,13,7e-06,31
en.wikipedia.org/wiki/Category:Metropolitan_law_enforcement_agencies_of_India,,1,0,1,6e-06,31
en.wikipedia.org/wiki/Category:Uttar_Pradesh_Police,,1,0,1,6e-06,31
en.wikipedia.org/wiki/Category:Government_agencies_established_in_2021,,1,0,1,6e-06,31
en.wikipedia.org/wiki/Category:Articles_needing_additional_references_from_June_2021,,4,0,4,7e-06,31
upload.wikimedia.org/wikipedia/commons/5/57/Uttar_Pradesh_Logo.png,,1,0,1,6e-06,31
en.wikipedia.org/w/index.php?title=Special:CreateAccount&returnto=Kanpur+Development+Authority,,1,0,1,6e-06,31
en.wikipedia.org/w/index.php?title=Special:UserLogin&returnto=Kanpur+Development+Authority,,1,0,1,6e-06,31
wikidata.org/wiki/Special:EntityPage/Q6364358,,1,0,1,6e-06,31
en.wikipedia.org/wiki/Talk:Kanpur_Development_Authority,,1,0,1,6e-06,31
en.wikipedia.org/w/index.php?title=Kanpur_Development_Authority&action=edit,,1,0,1,6e-06,31
en.wikipedia.org/w/index.php?title=Kanpur_Development_Authority&action=history,,1,0,1,6e-06,31
en.wikipedia.org/wiki/Special:WhatLinksHere/Kanpur_Development_Authority,,1,0,1,6e-06,31
en.wikipedia.org/wiki/Special:RecentChangesLinked/Kanpur_Development_Authority,,1,0,1,6e-06,31
en.wikipedia.org/w/index.php?title=Kanpur_Development_Authority&oldid=1304674947,,1,0,1,6e-06,31
en.wikipedia.org/w/index.php?title=Kanpur_Development_Authority&action=info,,1,0,1,6e-06,31
en.wikipedia.org/w/index.php?title=Kanpur_Development_Authority&printable=yes,,1,0,1,6e-06,31
en.wikipedia.org/wiki/Special:Map/10/18.520277777778/73.856666666667/en,,1,0,1,6e-06,31
en.wikipedia.org/wiki/Suresh_Pasi,,1,0,1,6e-06,31
en.wikipedia.org/wiki/Kinjal_Singh,,1,0,1,6e-06,31
kdaindia.co.in/,,1,0,1,6e-06,31
en.wikipedia.org/wiki/Development_agency,,1,0,1,6e-06,31
en.wikipedia.org/w/index.php?title=Kanpur_Development_Authority&action=edit&section=1,,1,0,1,6e-06,31
en.wikipedia.org/w/index.php?title=Kanpur_Development_Authority&action=edit&section=2,,1,0,1,6e-06,31
en.wikipedia.org/w/index.php?title=Kanpur_Development_Authority&action=edit&section=3,,1,0,1,6e-06,31
en.wikipedia.org/w/index.php?title=Kanpur_Development_Authority&action=edit&section=4,,1,0,1,6e-06,31
en.wikipedia.org/w/index.php?title=Kanpur_Development_Authority&action=edit&section=5,,1,0,1,6e-06,31
web.archive.org/web/20160530223040/http://uphome.gov.in/DM-UP-Contact.htm,,1,0,1,6e-06,31
web.archive.org/web/20150315075407/http://kanpurnagar.nic.in/Admin.htm,,1,0,1,6e-06,31
web.archive.org/web/20090327095154/http://www.kdaindia.co.in/aboutkda.aspx,,1,0,1,6e-06,31
web.archive.org/web/20160624023901/http://www.kdaindia.co.in/contact.aspx,,1,0,1,6e-06,31
upcmo.up.nic.in/cabinet_minister.htm,,1,0,1,6e-06,31
upcmo.up.nic.in/state_minister.htm,,1,0,1,6e-06,31
web.archive.org/web/20170305002931/http://townplanning.up.nic.in/manual-v.htm,,1,0,1,6e-06,31
townplanning.up.nic.in/manual-v.htm,,1,0,1,6e-06,31
en.wikipedia.org/w/index.php?title=Kanpur_Development_Authority&action=edit&section=6,,1,0,1,6e-06,31
kdaindia.org.in/,,1,0,1,6e-06,31
web.archive.org/web/20130721153713/http://kdaindia.org.in/,,1,0,1,6e-06,31
en.wikipedia.org/wiki/Category:Government_of_Kanpur,,1,0,1,6e-06,31
en.wikipedia.org/wiki/Category:Government_agencies_established_in_1955,,1,0,1,6e-06,31
en.wikipedia.org/wiki/Category:Urban_development_authorities_in_India,,1,0,1,6e-06,31
en.wikipedia.org/wiki/Category:State_agencies_of_Uttar_Pradesh,,2,0,2,7e-06,31
en.wikipedia.org/wiki/Category:1955_establishments_in_Uttar_Pradesh,,2,0,2,7e-06,31
en.wikipedia.org/wiki/Category:Organisations_based_in_Kanpur,,1,0,1,6e-06,31
en.m.wikipedia.org/w/index.php?title=Kanpur_Development_Authority&mobileaction=toggle_view_mobile,,1,0,1,6e-06,31
en.wikipedia.org/w/index.php?title=Special:CreateAccount&returnto=Kanpur+Central+railway+station,,1,0,1,6e-06,31
en.wikipedia.org/w/index.php?title=Special:UserLogin&returnto=Kanpur+Central+railway+station,,1,0,1,6e-06,31
bn.wikipedia.org/wiki/কানপুর_সেন্ট্রাল_জংশন_রেলওয়ে_স্টেশন,,1,0,1,6e-06,31
cs.wikipedia.org/wiki/Kanpur_Central,,1,0,1,6e-06,31
es.wikipedia.org/wiki/Estación_Central_de_Kanpur,,1,0,1,6e-06,31
hi.wikipedia.org/wiki/कानपुर_सेंट्रल_रेलवे_स्टेशन,,1,0,1,6e-06,31
kn.wikipedia.org/wiki/ಕಾನ್ಪುರ_ಸೆಂಟ್ರಲ್_ರೈಲು_ನಿಲ್ದಾಣ,,1,0,1,6e-06,31
mr.wikipedia.org/wiki/कानपूर_सेंट्रल_रेल्वे_स्थानक,,1,0,1,6e-06,31
pa.wikipedia.org/wiki/ਕਾਨਪੁਰ_ਸੈਂਟਰਲ_ਰੇਲਵੇ_ਸਟੇਸ਼ਨ,,1,0,1,6e-06,31
pl.wikipedia.org/wiki/Kanpur_Central,,1,0,1,6e-06,31
sat.wikipedia.org/wiki/ᱠᱟᱱᱯᱩᱨ_ᱥᱮᱱᱴᱨᱟᱞ_ᱨᱮᱞᱣᱮ_ᱥᱴᱮᱥᱚᱱ,,1,0,1,6e-06,31
ta.wikipedia.org/wiki/கான்பூர்_மத்தியத்_தொடருந்து_நிலையம்,,1,0,1,6e-06,31
ur.wikipedia.org/wiki/کانپور_سنٹرل_ریلوے_اسٹیشن,,1,0,1,6e-06,31
wikidata.org/wiki/Special:EntityPage/Q3633977,,1,0,1,6e-06,31
en.wikipedia.org/wiki/Talk:Kanpur_Central_railway_station,,1,0,1,6e-06,31
en.wikipedia.org/w/index.php?title=Kanpur_Central_railway_station&action=edit,,1,0,1,6e-06,31
en.wikipedia.org/w/index.php?title=Kanpur_Central_railway_station&action=history,,1,0,1,6e-06,31
en.wikipedia.org/wiki/Special:WhatLinksHere/Kanpur_Central_railway_station,,1,0,1,6e-06,31
en.wikipedia.org/wiki/Special:RecentChangesLinked/Kanpur_Central_railway_station,,1,0,1,6e-06,31
en.wikipedia.org/w/index.php?title=Kanpur_Central_railway_station&oldid=1304341440,,1,0,1,6e-06,31
en.wikipedia.org/w/index.php?title=Kanpur_Central_railway_station&action=info,,1,0,1,6e-06,31
en.wikipedia.org/w/index.php?title=Kanpur_Central_railway_station&printable=yes,,1,0,1,6e-06,31
commons.wikimedia.org/wiki/Category:Kanpur_Central_railway_station,,1,0,1,6e-06,31
en.wikipedia.org/wiki/Special:EditPage/Kanpur_Central_railway_station,,1,0,1,6e-06,31
"google.com/search?as_eq=wikipedia&q=""Kanpur+Central+railway+station""",,1,0,1,6e-06,31
"google.com/search?tbm=nws&q=""Kanpur+Central+railway+station""+-wikipedia&tbs=ar:1",,1,0,1,6e-06,31
"google.com/search?&q=""Kanpur+Central+railway+station""&tbs=bkt:s&tbm=bks",,1,0,1,6e-06,31
"google.com/search?tbs=bks:1&q=""Kanpur+Central+railway+station""+-wikipedia",,1,0,1,6e-06,31
"scholar.google.com/scholar?q=""Kanpur+Central+railway+station""",,1,0,1,6e-06,31
"jstor.org/action/doBasicSearch?Query=""Kanpur+Central+railway+station""&acc=on&wc=on",,1,0,1,6e-06,31
en.wikipedia.org/wiki/File:Indian_Railways_Suburban_Railway_Logo.svg,,7,0,7,7e-06,31
en.wikipedia.org/wiki/File:Kanpur-Central-Railway-Station-Uttar-Pradesh-India.jpg,,1,0,1,6e-06,31
en.wikipedia.org/wiki/Howrah-Gaya-Delhi_line,,2,0,2,6e-06,31
en.wikipedia.org/wiki/Howrah-Delhi_main_line,,2,0,2,6e-06,31
en.wikipedia.org/wiki/Pandit_Deen_Dayal_Upadhyaya_Junction_–_Kanpur_section,,2,0,2,6e-06,31
en.wikipedia.org/wiki/Intersection_(road),,4,0,4,7e-06,31
en.wikipedia.org/wiki/Parking,,1,0,1,6e-06,31
en.wikipedia.org/wiki/Indo-Saracenic_architecture,,1,0,1,6e-06,31
en.wikipedia.org/wiki/Prayagraj_railway_division,,6,0,6,7e-06,31
en.wikipedia.org/wiki/Howrah_station,,1,0,1,6e-06,31
en.wikipedia.org/wiki/New_Delhi_railway_station,,7,0,7,7e-06,31
en.wikipedia.org/wiki/Northern_Railways,,4,0,4,7e-06,31
en.wikipedia.org/wiki/File:Feature_ticket_office.svg,,2,0,2,6e-06,31
en.wikipedia.org/wiki/File:Baggage_claim_ecomo.svg,,1,0,1,6e-06,31
en.wikipedia.org/wiki/File:Feature_parking.svg,,2,0,2,6e-06,31
en.wikipedia.org/wiki/File:Feature_accessible.svg,,1,0,1,6e-06,31
en.wikipedia.org/wiki/File:SymbolCoffeeShop.svg,,2,0,2,6e-06,31
en.wikipedia.org/wiki/File:AB-Autobahnkiosk.svg,,1,0,1,6e-06,31
en.wikipedia.org/wiki/File:Aseos_Públicos.jpg,,1,0,1,6e-06,31
en.wikipedia.org/wiki/File:Aiga_taxi.svg,,1,0,1,6e-06,31
en.wikipedia.org/wiki/File:Feature_suburban_buses.svg,,2,0,2,6e-06,31
en.wikipedia.org/wiki/Special:Map/14/26.45424/80.350966/en,,1,0,1,6e-06,31
en.wikipedia.org/wiki/Howrah_railway_station,,2,0,2,6e-06,31
en.wikipedia.org/wiki/Intercity_rail,,1,0,1,6e-06,31
en.wikipedia.org/w/index.php?title=Kanpur_Central_railway_station&action=edit&section=1,,1,0,1,6e-06,31
en.wikipedia.org/wiki/Mamata_Banerjee,,1,0,1,6e-06,31
en.wikipedia.org/w/index.php?title=Kanpur_Central_railway_station&action=edit&section=2,,1,0,1,6e-06,31
en.wikipedia.org/w/index.php?title=Kanpur_Central_railway_station&action=edit&section=3,,1,0,1,6e-06,31
en.wikipedia.org/wiki/Shram_Shakti_Express,,1,0,1,6e-06,31
en.wikipedia.org/wiki/Kanpur–New_Delhi_Shatabdi_Express,,2,0,2,6e-06,31
en.wikipedia.org/wiki/Kanpur_Central–Anand_Vihar_Terminal_Express,,1,0,1,6e-06,31
en.wikipedia.org/wiki/Kanpur_Central–Bandra_Terminus_Weekly_Express,,1,0,1,6e-06,31
en.wikipedia.org/wiki/Kanpur_Central–Kathgodam_Garib_Rath_Express,,1,0,1,6e-06,31
en.wikipedia.org/wiki/Prayag_Ghat–Kanpur_Intercity_Express,,1,0,1,6e-06,31
en.wikipedia.org/wiki/Unnao_Junction_railway_station,,8,0,8,7e-06,31
en.wikipedia.org/wiki/Unchahar_Junction_railway_station,,1,0,1,6e-06,31
en.wikipedia.org/wiki/Pratapgarh–Kanpur_Intercity_Express,,1,0,1,6e-06,31
en.wikipedia.org/wiki/Chitrakootdham_(Karwi)–Kanpur_Intercity_Express,,1,0,1,6e-06,31
en.wikipedia.org/wiki/Bhiwani_Junction_railway_station,,1,0,1,6e-06,31
en.wikipedia.org/wiki/Kalindi_Express,,1,0,1,6e-06,31
en.wikipedia.org/wiki/Udyog_Karmi_Express,,1,0,1,6e-06,31
en.wikipedia.org/wiki/Kanpur_Central–Jammu_Tawi_Superfast_Express,,1,0,1,6e-06,31
en.wikipedia.org/wiki/Kanpur_Central–Amritsar_Weekly_Express,,1,0,1,6e-06,31
en.wikipedia.org/wiki/Durg_Junction_railway_station,,1,0,1,6e-06,31
en.wikipedia.org/wiki/Betwa_Express,,1,0,1,6e-06,31
en.wikipedia.org/wiki/Rae_Bareli_Junction_railway_station,,6,0,6,7e-06,31
en.wikipedia.org/w/index.php?title=Kanpur_Central_railway_station&action=edit&section=4,,1,0,1,6e-06,31
"en.wikipedia.org/wiki/Electric_Loco_Shed,_Kanpur",,2,0,2,6e-06,31
en.wikipedia.org/wiki/WAP-4,,1,0,1,6e-06,31
en.wikipedia.org/wiki/WAP-7,,1,0,1,6e-06,31
en.wikipedia.org/wiki/Indian_locomotive_class_WAG-7,,1,0,1,6e-06,31
en.wikipedia.org/wiki/WAG-9,,1,0,1,6e-06,31
en.wikipedia.org/w/index.php?title=Kanpur_Central_railway_station&action=edit&section=5,,1,0,1,6e-06,31
en.wikipedia.org/wiki/Cawnpore–Burhwal_Railway,,4,0,4,6e-06,31
en.wikipedia.org/wiki/Cawnpore–Barabanki_Railway,,4,0,4,6e-06,31
en.wikipedia.org/wiki/Chitrakootdham_(Karwi)–Kanpur_Intercity_Express_(via_Allahabad),,1,0,1,6e-06,31
en.wikipedia.org/w/index.php?title=Kanpur_Central_railway_station&action=edit&section=6,,1,0,1,6e-06,31
indiaheritagewalks.org/blog/indian-railways-heritage-buildings-indo-saracenic-architecture-specimens,,1,0,1,6e-06,31
indianrailways.gov.in/Railway_station_zone-category_wise_list.pdf,,1,0,1,6e-06,31
irfca.org/faq/faq-elec.html,,2,0,2,6e-06,31
timesofindia.indiatimes.com/city/kanpur/Making-Kanpur-Central-world-class/articleshow/6885062.cms,,1,0,1,6e-06,31
en.wikipedia.org/w/index.php?title=Kanpur_Central_railway_station&action=edit&section=7,,1,0,1,6e-06,31
etrain.info/in?STATION=CNB,,1,0,1,6e-06,31
en.wikipedia.org/wiki/Template:Railway_stations_in_Uttar_Pradesh,,6,0,6,7e-06,31
en.wikipedia.org/wiki/Template_talk:Railway_stations_in_Uttar_Pradesh,,6,0,6,7e-06,31
en.wikipedia.org/wiki/Special:EditPage/Template:Railway_stations_in_Uttar_Pradesh,,6,0,6,7e-06,31
en.wikipedia.org/wiki/Train_station,,8,0,8,7e-06,31
en.wikipedia.org/wiki/East_Central_Railway_zone,,7,0,7,7e-06,31
en.wikipedia.org/wiki/Dhanbad_railway_division,,7,0,7,7e-06,31
en.wikipedia.org/wiki/Chopan_railway_station,,6,0,6,7e-06,31
en.wikipedia.org/wiki/Obra_Dam_railway_station,,6,0,6,7e-06,31
en.wikipedia.org/wiki/Renukoot_railway_station,,6,0,6,7e-06,31
en.wikipedia.org/wiki/Shaktinagar_Terminal_railway_station,,6,0,6,7e-06,31
en.wikipedia.org/wiki/Danapur_railway_division,,7,0,7,7e-06,31
en.wikipedia.org/wiki/Dildarnagar_Junction_railway_station,,6,0,6,7e-06,31
en.wikipedia.org/wiki/Pandit_Deen_Dayal_Upadhyaya_railway_division,,7,0,7,7e-06,31
en.wikipedia.org/wiki/Chandauli_Majhwar_railway_station,,6,0,6,7e-06,31
en.wikipedia.org/wiki/Pandit_Deen_Dayal_Upadhyaya_Junction_railway_station,,6,0,6,7e-06,31
en.wikipedia.org/wiki/Ambala_railway_division,,6,0,6,7e-06,31
en.wikipedia.org/wiki/Saharanpur_Junction_railway_station,,6,0,6,7e-06,31
en.wikipedia.org/wiki/Delhi_railway_division,,6,0,6,7e-06,31
en.wikipedia.org/wiki/Baghpat_Road_railway_station,,8,0,8,7e-06,31
en.wikipedia.org/wiki/Ghaziabad_Junction_railway_station,,8,0,8,7e-06,31
en.wikipedia.org/wiki/Khatauli_railway_station,,6,0,6,7e-06,31
en.wikipedia.org/wiki/Meerut_City_railway_station,,8,0,8,7e-06,31
en.wikipedia.org/wiki/Meerut_Cantt_railway_station,,8,0,8,7e-06,31
en.wikipedia.org/wiki/Modinagar_railway_station,,8,0,8,7e-06,31
en.wikipedia.org/wiki/Muzaffarnagar_railway_station,,6,0,6,7e-06,31
en.wikipedia.org/wiki/New_Ghaziabad_railway_station,,8,0,8,7e-06,31
en.wikipedia.org/wiki/Sahibabad_Junction_railway_station,,6,0,6,7e-06,31
en.wikipedia.org/wiki/Tapri_Junction_railway_station,,6,0,6,7e-06,31
en.wikipedia.org/wiki/Lucknow_NR_railway_division,,6,0,6,7e-06,31
en.wikipedia.org/wiki/Acharya_Narendra_Dev_Nagar_railway_station,,6,0,6,7e-06,31
en.wikipedia.org/wiki/Akbarganj_railway_station,,6,0,6,7e-06,31
en.wikipedia.org/wiki/Akbarpur_Junction_railway_station,,6,0,6,7e-06,31
en.wikipedia.org/wiki/Amausi_railway_station,,12,0,12,7e-06,31
en.wikipedia.org/wiki/Amethi_railway_station,,6,0,6,7e-06,31
en.wikipedia.org/wiki/Ayodhya_Junction_railway_station,,6,0,6,7e-06,31
en.wikipedia.org/wiki/Faizabad_Junction_railway_station,,6,0,6,7e-06,31
en.wikipedia.org/wiki/Balrampur_railway_station,,6,0,6,7e-06,31
en.wikipedia.org/wiki/Barabanki_Junction_railway_station,,6,0,6,7e-06,31
en.wikipedia.org/wiki/Goshainganj_railway_station,,6,0,6,7e-06,31
en.wikipedia.org/wiki/Jarauna_railway_station,,6,0,6,7e-06,31
en.wikipedia.org/wiki/Jaunpur_City_railway_station,,6,0,6,7e-06,31
en.wikipedia.org/wiki/Jaunpur_Junction_railway_station,,6,0,6,7e-06,31
en.wikipedia.org/wiki/Lucknow_Charbagh_railway_station,,16,0,16,7e-06,31
en.wikipedia.org/wiki/Manak_Nagar_railway_station,,12,0,12,7e-06,31
en.wikipedia.org/wiki/Nihalgarh_railway_station,,6,0,6,7e-06,31
en.wikipedia.org/wiki/Pindra_Road_railway_station,,6,0,6,7e-06,31
en.wikipedia.org/wiki/Sultanpur_Junction_railway_station,,6,0,6,7e-06,31
en.wikipedia.org/wiki/Sri_Krishna_Nagar_railway_station,,6,0,6,7e-06,31
en.wikipedia.org/wiki/Zafarabad_Junction_railway_station,,6,0,6,7e-06,31
en.wikipedia.org/wiki/Moradabad_railway_division,,6,0,6,7e-06,31
en.wikipedia.org/wiki/Amroha_railway_station,,6,0,6,7e-06,31
en.wikipedia.org/wiki/Aonla_railway_station,,6,0,6,7e-06,31
en.wikipedia.org/wiki/Bareilly_Cantt_railway_station,,6,0,6,7e-06,31
en.wikipedia.org/wiki/Bareilly_City_railway_station,,6,0,6,7e-06,31
en.wikipedia.org/wiki/Bareilly_Junction_railway_station,,6,0,6,7e-06,31
en.wikipedia.org/wiki/Basharatganj_railway_station,,6,0,6,7e-06,31
en.wikipedia.org/wiki/Bhitaura_railway_station,,6,0,6,7e-06,31
en.wikipedia.org/wiki/Bijnor_railway_station,,6,0,6,7e-06,31
en.wikipedia.org/wiki/Bilaspur_Road_railway_station,,6,0,6,7e-06,31
en.wikipedia.org/wiki/Bilpur_railway_station,,6,0,6,7e-06,31
en.wikipedia.org/wiki/Chandausi_railway_station,,6,0,6,7e-06,31
en.wikipedia.org/wiki/Chodiala_railway_station,,6,0,6,7e-06,31
en.wikipedia.org/wiki/Clutterbuckganj_railway_station,,6,0,6,7e-06,31
en.wikipedia.org/wiki/Dhaneta_railway_station,,6,0,6,7e-06,31
en.wikipedia.org/wiki/Hapur_Junction_railway_station,,8,0,8,7e-06,31
en.wikipedia.org/wiki/Iqbalpur_railway_station,,6,0,6,7e-06,31
en.wikipedia.org/wiki/Kakori_railway_station,,6,0,6,7e-06,31
en.wikipedia.org/wiki/Moradabad_railway_station,,6,0,6,7e-06,31
en.wikipedia.org/wiki/Nagaria_Sadat_railway_station,,6,0,6,7e-06,31
en.wikipedia.org/wiki/Nisoi_railway_station,,6,0,6,7e-06,31
en.wikipedia.org/wiki/Parsa_Khera_railway_station,,6,0,6,7e-06,31
en.wikipedia.org/wiki/Pitambarpur_railway_station,,6,0,6,7e-06,31
en.wikipedia.org/wiki/Pt_Ram_Prasad_Bismil_railway_station,,6,0,6,7e-06,31
en.wikipedia.org/wiki/Rampur_Junction_railway_station,,6,0,6,7e-06,31
en.wikipedia.org/wiki/Rasuiya_railway_station,,6,0,6,7e-06,31
en.wikipedia.org/wiki/Reoti_Bahora_Khera_railway_station,,6,0,6,7e-06,31
en.wikipedia.org/wiki/Shahjahanpur_railway_station,,6,0,6,7e-06,31
en.wikipedia.org/wiki/Tisua_railway_station,,6,0,6,7e-06,31
en.wikipedia.org/wiki/Agra_railway_division,,6,0,6,7e-06,31
en.wikipedia.org/wiki/Agra_Cantonment_railway_station,,6,0,6,7e-06,31
en.wikipedia.org/wiki/Agra_City_railway_station,,6,0,6,7e-06,31
en.wikipedia.org/wiki/Agra_Fort_railway_station,,6,0,6,7e-06,31
en.wikipedia.org/wiki/Bhuteshwar_railway_station,,6,0,6,7e-06,31
en.wikipedia.org/wiki/Idgah_railway_station,,6,0,6,7e-06,31
en.wikipedia.org/wiki/Mathura_Cantt_railway_station,,6,0,6,7e-06,31
en.wikipedia.org/wiki/Raja_ki_Mandi_railway_station,,6,0,6,7e-06,31
en.wikipedia.org/wiki/Vrindavan_railway_station,,6,0,6,7e-06,31
en.wikipedia.org/wiki/Vrindaban_Road_railway_station,,6,0,6,7e-06,31
en.wikipedia.org/wiki/Yamuna_Bridge_railway_station,,6,0,6,7e-06,31
en.wikipedia.org/wiki/Aligarh_Junction_railway_station,,7,0,7,7e-06,31
en.wikipedia.org/wiki/Barhan_Junction_railway_station,,6,0,6,7e-06,31
en.wikipedia.org/wiki/Chunar_railway_station,,6,0,6,7e-06,31
en.wikipedia.org/wiki/Dadri_railway_station,,6,0,6,7e-06,31
en.wikipedia.org/wiki/Etah_railway_station,,6,0,6,7e-06,31
en.wikipedia.org/wiki/Fatehpur_railway_station,,6,0,6,7e-06,31
en.wikipedia.org/wiki/Firozabad_railway_station,,6,0,6,7e-06,31
en.wikipedia.org/wiki/Hathras_Junction_railway_station,,6,0,6,7e-06,31
en.wikipedia.org/wiki/Hathras_Kila_railway_station,,6,0,6,7e-06,31
en.wikipedia.org/wiki/Kanpur_railway_station,,7,0,7,7e-06,31
en.wikipedia.org/wiki/Khurja_Junction_railway_station,,6,0,6,7e-06,31
en.wikipedia.org/wiki/Mainpuri_railway_station,,6,0,6,7e-06,31
en.wikipedia.org/wiki/Manikpur_Junction_railway_station,,6,0,6,7e-06,31
en.wikipedia.org/wiki/Mirzapur_railway_station,,6,0,6,7e-06,31
en.wikipedia.org/wiki/Panki_railway_station,,8,0,8,7e-06,31
en.wikipedia.org/wiki/Prayag_Junction_railway_station,,6,0,6,7e-06,31
en.wikipedia.org/wiki/Prayagraj_Junction_railway_station,,6,0,6,7e-06,31
en.wikipedia.org/wiki/Prayagraj_Chheoki_Junction_railway_station,,6,0,6,7e-06,31
en.wikipedia.org/wiki/Prayagraj_Rambagh_railway_station,,6,0,6,7e-06,31
en.wikipedia.org/wiki/Shikohabad_railway_station,,7,0,7,7e-06,31
en.wikipedia.org/wiki/Subedarganj_railway_station,,6,0,6,7e-06,31
en.wikipedia.org/wiki/Saifai_railway_station,,7,0,7,7e-06,31
en.wikipedia.org/wiki/Tundla_Junction_railway_station,,8,0,8,7e-06,31
en.wikipedia.org/wiki/Jhansi_railway_division,,6,0,6,7e-06,31
en.wikipedia.org/wiki/Banda_railway_station,,6,0,6,7e-06,31
en.wikipedia.org/wiki/Chitrakutdham_Karwi_railway_station,,6,0,6,7e-06,31
en.wikipedia.org/wiki/Kulpahar_railway_station,,6,0,6,7e-06,31
en.wikipedia.org/wiki/Mahoba_Junction_railway_station,,6,0,6,7e-06,31
en.wikipedia.org/wiki/Jhansi_Junction_railway_station,,6,0,6,7e-06,31
en.wikipedia.org/wiki/North_Eastern_Railway_zone,,11,0,11,7e-06,31
en.wikipedia.org/wiki/Izzatnagar_railway_division,,7,0,7,7e-06,31
en.wikipedia.org/wiki/Baheri_railway_station,,6,0,6,7e-06,31
en.wikipedia.org/wiki/Bhojipura_Junction_railway_station,,6,0,6,7e-06,31
en.wikipedia.org/wiki/Bijauria_Junction_railway_station,,6,0,6,7e-06,31
en.wikipedia.org/wiki/Budaun_railway_station,,6,0,6,7e-06,31
en.wikipedia.org/wiki/Farrukhabad_Junction_railway_station,,7,0,7,7e-06,31
en.wikipedia.org/wiki/Fatehgarh_railway_station,,7,0,7,7e-06,31
en.wikipedia.org/wiki/Hathras_City_railway_station,,6,0,6,7e-06,31
en.wikipedia.org/wiki/Hathras_Road_railway_station,,6,0,6,7e-06,31
en.wikipedia.org/wiki/Kannauj_railway_station,,7,0,7,7e-06,31
en.wikipedia.org/wiki/Kannauj_City_railway_station,,7,0,7,7e-06,31
en.wikipedia.org/wiki/Kasganj_Junction_railway_station,,6,0,6,7e-06,31
en.wikipedia.org/wiki/Pilibhit_Junction_railway_station,,6,0,6,7e-06,31
en.wikipedia.org/wiki/Ramganga_railway_station,,6,0,6,7e-06,31
en.wikipedia.org/wiki/Sheikhupur_railway_station,,6,0,6,7e-06,31
en.wikipedia.org/wiki/Sikandra_Rao_railway_station,,6,0,6,7e-06,31
en.wikipedia.org/wiki/Soron_Shukar_Kshetra_railway_station,,6,0,6,7e-06,31
en.wikipedia.org/wiki/Tanakpur_railway_station,,6,0,6,7e-06,31
en.wikipedia.org/wiki/Ujhani_railway_station,,6,0,6,7e-06,31
en.wikipedia.org/wiki/Lucknow_NER_railway_division,,6,0,6,7e-06,31
en.wikipedia.org/wiki/Aishbagh_railway_station,,6,0,6,7e-06,31
en.wikipedia.org/wiki/Anand_Nagar_Junction_railway_station,,6,0,6,7e-06,31
en.wikipedia.org/wiki/Babhnan_railway_station,,6,0,6,7e-06,31
en.wikipedia.org/wiki/Badshahnagar_railway_station,,12,0,12,7e-06,31
en.wikipedia.org/wiki/Bahraich_railway_station,,6,0,6,7e-06,31
en.wikipedia.org/wiki/Barhni_railway_station,,6,0,6,7e-06,31
en.wikipedia.org/wiki/Basti_railway_station,,6,0,6,7e-06,31
en.wikipedia.org/wiki/Chauri_Chaura_railway_station,,6,0,6,7e-06,31
en.wikipedia.org/wiki/Daliganj_Junction_railway_station,,6,0,6,7e-06,31
en.wikipedia.org/wiki/Domingarh_railway_station,,6,0,6,7e-06,31
en.wikipedia.org/wiki/Dudhwa_railway_station,,6,0,6,7e-06,31
en.wikipedia.org/wiki/Gola_Gokarannath_railway_station,,6,0,6,7e-06,31
en.wikipedia.org/wiki/Gomti_Nagar_railway_station,,12,0,12,7e-06,31
en.wikipedia.org/wiki/Gonda_Junction_railway_station,,6,0,6,7e-06,31
en.wikipedia.org/wiki/Gorakhpur_Junction_railway_station,,7,0,7,7e-06,31
en.wikipedia.org/wiki/Jharkhandi_railway_station,,6,0,6,7e-06,31
en.wikipedia.org/wiki/Khalilabad_railway_station,,6,0,6,7e-06,31
en.wikipedia.org/wiki/Lucknow_Junction_railway_station,,12,0,12,7e-06,31
en.wikipedia.org/wiki/Lucknow_City_railway_station,,12,0,12,7e-06,31
en.wikipedia.org/wiki/Mailani_Junction_railway_station,,6,0,6,7e-06,31
en.wikipedia.org/wiki/Nautanwa_railway_station,,6,0,6,7e-06,31
en.wikipedia.org/wiki/Puranpur_railway_station,,6,0,6,7e-06,31
en.wikipedia.org/wiki/Siddharthnagar_railway_station,,6,0,6,7e-06,31
en.wikipedia.org/wiki/Sitapur_Junction_railway_station,,6,0,6,7e-06,31
en.wikipedia.org/wiki/Sitapur_City_Junction_railway_station,,6,0,6,7e-06,31
en.wikipedia.org/wiki/Sitapur_Cutchery_railway_station,,6,0,6,7e-06,31
en.wikipedia.org/wiki/Shohratgarh_railway_station,,6,0,6,7e-06,31
en.wikipedia.org/wiki/Tulsipur_railway_station,,6,0,6,7e-06,31
en.wikipedia.org/wiki/Varanasi_railway_division,,7,0,7,7e-06,31
en.wikipedia.org/wiki/Aunrihar_Junction_railway_station,,6,0,6,7e-06,31
en.wikipedia.org/wiki/Azamgarh_railway_station,,6,0,6,7e-06,31
en.wikipedia.org/wiki/Ballia_railway_station,,6,0,6,7e-06,31
en.wikipedia.org/wiki/Banaras_railway_station,,6,0,6,7e-06,31
en.wikipedia.org/wiki/Belthara_Road_railway_station,,6,0,6,7e-06,31
en.wikipedia.org/wiki/Deoria_Sadar_railway_station,,6,0,6,7e-06,31
en.wikipedia.org/wiki/Ghazipur_City_railway_station,,6,0,6,7e-06,31
en.wikipedia.org/wiki/Ghazipur_Ghat_railway_station,,6,0,6,7e-06,31
en.wikipedia.org/wiki/Gyanpur_Road_railway_station,,6,0,6,7e-06,31
en.wikipedia.org/wiki/Kachhwa_Road_railway_station,,6,0,6,7e-06,31
en.wikipedia.org/wiki/Kaptanganj_Junction_railway_station,,6,0,6,7e-06,31
en.wikipedia.org/wiki/Kerakat_railway_station,,6,0,6,7e-06,31
en.wikipedia.org/wiki/Mau_Junction_railway_station,,6,0,6,7e-06,31
en.wikipedia.org/wiki/Padrauna_railway_station,,6,0,6,7e-06,31
en.wikipedia.org/wiki/Phephna_Junction_railway_station,,6,0,6,7e-06,31
en.wikipedia.org/wiki/Tamkuhi_Road_railway_station,,6,0,6,7e-06,31
en.wikipedia.org/wiki/Vyasnagar_railway_station,,6,0,6,7e-06,31
en.wikipedia.org/wiki/Template:Delhi_%26_NCR_Metro_stations,,6,0,6,7e-06,31
en.wikipedia.org/wiki/Template:Urban_rail_transit_in_India,,5,0,5,7e-06,31
en.wikipedia.org/wiki/Template_talk:Urban_rail_transit_in_India,,5,0,5,7e-06,31
en.wikipedia.org/wiki/Special:EditPage/Template:Urban_rail_transit_in_India,,5,0,5,7e-06,31
en.wikipedia.org/wiki/Urban_rail_transit_in_India,,6,0,6,7e-06,31
en.wikipedia.org/wiki/Suburban_rail_in_India,,6,0,6,7e-06,31
en.wikipedia.org/wiki/Chennai_Suburban_Railway,,8,0,8,7e-06,31
en.wikipedia.org/wiki/Delhi–Meerut_Regional_Rapid_Transit_System,,6,0,6,7e-06,31
en.wikipedia.org/wiki/Kolkata_Suburban_Railway,,6,0,6,7e-06,31
en.wikipedia.org/wiki/Barabanki–Lucknow_Suburban_Railway,,13,0,13,7e-06,31
en.wikipedia.org/wiki/Mumbai_Suburban_Railway,,8,0,8,7e-06,31
en.wikipedia.org/wiki/Pune_Suburban_Railway,,6,0,6,7e-06,31
en.wikipedia.org/wiki/Bengaluru_Commuter_Rail,,6,0,6,7e-06,31
en.wikipedia.org/wiki/Ahmedabad_Suburban_Railway,,6,0,6,7e-06,31
en.wikipedia.org/wiki/Nagpur_broad-gauge_Metro,,5,0,5,7e-06,31
en.wikipedia.org/wiki/Delhi–Sonipat–Panipat_Regional_Rapid_Transit_System,,5,0,5,7e-06,31
en.wikipedia.org/wiki/Agra_Metro,,7,0,7,7e-06,31
en.wikipedia.org/wiki/Ahmedabad_Metro,,6,0,6,7e-06,31
en.wikipedia.org/wiki/Namma_Metro,,6,0,6,7e-06,31
en.wikipedia.org/wiki/Chennai_Metro,,7,0,7,7e-06,31
en.wikipedia.org/wiki/Chennai_Mass_Rapid_Transit_System,,8,0,8,7e-06,31
en.wikipedia.org/wiki/Indore_Metro,,5,0,5,7e-06,31
en.wikipedia.org/wiki/Jaipur_Metro,,5,0,5,7e-06,31
en.wikipedia.org/wiki/Kochi_Metro,,5,0,5,7e-06,31
en.wikipedia.org/wiki/Kolkata_Metro,,6,0,6,7e-06,31
en.wikipedia.org/wiki/Lucknow_Metro,,13,0,13,7e-06,31
en.wikipedia.org/wiki/Mumbai_Metro,,7,0,7,7e-06,31
en.wikipedia.org/wiki/Nagpur_Metro,,5,0,5,7e-06,31
en.wikipedia.org/wiki/Navi_Mumbai_Metro,,5,0,5,7e-06,31
en.wikipedia.org/wiki/Pune_Metro,,5,0,5,7e-06,31
en.wikipedia.org/wiki/Bhoj_Metro,,5,0,5,7e-06,31
en.wikipedia.org/wiki/Patna_Metro,,6,0,6,7e-06,31
en.wikipedia.org/wiki/Surat_Metro,,5,0,5,7e-06,31
en.wikipedia.org/wiki/Bhubaneswar_Metro,,5,0,5,7e-06,31
en.wikipedia.org/wiki/Meerut_Metro,,7,0,7,7e-06,31
en.wikipedia.org/wiki/Chandigarh_Metro,,5,0,5,7e-06,31
en.wikipedia.org/wiki/Coimbatore_Metro,,5,0,5,7e-06,31
en.wikipedia.org/wiki/Gorakhpur_Metro,,5,0,5,7e-06,31
en.wikipedia.org/wiki/Guwahati_Metro,,5,0,5,7e-06,31
en.wikipedia.org/wiki/Jabalpur_Metro,,5,0,5,7e-06,31
en.wikipedia.org/wiki/Ludhiana_Metro,,5,0,5,7e-06,31
en.wikipedia.org/wiki/Madurai_Metro,,5,0,5,7e-06,31
en.wikipedia.org/wiki/Thiruvananthapuram_Metro,,5,0,5,7e-06,31
en.wikipedia.org/wiki/Bareilly_Metro,,5,0,5,7e-06,31
en.wikipedia.org/wiki/Jammu_Metro,,5,0,5,7e-06,31
en.wikipedia.org/wiki/Ranchi_Metro,,5,0,5,7e-06,31
en.wikipedia.org/wiki/Srinagar_Metro,,5,0,5,7e-06,31
en.wikipedia.org/wiki/Thane_Metro,,5,0,5,7e-06,31
en.wikipedia.org/wiki/Trichy_Metro,,5,0,5,7e-06,31
en.wikipedia.org/wiki/Warangal_Metro,,6,0,6,7e-06,31
en.wikipedia.org/wiki/Monorail,,6,0,6,7e-06,31
en.wikipedia.org/wiki/Mumbai_Monorail,,7,0,7,7e-06,31
en.wikipedia.org/wiki/Aizawl_Monorail,,5,0,5,7e-06,31
en.wikipedia.org/wiki/Indore_Monorail,,5,0,5,7e-06,31
en.wikipedia.org/wiki/Patna_Monorail,,6,0,6,7e-06,31
en.wikipedia.org/wiki/Warangal_Monorail,,6,0,6,7e-06,31
en.wikipedia.org/wiki/Bengaluru_Monorail,,5,0,5,7e-06,31
en.wikipedia.org/wiki/Chennai_Monorail,,5,0,5,7e-06,31
en.wikipedia.org/wiki/Kolkata_Monorail,,6,0,6,7e-06,31
en.wikipedia.org/wiki/Pune_Monorail,,5,0,5,7e-06,31
en.wikipedia.org/wiki/Skybus_Metro,,5,0,5,7e-06,31
en.wikipedia.org/wiki/Metrolite,,5,0,5,7e-06,31
en.wikipedia.org/wiki/Greater_Nashik_Metro,,5,0,5,7e-06,31
en.wikipedia.org/wiki/Kolkata_Light_Rail_Transit,,5,0,5,7e-06,31
en.wikipedia.org/wiki/Kozhikode_Light_Metro,,5,0,5,7e-06,31
en.wikipedia.org/wiki/Allahabad_Metro,,5,0,5,7e-06,31
en.wikipedia.org/wiki/Uttarakhand_Metro,,7,0,7,7e-06,31
en.wikipedia.org/wiki/Chennai_Metrolite,,7,0,7,7e-06,31
en.wikipedia.org/wiki/Delhi_Metrolite,,5,0,5,7e-06,31
en.wikipedia.org/wiki/Trams_in_India,,5,0,5,7e-06,31
en.wikipedia.org/wiki/Kolkata_tram,,5,0,5,7e-06,31
en.wikipedia.org/wiki/Bhavnagar_tram,,5,0,5,7e-06,31
en.wikipedia.org/wiki/Chennai_tram,,5,0,5,7e-06,31
en.wikipedia.org/wiki/Delhi_tram,,5,0,5,7e-06,31
en.wikipedia.org/wiki/Kanpur_tram,,5,0,5,7e-06,31
en.wikipedia.org/wiki/Kochi_tram,,5,0,5,7e-06,31
en.wikipedia.org/wiki/Mumbai_tram,,5,0,5,7e-06,31
en.wikipedia.org/wiki/Nashik_tram,,5,0,5,7e-06,31
en.wikipedia.org/wiki/Patna_tram,,5,0,5,7e-06,31
en.wikipedia.org/wiki/Category:Railway_stations_in_India_opened_in_1930,,1,0,1,6e-06,31
en.wikipedia.org/wiki/Category:Railway_centrals_in_India,,1,0,1,6e-06,31
en.wikipedia.org/wiki/Category:Railway_stations_in_Kanpur,,4,0,4,7e-06,31
en.wikipedia.org/wiki/Category:Prayagraj_railway_division,,5,0,5,7e-06,31
en.wikipedia.org/wiki/Category:Use_Indian_English_from_March_2015,,6,0,6,7e-06,31
en.wikipedia.org/wiki/Category:Articles_needing_additional_references_from_January_2015,,1,0,1,6e-06,31
en.m.wikipedia.org/w/index.php?title=Kanpur_Central_railway_station&mobileaction=toggle_view_mobile,,1,0,1,6e-06,31
upload.wikimedia.org/wikipedia/commons/thumb/6/6b/BSicon_PARKING.svg/20px-BSicon_PARKING.svg.png,,1,0,1,6e-06,31
upload.wikimedia.org/wikipedia/commons/thumb/b/bb/Feature_parking.svg/20px-Feature_parking.svg.png,,2,0,2,6e-06,31
upload.wikimedia.org/wikipedia/commons/thumb/c/c6/SymbolCoffeeShop.svg/20px-SymbolCoffeeShop.svg.png,,2,0,2,6e-06,31
upload.wikimedia.org/wikipedia/commons/thumb/f/f4/AB-Autobahnkiosk.svg/20px-AB-Autobahnkiosk.svg.png,,1,0,1,6e-06,31
upload.wikimedia.org/wikipedia/commons/thumb/3/31/Aseos_Públicos.jpg/20px-Aseos_Públicos.jpg,,1,0,1,6e-06,31
upload.wikimedia.org/wikipedia/commons/thumb/4/40/Aiga_taxi.svg/20px-Aiga_taxi.svg.png,,1,0,1,6e-06,31
topuniversities.com/asia-university-rankings/2023,,1,0,1,1.2e-05,31
nirfindia.org/Rankings/2024/EngineeringRanking300.html,,4,0,4,7e-06,31
gktoday.in/iit-kanpur-develops-energy-efficient-system-to-transport-minerals/,,1,0,1,1.2e-05,31
commons.wikimedia.org/wiki/,,3,0,3,7e-06,31
ta.wikipedia.org/wiki/விக்கிப்பீடியா:File_Upload_Wizard,,2,0,2,7e-06,31
search.worldcat.org/search?q=n2:0971-8257,,1,0,1,1.2e-05,31
iks.iitk.ac.in/assets/index-Cohqbp5i.js,,1,0,1,9e-06,31
iks.iitk.ac.in/assets/index-DMjkk8X1.css,,1,0,1,9e-06,31
hi.wikipedia.org/wiki/विकिपीडिया:अपलोड,,2,0,2,7e-06,31
hi.wikipedia.org/wiki/विकिपीडिया:साधारण_अस्वीकरण,,2,0,2,7e-06,31
wikimediafoundation.org/es/,,2,0,2,7e-06,31
es.wikipedia.org/wiki/Wikipedia:Limitación_general_de_responsabilidad,,2,0,2,7e-06,31
en.wikipedia.org/wiki/Yadav,,3,0,3,7e-06,31
en.wikipedia.org/wiki/Namesake,,8,0,8,7e-06,31
en.wikipedia.org/wiki/Wikimedia_Commons,,3,0,3,7e-06,31
en.wikipedia.org/wiki/Wikipedia:Articles_with_a_single_source,,8,0,8,7e-06,31
en.wikipedia.org/wiki/Wikipedia:Image_use_policy,,4,0,4,7e-06,31
en.wikipedia.org/wiki/Wikipedia:Manual_of_Style/Layout,,4,0,4,7e-06,31
en.wikipedia.org/wiki/Wikipedia:Basic_copyediting,,3,0,3,6e-06,31
en.wikipedia.org/w/index.php?title=Special:CreateAccount&returnto=Wikipedia%3AFile+upload+wizard,,1,0,1,7e-06,31
en.wikipedia.org/w/index.php?title=Special:UserLogin&returnto=Wikipedia%3AFile+upload+wizard,,1,0,1,7e-06,31
ar.wikipedia.org/wiki/ويكيبيديا:معالج_رفع_الملفات,,1,0,1,7e-06,31
as.wikipedia.org/wiki/ৱিকিপিডিয়া:আপল’ড,,1,0,1,7e-06,31
az.wikipedia.org/wiki/Vikipediya:Yükləmə_sehrbazı,,1,0,1,7e-06,31
azb.wikipedia.org/wiki/ویکی‌پدیا:یوکله‌مه,,1,0,1,7e-06,31
zh-min-nan.wikipedia.org/wiki/Wikipedia:Chiūⁿ-bāng,,1,0,1,7e-06,31
bh.wikipedia.org/wiki/विकिपीडिया:फाइल_अपलोड,,1,0,1,7e-06,31
bs.wikipedia.org/wiki/Wikipedia:Vodič_za_slanje_slika,,1,0,1,7e-06,31
sn.wikipedia.org/wiki/Wikipedia:File_Upload_Wizard,,1,0,1,7e-06,31
co.wikipedia.org/wiki/Wikipedia:Par_incaricà_una_imagina,,1,0,1,7e-06,31
ary.wikipedia.org/wiki/ويكيپيديا:أپلودي_فيشي,,1,0,1,7e-06,31
el.wikipedia.org/wiki/Βοήθεια:Επιφόρτωση_αρχείου,,1,0,1,7e-06,31
eo.wikipedia.org/wiki/Helpo:Alŝuti_dosieron,,1,0,1,7e-06,31
fa.wikipedia.org/wiki/ویکی‌پدیا:بارگذاری,,1,0,1,7e-06,31
gag.wikipedia.org/wiki/Vikipediya:Ükle,,1,0,1,7e-06,31
gan.wikipedia.org/wiki/Wikipedia:Upload,,1,0,1,7e-06,31
haw.wikipedia.org/wiki/Wikipedia:File_Upload_Wizard,,1,0,1,7e-06,31
hr.wikipedia.org/wiki/Wikipedija:Upload,,1,0,1,7e-06,31
id.wikipedia.org/wiki/Wikipedia:Wisaya_pengunggahan_berkas,,1,0,1,7e-06,31
is.wikipedia.org/wiki/Wikipedia:Hlaða_inn_skrá,,1,0,1,7e-06,31
it.wikipedia.org/wiki/Aiuto:Carica_un_file,,1,0,1,7e-06,31
kk.wikipedia.org/wiki/Уикипедия:Жүктеу,,1,0,1,7e-06,31
lld.wikipedia.org/wiki/Wikipedia:Cëria_su_n_documënt,,1,0,1,7e-06,31
hu.wikipedia.org/wiki/Wikipédia:Kép_feltöltése_a_Commonsra,,1,0,1,7e-06,31
mk.wikipedia.org/wiki/Википедија:Подигни_податотека,,1,0,1,7e-06,31
mr.wikipedia.org/wiki/विकिपीडिया:संचिका_चढवा,,1,0,1,7e-06,31
mzn.wikipedia.org/wiki/ویکی‌پدیا:باربی‌یشتن,,1,0,1,7e-06,31
ms.wikipedia.org/wiki/Wikipedia:Muat_naik,,1,0,1,7e-06,31
my.wikipedia.org/wiki/ဝီကီပီးဒီးယား:ဖိုင်တင်ကူညီကိရိယာ,,1,0,1,7e-06,31
nl.wikipedia.org/wiki/Wikipedia:Upload,,1,0,1,7e-06,31
ne.wikipedia.org/wiki/विकिपिडिया:चित्र_उर्ध्वभरण,,1,0,1,7e-06,31
ja.wikipedia.org/wiki/Wikipedia:ファイルのアップロード,,1,0,1,7e-06,31
ce.wikipedia.org/wiki/Википеди:File_Upload_Wizard,,1,0,1,7e-06,31
uz.wikipedia.org/wiki/Vikipediya:Fayl_yuklash_ustaxonasi,,1,0,1,7e-06,31
ps.wikipedia.org/wiki/ويکيپېډيا:دوتنه_پورته_کول,,1,0,1,7e-06,31
pl.wikipedia.org/wiki/Wikipedia:Przesyłanie_plików,,1,0,1,7e-06,31
pt.wikipedia.org/wiki/Wikipédia:Carregar_ficheiro,,1,0,1,7e-06,31
kaa.wikipedia.org/wiki/Wikipedia:Fayl_júklew,,1,0,1,7e-06,31
ro.wikipedia.org/wiki/Wikipedia:Trimite_fișier,,1,0,1,7e-06,31
si.wikipedia.org/wiki/විකිපීඩියා:File_Upload_Wizard,,1,0,1,7e-06,31
sl.wikipedia.org/wiki/Wikipedija:Naloži_datoteko,,1,0,1,7e-06,31
so.wikipedia.org/wiki/Wikipedia:File_Upload_Wizard,,1,0,1,7e-06,31
ckb.wikipedia.org/wiki/ویکیپیدیا:بارکردن,,1,0,1,7e-06,31
sr.wikipedia.org/wiki/Википедија:Водич_за_отпремање,,1,0,1,7e-06,31
sh.wikipedia.org/wiki/Wikipedija:Vodič_za_slanje_slika,,1,0,1,7e-06,31
su.wikipedia.org/wiki/Wikipedia:Pangunjalan,,1,0,1,7e-06,31
tl.wikipedia.org/wiki/Wikipedia:Pagkakarga_(Pag-aupload),,1,0,1,7e-06,31
th.wikipedia.org/wiki/วิกิพีเดีย:อัปโหลด,,1,0,1,7e-06,31
tg.wikipedia.org/wiki/Википедиа:Боргузорӣ,,1,0,1,7e-06,31
tr.wikipedia.org/wiki/Vikipedi:Dosya_Yükleme_Sihirbazı,,1,0,1,7e-06,31
uk.wikipedia.org/wiki/Вікіпедія:Майстер_завантаження_файлів,,1,0,1,7e-06,31
ur.wikipedia.org/wiki/ویکیپیڈیا:ساحر_برائے_اپلوڈ_فائل,,1,0,1,7e-06,31
vi.wikipedia.org/wiki/Wikipedia:Trình_tải_lên_tập_tin,,1,0,1,7e-06,31
zh-yue.wikipedia.org/wiki/Wikipedia:上載,,1,0,1,7e-06,31
zh.wikipedia.org/wiki/Wikipedia:上传,,1,0,1,7e-06,31
zgh.wikipedia.org/wiki/ⵡⵉⴽⵉⴱⵉⴷⵢⴰ:ⵙⵙⴽⵛⵎ_ⴰⴼⴰⵢⵍⵓ,,1,0,1,7e-06,31
wikidata.org/wiki/Special:EntityPage/Q8989284,,1,0,1,7e-06,31
en.wikipedia.org/wiki/Wikipedia_talk:File_upload_wizard,,1,0,1,7e-06,31
en.wikipedia.org/w/index.php?title=Wikipedia:File_upload_wizard&action=edit,,1,0,1,7e-06,31
en.wikipedia.org/w/index.php?title=Wikipedia:File_upload_wizard&action=history,,1,0,1,7e-06,31
en.wikipedia.org/wiki/Special:WhatLinksHere/Wikipedia:File_upload_wizard,,1,0,1,7e-06,31
en.wikipedia.org/wiki/Special:RecentChangesLinked/Wikipedia:File_upload_wizard,,1,0,1,7e-06,31
en.wikipedia.org/w/index.php?title=Wikipedia:File_upload_wizard&oldid=1306648226,,1,0,1,7e-06,31
en.wikipedia.org/w/index.php?title=Wikipedia:File_upload_wizard&action=info,,1,0,1,7e-06,31
en.wikipedia.org/w/index.php?title=Wikipedia:File_upload_wizard&printable=yes,,1,0,1,7e-06,31
commons.wikimedia.org/wiki/Commons:Upload,,1,0,1,7e-06,31
en.wikiversity.org/wiki/Wikiversity:Upload,,1,0,1,7e-06,31
en.wikipedia.org/wiki/Wikipedia:FUW,,1,0,1,7e-06,31
en.wikipedia.org/wiki/Wikipedia:Wikimedia_Commons,,1,0,1,7e-06,31
en.wikipedia.org/wiki/Special:Upload,,1,0,1,7e-06,31
en.wikipedia.org/wiki/Wikipedia:AUTOCONFIRM,,1,0,1,7e-06,31
en.wikipedia.org/wiki/Wikipedia:Files_for_upload,,1,0,1,7e-06,31
en.wikipedia.org/wiki/Wikipedia:Requests_for_permissions/Confirmed,,2,0,2,7e-06,31
en.wikipedia.org/wiki/File:Example.jpg,,1,0,1,7e-06,31
en.wikipedia.org/wiki/Wikipedia:Cheatsheet,,1,0,1,7e-06,31
en.wikipedia.org/wiki/Public_Domain,,1,0,1,7e-06,31
en.wikipedia.org/wiki/Uruguay_Round_Agreements_Act,,1,0,1,7e-06,31
copyright.cornell.edu/resources/publicdomain.cfm,,1,0,1,7e-06,31
en.wikipedia.org/wiki/Copyright_status_of_work_by_U.S._subnational_governments,,1,0,1,7e-06,31
en.wikipedia.org/wiki/Wikipedia:NFC,,1,0,1,7e-06,31
en.wikipedia.org/wiki/Wikipedia:NFCC,,1,0,1,7e-06,31
en.wikipedia.org/wiki/Example,,1,0,1,7e-06,31
en.wikipedia.org/wiki/Wikipedia:SUL,,1,0,1,7e-06,31
commons.wikimedia.org/wiki/Special:UserLogin,,1,0,1,7e-06,31
en.wikipedia.org/wiki/Template:Keep_local,,1,0,1,7e-06,31
en.wikipedia.org/wiki/Wikipedia:Media_copyright_questions,,2,0,2,7e-06,31
en.wikipedia.org/wiki/Wikipedia:Picture_tutorial,,1,0,1,7e-06,31
commons.wikimedia.org/wiki/Special:Upload,,1,0,1,7e-06,31
en.wikipedia.org/wiki/Wikipedia:Upload/old,,1,0,1,7e-06,31
en.wikipedia.org/wiki/Wikipedia:File_upload_wizard/doc,,1,0,1,7e-06,31
en.wikipedia.org/wiki/MediaWiki:FileUploadWizard.js,,1,0,1,7e-06,31
en.m.wikipedia.org/w/index.php?title=Wikipedia:File_upload_wizard&mobileaction=toggle_view_mobile,,1,0,1,7e-06,31
upload.wikimedia.org/wikipedia/en/thumb/a/a9/Example.jpg/250px-Example.jpg,,1,0,1,7e-06,31
upload.wikimedia.org/wikipedia/commons/thumb/b/b4/Gtk-dialog-info.svg/40px-Gtk-dialog-info.svg.png,,1,0,1,7e-06,31
upload.wikimedia.org/wikipedia/commons/thumb/b/b4/Gtk-dialog-info.svg/20px-Gtk-dialog-info.svg.png,,1,0,1,7e-06,31
upload.wikimedia.org/wikipedia/commons/thumb/b/b7/Gtk-ok.svg/20px-Gtk-ok.svg.png,,1,0,1,7e-06,31
upload.wikimedia.org/wikipedia/en/a/a9/Example.jpg,,1,0,1,7e-06,31
en.wikipedia.org/w/index.php?title=Special:CreateAccount&returnto=Wikipedia%3AContact+us,,1,0,1,7e-06,31
en.wikipedia.org/w/index.php?title=Special:UserLogin&returnto=Wikipedia%3AContact+us,,1,0,1,7e-06,31
als.wikipedia.org/wiki/Wikipedia:Kontakt,,1,0,1,7e-06,31
anp.wikipedia.org/wiki/विकिपीडिया:संपर्क_करौ,,1,0,1,7e-06,31
az.wikipedia.org/wiki/Vikipediya:Bizimlə_əlaqə,,1,0,1,7e-06,31
azb.wikipedia.org/wiki/ویکی‌پدیا:بیزیم‌له_ایرتیباط,,1,0,1,7e-06,31
bn.wikipedia.org/wiki/উইকিপিডিয়া:আমাদের_সাথে_যোগাযোগ,,1,0,1,7e-06,31
bjn.wikipedia.org/wiki/Wikipidia:Hubungi_kami,,1,0,1,7e-06,31
zh-min-nan.wikipedia.org/wiki/Wikipedia:Liân-lo̍k,,1,0,1,7e-06,31
map-bms.wikipedia.org/wiki/Wikipedia:Hubungi_kami,,1,0,1,7e-06,31
bh.wikipedia.org/wiki/विकिपीडिया:संपर्क,,1,0,1,7e-06,31
bg.wikipedia.org/wiki/Уикипедия:За_контакти,,1,0,1,7e-06,31
ca.wikipedia.org/wiki/Viquipèdia:Contacte,,1,0,1,7e-06,31
cs.wikipedia.org/wiki/Wikipedie:Kontakt,,1,0,1,7e-06,31
cy.wikipedia.org/wiki/Wicipedia:Cysylltwch_â_ni,,1,0,1,7e-06,31
da.wikipedia.org/wiki/Hjælp:Kontakt_Wikipedia,,1,0,1,7e-06,31
ary.wikipedia.org/wiki/ويكيپيديا:تاصل_بينا,,1,0,1,7e-06,31
se.wikipedia.org/wiki/Wikipedia:Váldde_oktavuođa,,1,0,1,7e-06,31
et.wikipedia.org/wiki/Vikipeedia:Kontakteeru_meiega,,1,0,1,7e-06,31
el.wikipedia.org/wiki/Βικιπαίδεια:Επικοινωνία,,1,0,1,7e-06,31
es.wikipedia.org/wiki/Wikipedia:Contacto,,1,0,1,7e-06,31
eo.wikipedia.org/wiki/Vikipedio:Kontaktoj,,1,0,1,7e-06,31
fa.wikipedia.org/wiki/ویکی‌پدیا:تماس_با_ما,,1,0,1,7e-06,31
ko.wikipedia.org/wiki/위키백과:연락처,,1,0,1,7e-06,31
hi.wikipedia.org/wiki/विकिपीडिया:हमें_सम्पर्क_करें,,1,0,1,7e-06,31
hr.wikipedia.org/wiki/Wikipedija:Kontaktirajte_nas,,1,0,1,7e-06,31
id.wikipedia.org/wiki/Wikipedia:Hubungi_kami,,1,0,1,7e-06,31
he.wikipedia.org/wiki/ויקיפדיה:יצירת_קשר,,1,0,1,7e-06,31
jv.wikipedia.org/wiki/Wikipédia:Sesambungan,,1,0,1,7e-06,31
ka.wikipedia.org/wiki/თარგი:მოგვწერეთ,,1,0,1,7e-06,31
ky.wikipedia.org/wiki/Википедия:Байланыш,,1,0,1,7e-06,31
lv.wikipedia.org/wiki/Vikipēdija:Kontakti,,1,0,1,7e-06,31
lb.wikipedia.org/wiki/Wikipedia:Kontakt,,1,0,1,7e-06,31
hu.wikipedia.org/wiki/Wikipédia:Kapcsolatfelvétel,,1,0,1,7e-06,31
mt.wikipedia.org/wiki/Wikipedija:Kuntatt,,1,0,1,7e-06,31
ms.wikipedia.org/wiki/Wikipedia:Hubungi_kami,,1,0,1,7e-06,31
my.wikipedia.org/wiki/ဝီကီပီးဒီးယား:ဆက်သွယ်ရန်,,1,0,1,7e-06,31
nl.wikipedia.org/wiki/Help:Contact_met_Wikipedia,,1,0,1,7e-06,31
ja.wikipedia.org/wiki/Wikipedia:連絡先,,1,0,1,7e-06,31
nn.wikipedia.org/wiki/Wikipedia:Kontakt,,1,0,1,7e-06,31
oc.wikipedia.org/wiki/Wikipèdia:Contacte,,1,0,1,7e-06,31
or.wikipedia.org/wiki/ଉଇକିପିଡ଼ିଆ:ଆମ_ସହ_ଯୋଗାଯୋଗ,,1,0,1,7e-06,31
uz.wikipedia.org/wiki/Vikipediya:Aloqa,,1,0,1,7e-06,31
ps.wikipedia.org/wiki/ويکيپېډيا:له_موږ_سره_اړيکه,,1,0,1,7e-06,31
nds.wikipedia.org/wiki/Wikipedia:Kuntakt,,1,0,1,7e-06,31
pl.wikipedia.org/wiki/Wikipedia:Kontakt_z_wikipedystami,,1,0,1,7e-06,31
ro.wikipedia.org/wiki/Wikipedia:Contact,,1,0,1,7e-06,31
rue.wikipedia.org/wiki/Вікіпедія:Контакт,,1,0,1,7e-06,31
ru.wikipedia.org/wiki/Википедия:Контакты,,1,0,1,7e-06,31
sco.wikipedia.org/wiki/Wikipedia:Contact_us,,1,0,1,7e-06,31
sq.wikipedia.org/wiki/Wikipedia:Na_kontakto,,1,0,1,7e-06,31
si.wikipedia.org/wiki/විකිපීඩියා:Contact_us,,1,0,1,7e-06,31
simple.wikipedia.org/wiki/Wikipedia:Contact_us,,1,0,1,7e-06,31
sd.wikipedia.org/wiki/وڪيپيڊيا:اسان_سان_رابطو_ڪريو,,1,0,1,7e-06,31
sk.wikipedia.org/wiki/Wikipédia:Kontakt,,1,0,1,7e-06,31
sl.wikipedia.org/wiki/Wikipedija:Stik_z_nami,,1,0,1,7e-06,31
ckb.wikipedia.org/wiki/ویکیپیدیا:پەیوەندی,,1,0,1,7e-06,31
sr.wikipedia.org/wiki/Википедија:Контакт,,1,0,1,7e-06,31
sh.wikipedia.org/wiki/Wikipedija:Kontakt,,1,0,1,7e-06,31
su.wikipedia.org/wiki/Wikipédia:Taros_kami,,1,0,1,7e-06,31
fi.wikipedia.org/wiki/Wikipedia:Yhteystiedot,,1,0,1,7e-06,31
sv.wikipedia.org/wiki/Wikipedia:Kontakt,,1,0,1,7e-06,31
tt.wikipedia.org/wiki/Википедия:Контактлар,,1,0,1,7e-06,31
th.wikipedia.org/wiki/วิกิพีเดีย:ติดต่อ,,1,0,1,7e-06,31
tg.wikipedia.org/wiki/Википедиа:Тамос_бо_мо,,1,0,1,7e-06,31
tr.wikipedia.org/wiki/Vikipedi:Bize_ulaşın,,1,0,1,7e-06,31
uk.wikipedia.org/wiki/Вікіпедія:Зворотний_зв%27язок,,1,0,1,7e-06,31
vec.wikipedia.org/wiki/Wikipedia:Contati,,1,0,1,7e-06,31
vi.wikipedia.org/wiki/Wikipedia:Liên_lạc,,1,0,1,7e-06,31
yi.wikipedia.org/wiki/װיקיפּעדיע:קאנטאקט_אונדז,,1,0,1,7e-06,31
zh-yue.wikipedia.org/wiki/Wikipedia:聯絡我哋,,1,0,1,7e-06,31
zh.wikipedia.org/wiki/Wikipedia:联络我们,,1,0,1,7e-06,31
wikidata.org/wiki/Special:EntityPage/Q4654783,,1,0,1,7e-06,31
en.wikipedia.org/wiki/Wikipedia_talk:Contact_us,,1,0,1,7e-06,31
en.wikipedia.org/w/index.php?title=Wikipedia:Contact_us&action=edit,,1,0,1,7e-06,31
en.wikipedia.org/w/index.php?title=Wikipedia:Contact_us&action=history,,1,0,1,7e-06,31
en.wikipedia.org/wiki/Special:WhatLinksHere/Wikipedia:Contact_us,,1,0,1,7e-06,31
en.wikipedia.org/wiki/Special:RecentChangesLinked/Wikipedia:Contact_us,,1,0,1,7e-06,31
en.wikipedia.org/w/index.php?title=Wikipedia:Contact_us&oldid=1298437408,,1,0,1,7e-06,31
en.wikipedia.org/w/index.php?title=Wikipedia:Contact_us&action=info,,1,0,1,7e-06,31
en.wikipedia.org/w/index.php?title=Wikipedia:Contact_us&printable=yes,,1,0,1,7e-06,31
meta.wikimedia.org/wiki/Answers,,1,0,1,7e-06,31
en.wikibooks.org/wiki/Wikibooks:Contact_us,,1,0,1,7e-06,31
en.wikinews.org/wiki/Wikinews:Contact_us,,1,0,1,7e-06,31
en.wikiquote.org/wiki/Wikiquote:Contact_us,,1,0,1,7e-06,31
en.wikiversity.org/wiki/Wikiversity:Contact,,1,0,1,7e-06,31
en.wikivoyage.org/wiki/Wikivoyage:Contact_us,,1,0,1,7e-06,31
en.wiktionary.org/wiki/Wiktionary:Contact_us,,1,0,1,7e-06,31
en.wikipedia.org/wiki/Wikipedia:Contact_us/Readers,,1,0,1,7e-06,31
en.wikipedia.org/wiki/Wikipedia:Contact_us/Article_subjects,,1,0,1,7e-06,31
en.wikipedia.org/wiki/Wikipedia:Contact_us/Licensing,,1,0,1,7e-06,31
en.wikipedia.org/wiki/Wikipedia:Contact_us/Donors,,1,0,1,7e-06,31
en.wikipedia.org/wiki/Wikipedia:Contact_us/Press_and_partnerships,,1,0,1,7e-06,31
en.wikipedia.org/wiki/Wikipedia:Main,,1,0,1,7e-06,31
en.wikipedia.org/wiki/File:Contactus-wmcolors.svg,,1,0,1,7e-06,31
en.wikipedia.org/wiki/Jimmy_Wales,,4,0,4,7e-06,31
en.wikipedia.org/wiki/Wikipedia:Dispute_resolution,,2,0,2,7e-06,31
en.wikipedia.org/wiki/Category:Wikipedia_tutorials,,1,0,1,7e-06,31
en.m.wikipedia.org/w/index.php?title=Wikipedia:Contact_us&mobileaction=toggle_view_mobile,,1,0,1,7e-06,31
upload.wikimedia.org/wikipedia/commons/thumb/8/88/At_sign.svg/20px-At_sign.svg.png,,1,0,1,7e-06,31
en.wikipedia.org/wiki/Wikipedia:Featured_articles,,3,0,3,7e-06,31
en.wikipedia.org/wiki/Help:Transclusion,,5,0,5,7e-06,31
en.wikipedia.org/wiki/Wikipedia:Content_assessment,,6,0,6,7e-06,31
en.wikipedia.org/wiki/Wikipedia:Peer_review,,2,0,2,7e-06,31
en.wikipedia.org/wiki/Help:Collapsing_tables_and_more,,29,0,29,8e-06,31
en.wikipedia.org/wiki/Wikipedia:Navigation_template,,28,0,28,8e-06,31
en.wikipedia.org/wiki/Special:NewPages,,2,0,2,7e-06,31
en.wikipedia.org/wiki/Rohilla,,2,0,2,6e-06,31
en.wikipedia.org/wiki/Rampur_State,,2,0,2,6e-06,31
en.wikipedia.org/wiki/Kingdom_of_Nepal,,2,0,2,6e-06,31
en.wikipedia.org/wiki/Killed_in_action,,2,0,2,6e-06,31
en.wikipedia.org/wiki/Tatya_Tope,,7,0,7,7e-06,31
en.wikipedia.org/wiki/Begum_Hazrat_Mahal,,8,0,8,7e-06,31
"en.wikipedia.org/wiki/Charles_Canning,_1st_Earl_Canning",,3,0,3,6e-06,31
"en.wikipedia.org/wiki/Colin_Campbell,_1st_Baron_Clyde",,4,0,4,7e-06,31
"en.wikipedia.org/wiki/Sir_James_Outram,_1st_Baronet",,4,0,4,6e-06,31
en.wikipedia.org/wiki/Henry_Montgomery_Lawrence,,3,0,3,6e-06,31
en.wikipedia.org/wiki/Template:Campaignbox_Indian_Rebellion_of_1857,,3,0,3,6e-06,31
en.wikipedia.org/wiki/Template_talk:Campaignbox_Indian_Rebellion_of_1857,,3,0,3,6e-06,31
en.wikipedia.org/wiki/Special:EditPage/Template:Campaignbox_Indian_Rebellion_of_1857,,3,0,3,6e-06,31
en.wikipedia.org/wiki/Meerut_mutiny,,3,0,3,6e-06,31
en.wikipedia.org/w/index.php?title=Allahabad_Mutiny&action=edit&redlink=1,,3,0,3,6e-06,31
sv.wikipedia.org/wiki/Myteriet_i_Allahabad,,3,0,3,6e-06,31
en.wikipedia.org/w/index.php?title=Jhansi_Mutiny&action=edit&redlink=1,,3,0,3,6e-06,31
sv.wikipedia.org/wiki/Myteriet_i_Jhansi,,3,0,3,6e-06,31
en.wikipedia.org/wiki/Siege_of_Lucknow,,6,0,6,7e-06,31
en.wikipedia.org/wiki/Battle_of_Badli-ki-Serai,,3,0,3,6e-06,31
en.wikipedia.org/wiki/Siege_of_Delhi,,3,0,3,6e-06,31
en.wikipedia.org/wiki/Battle_of_Chinhat,,3,0,3,6e-06,31
en.wikipedia.org/wiki/Battle_of_Jhelum_(1857),,3,0,3,6e-06,31
en.wikipedia.org/wiki/Battle_of_Aong,,3,0,3,6e-06,31
en.wikipedia.org/wiki/Battle_of_Agra,,3,0,3,6e-06,31
en.wikipedia.org/wiki/Battle_of_Najafgarh,,3,0,3,6e-06,31
en.wikipedia.org/wiki/Capture_of_Lucknow,,3,0,3,6e-06,31
en.wikipedia.org/wiki/Central_Indian_campaign_of_1858,,3,0,3,6e-06,31
en.wikipedia.org/wiki/Siege_of_Jhansi,,3,0,3,6e-06,31
en.wikipedia.org/wiki/Muzaffarnagar,,3,0,3,6e-06,31
en.wikipedia.org/wiki/Punjab_Province_(British_India),,4,0,4,6e-06,31
en.wikipedia.org/wiki/Mangal_Pandey,,3,0,3,6e-06,31
"en.wikipedia.org/wiki/File:Cawnpore_Memorial,_1860.jpg",,3,0,3,6e-06,31
en.wikipedia.org/wiki/Samuel_Bourne,,4,0,4,6e-06,31
en.wikipedia.org/wiki/Hugh_Wheeler_(British_Army_Officer),,2,0,2,6e-06,31
en.wikipedia.org/wiki/Bibighar_massacre,,3,0,3,6e-06,31
en.wikipedia.org/wiki/Mowbray_Thomson,,3,0,3,7e-06,31
en.wikipedia.org/wiki/File:1857_hospital_wheeler_cawnpore2.jpg,,2,0,2,6e-06,31
"en.wikipedia.org/wiki/File:Slaughter_Ghat,_Cawnpore.jpg",,3,0,3,6e-06,31
en.wikipedia.org/wiki/File:1858_Kanpur_well_monument.jpg,,3,0,3,6e-06,31
"en.wikipedia.org/wiki/File:Outside_of_well,_Cawnpore.jpg",,3,0,3,6e-06,31
"en.wikipedia.org/wiki/Fatehpur,_Uttar_Pradesh",,6,0,6,7e-06,31
en.wikipedia.org/wiki/Blowing_from_a_gun,,2,0,2,6e-06,31
en.wikipedia.org/wiki/Alambagh,,7,0,7,7e-06,31
en.wikipedia.org/wiki/Jhansi_Fort,,3,0,3,7e-06,31
en.wikipedia.org/wiki/Bundelkhand,,5,0,5,7e-06,31
en.wikipedia.org/wiki/Danapur,,3,0,3,6e-06,31
en.wikipedia.org/wiki/Arrah,,3,0,3,6e-06,31
en.wikipedia.org/wiki/Cantonment,,4,0,4,7e-06,31
en.wikipedia.org/wiki/George_MacDonald_Fraser,,2,0,2,6e-06,31
en.wikipedia.org/wiki/Flashman_in_the_Great_Game,,2,0,2,6e-06,31
books.google.com/books?id=OVqP54UEe4QC&pg=PA175,,2,0,2,6e-06,31
en.wikipedia.org/wiki/Special:BookSources/978-0-14-029045-5,,2,0,2,6e-06,31
en.wikipedia.org/wiki/Rudrangshu_Mukherjee,,2,0,2,6e-06,31
en.wikipedia.org/wiki/Christopher_Hibbert,,3,0,3,6e-06,31
doi.org/10.1093%2Fpast%2F142.1.169,,2,0,2,6e-06,31
jstor.org/stable/651200,,2,0,2,6e-06,31
doi.org/10.1093%2Fpast%2F128.1.92,,2,0,2,6e-06,31
jstor.org/stable/651010,,2,0,2,6e-06,31
"en.wikipedia.org/wiki/Frederick_Roberts,_1st_Earl_Roberts",,2,0,2,6e-06,31
en.wikipedia.org/wiki/Second_Anglo-Maratha_War,,4,0,4,6e-06,31
en.wikipedia.org/wiki/Khilafat_Movement,,5,0,5,7e-06,31
en.wikipedia.org/wiki/Jallianwala_Bagh_massacre,,3,0,3,6e-06,31
en.wikipedia.org/wiki/Kakori_conspiracy,,6,0,6,7e-06,31
en.wikipedia.org/wiki/Lucknow_Pact,,5,0,5,7e-06,31
en.wikipedia.org/wiki/All_India_Kisan_Sabha,,3,0,3,6e-06,31
en.wikipedia.org/wiki/Chandra_Shekhar_Azad,,4,0,4,6e-06,31
en.wikipedia.org/wiki/Ram_Prasad_Bismil,,3,0,3,6e-06,31
en.wikipedia.org/wiki/Anglo-Persian_War,,2,0,2,6e-06,31
en.wikipedia.org/wiki/Second_Opium_War,,2,0,2,6e-06,31
en.wikipedia.org/wiki/List_of_Indian_state_symbols,,2,0,2,6e-06,31
en.wikipedia.org/wiki/List_of_Indian_state_animals,,2,0,2,6e-06,31
en.wikipedia.org/wiki/List_of_Indian_state_birds,,2,0,2,6e-06,31
en.wikipedia.org/wiki/List_of_Indian_state_flowers,,2,0,2,6e-06,31
en.wikipedia.org/wiki/List_of_Indian_state_trees,,2,0,2,6e-06,31
en.wikipedia.org/wiki/Hooghly_River,,4,0,4,6e-06,31
en.wikipedia.org/wiki/Hugli-Chuchura,,2,0,2,6e-06,31
en.wikipedia.org/wiki/Category:Conflicts_in_1857,,2,0,2,6e-06,31
en.wikipedia.org/wiki/Category:1857_in_India,,3,0,3,6e-06,31
en.wikipedia.org/wiki/Fintech,,3,0,3,6e-06,31
en.wikipedia.org/w/index.php?title=Special:CreateAccount&returnto=Uttar+Pradesh,,1,0,1,6e-06,31
en.wikipedia.org/w/index.php?title=Special:UserLogin&returnto=Uttar+Pradesh,,1,0,1,6e-06,31
ace.wikipedia.org/wiki/Uttar_Pradesh,,1,0,1,6e-06,31
af.wikipedia.org/wiki/Uttar_Pradesh,,1,0,1,6e-06,31
am.wikipedia.org/wiki/ኡተር_ፕረዴሽ,,1,0,1,6e-06,31
anp.wikipedia.org/wiki/उत्तर_प्रदेश,,1,0,1,6e-06,31
ar.wikipedia.org/wiki/أتر_برديش,,1,0,1,6e-06,31
as.wikipedia.org/wiki/উত্তৰ_প্ৰদেশ,,1,0,1,6e-06,31
ast.wikipedia.org/wiki/Uttar_Pradesh,,1,0,1,6e-06,31
awa.wikipedia.org/wiki/उत्तर_प्रदेश,,1,0,1,6e-06,31
az.wikipedia.org/wiki/Uttar-Pradeş,,1,0,1,6e-06,31
azb.wikipedia.org/wiki/اوتار_پرادش,,1,0,1,6e-06,31
ban.wikipedia.org/wiki/Uttar_Pradesh,,1,0,1,6e-06,31
bn.wikipedia.org/wiki/উত্তরপ্রদেশ,,1,0,1,6e-06,31
zh-min-nan.wikipedia.org/wiki/Uttar_Pradesh,,1,0,1,6e-06,31
be.wikipedia.org/wiki/Утар-Прадэш,,1,0,1,6e-06,31
be-tarask.wikipedia.org/wiki/Утар-Прадэш,,1,0,1,6e-06,31
bh.wikipedia.org/wiki/उत्तर_प्रदेश,,1,0,1,6e-06,31
bcl.wikipedia.org/wiki/Uttar_Pradesh,,1,0,1,6e-06,31
bg.wikipedia.org/wiki/Утар_Прадеш,,1,0,1,6e-06,31
br.wikipedia.org/wiki/Uttar_Pradesh,,1,0,1,6e-06,31
ca.wikipedia.org/wiki/Uttar_Pradesh,,1,0,1,6e-06,31
ceb.wikipedia.org/wiki/Uttar_Pradesh,,1,0,1,6e-06,31
cs.wikipedia.org/wiki/Uttarpradéš,,1,0,1,6e-06,31
cy.wikipedia.org/wiki/Uttar_Pradesh,,1,0,1,6e-06,31
da.wikipedia.org/wiki/Uttar_Pradesh,,1,0,1,6e-06,31
dv.wikipedia.org/wiki/އުއްތަރު_ޕްރަދޭޝް,,1,0,1,6e-06,31
dty.wikipedia.org/wiki/उत्तर_प्रदेश,,1,0,1,6e-06,31
et.wikipedia.org/wiki/Uttar_Pradesh,,1,0,1,6e-06,31
el.wikipedia.org/wiki/Ούταρ_Πραντές,,1,0,1,6e-06,31
eo.wikipedia.org/wiki/Utar-Pradeŝo,,1,0,1,6e-06,31
eu.wikipedia.org/wiki/Uttar_Pradesh,,1,0,1,6e-06,31
fa.wikipedia.org/wiki/اوتار_پرادش,,1,0,1,6e-06,31
hif.wikipedia.org/wiki/Uttar_Pradesh,,1,0,1,6e-06,31
fr.wikipedia.org/wiki/Uttar_Pradesh,,1,0,1,6e-06,31
ga.wikipedia.org/wiki/Uttar_Pradesh,,1,0,1,6e-06,31
gl.wikipedia.org/wiki/Uttar_Pradesh,,1,0,1,6e-06,31
gu.wikipedia.org/wiki/ઉત્તર_પ્રદેશ,,1,0,1,6e-06,31
gom.wikipedia.org/wiki/उत्तर_प्रदेश,,1,0,1,6e-06,31
ha.wikipedia.org/wiki/Uttar_Pradesh,,1,0,1,6e-06,31
hy.wikipedia.org/wiki/Ուտար_Պրադեշ,,1,0,1,6e-06,31
hr.wikipedia.org/wiki/Uttar_Pradesh,,1,0,1,6e-06,31
io.wikipedia.org/wiki/Uttar_Pradesh,,1,0,1,6e-06,31
bpy.wikipedia.org/wiki/উত্তর_প্রদেশ,,1,0,1,6e-06,31
id.wikipedia.org/wiki/Uttar_Pradesh,,1,0,1,6e-06,31
os.wikipedia.org/wiki/Уттар-Прадеш,,1,0,1,6e-06,31
is.wikipedia.org/wiki/Uttar_Pradesh,,1,0,1,6e-06,31
it.wikipedia.org/wiki/Uttar_Pradesh,,1,0,1,6e-06,31
he.wikipedia.org/wiki/אוטר_פרדש,,1,0,1,6e-06,31
jv.wikipedia.org/wiki/Uttar_Pradesh,,1,0,1,6e-06,31
kn.wikipedia.org/wiki/ಉತ್ತರ_ಪ್ರದೇಶ,,1,0,1,6e-06,31
pam.wikipedia.org/wiki/Uttar_Pradesh,,1,0,1,6e-06,31
ka.wikipedia.org/wiki/უტარ-პრადეში,,1,0,1,6e-06,31
ks.wikipedia.org/wiki/وۄتُر_پرَٛدیش,,1,0,1,6e-06,31
sw.wikipedia.org/wiki/Uttar_Pradesh,,1,0,1,6e-06,31
la.wikipedia.org/wiki/Uttara_Pradeśa,,1,0,1,6e-06,31
lv.wikipedia.org/wiki/Utarpradēša,,1,0,1,6e-06,31
lb.wikipedia.org/wiki/Uttar_Pradesh,,1,0,1,6e-06,31
lt.wikipedia.org/wiki/Utar_Pradešas,,1,0,1,6e-06,31
hu.wikipedia.org/wiki/Uttar_Prades,,1,0,1,6e-06,31
mai.wikipedia.org/wiki/उत्तर_प्रदेश,,1,0,1,6e-06,31
mk.wikipedia.org/wiki/Утар_Прадеш,,1,0,1,6e-06,31
ml.wikipedia.org/wiki/ഉത്തർ‌പ്രദേശ്,,1,0,1,6e-06,31
xmf.wikipedia.org/wiki/უტარ-პრადეში,,1,0,1,6e-06,31
mzn.wikipedia.org/wiki/اوتار_پرادش,,1,0,1,6e-06,31
ms.wikipedia.org/wiki/Uttar_Pradesh,,1,0,1,6e-06,31
mni.wikipedia.org/wiki/ꯎꯠꯇꯔ_ꯄ꯭ꯔꯗꯦꯁ,,1,0,1,6e-06,31
cdo.wikipedia.org/wiki/Uttar_Pradesh,,1,0,1,6e-06,31
mn.wikipedia.org/wiki/Уттар_Прадеш,,1,0,1,6e-06,31
my.wikipedia.org/wiki/ဥတ္တရပဒေသပြည်နယ်,,1,0,1,6e-06,31
nl.wikipedia.org/wiki/Uttar_Pradesh,,1,0,1,6e-06,31
ne.wikipedia.org/wiki/उत्तर_प्रदेश,,1,0,1,6e-06,31
new.wikipedia.org/wiki/उत्तरप्रदेश,,1,0,1,6e-06,31
ja.wikipedia.org/wiki/ウッタル・プラデーシュ州,,1,0,1,6e-06,31
ce.wikipedia.org/wiki/Уттар-Прадеш,,1,0,1,6e-06,31
frr.wikipedia.org/wiki/Uttar_Pradesh,,1,0,1,6e-06,31
nn.wikipedia.org/wiki/Uttar_Pradesh,,1,0,1,6e-06,31
oc.wikipedia.org/wiki/Uttar_Pradesh,,1,0,1,6e-06,31
or.wikipedia.org/wiki/ଉତ୍ତର_ପ୍ରଦେଶ,,1,0,1,6e-06,31
uz.wikipedia.org/wiki/Uttar-Pradesh,,1,0,1,6e-06,31
pa.wikipedia.org/wiki/ਉੱਤਰ_ਪ੍ਰਦੇਸ਼,,1,0,1,6e-06,31
pnb.wikipedia.org/wiki/اُتّر_پردیش,,1,0,1,6e-06,31
ps.wikipedia.org/wiki/اتر_پرديش,,1,0,1,6e-06,31
pms.wikipedia.org/wiki/Uttar_Pradesh,,1,0,1,6e-06,31
pl.wikipedia.org/wiki/Uttar_Pradesh,,1,0,1,6e-06,31
pt.wikipedia.org/wiki/Utar_Pradexe,,1,0,1,6e-06,31
ro.wikipedia.org/wiki/Uttar_Pradesh,,1,0,1,6e-06,31
ru.wikipedia.org/wiki/Уттар-Прадеш,,1,0,1,6e-06,31
sah.wikipedia.org/wiki/Уттар_Прадыш,,1,0,1,6e-06,31
sa.wikipedia.org/wiki/उत्तरप्रदेशराज्यम्,,1,0,1,6e-06,31
sat.wikipedia.org/wiki/ᱩᱛᱛᱚᱨ_ᱯᱨᱚᱫᱮᱥ,,1,0,1,6e-06,31
skr.wikipedia.org/wiki/اتر_پردیش,,1,0,1,6e-06,31
sco.wikipedia.org/wiki/Uttar_Pradesh,,1,0,1,6e-06,31
sq.wikipedia.org/wiki/Uttar_Pradesh,,1,0,1,6e-06,31
si.wikipedia.org/wiki/උත්තර්_ප්‍රදේශ්,,1,0,1,6e-06,31
simple.wikipedia.org/wiki/Uttar_Pradesh,,1,0,1,6e-06,31
sd.wikipedia.org/wiki/اتر_پرديش,,1,0,1,6e-06,31
sk.wikipedia.org/wiki/Uttarpradéš,,1,0,1,6e-06,31
sr.wikipedia.org/wiki/Утар_Прадеш,,1,0,1,6e-06,31
sh.wikipedia.org/wiki/Utar_Pradeš,,1,0,1,6e-06,31
fi.wikipedia.org/wiki/Uttar_Pradesh,,1,0,1,6e-06,31
sv.wikipedia.org/wiki/Uttar_Pradesh,,1,0,1,6e-06,31
tl.wikipedia.org/wiki/Uttar_Pradesh,,1,0,1,6e-06,31
ta.wikipedia.org/wiki/உத்தரப்_பிரதேசம்,,1,0,1,6e-06,31
tt.wikipedia.org/wiki/Уттар-Прадеш,,1,0,1,6e-06,31
th.wikipedia.org/wiki/รัฐอุตตรประเทศ,,1,0,1,6e-06,31
tg.wikipedia.org/wiki/Уттар_Прадеш,,1,0,1,6e-06,31
tcy.wikipedia.org/wiki/ಉತ್ತರ_ಪ್ರದೇಶ,,1,0,1,6e-06,31
tr.wikipedia.org/wiki/Uttar_Pradeş,,1,0,1,6e-06,31
uk.wikipedia.org/wiki/Уттар-Прадеш,,1,0,1,6e-06,31
ur.wikipedia.org/wiki/اتر_پردیش,,1,0,1,6e-06,31
vec.wikipedia.org/wiki/Uttar_Pradesh,,1,0,1,6e-06,31
vi.wikipedia.org/wiki/Uttar_Pradesh,,1,0,1,6e-06,31
war.wikipedia.org/wiki/Uttar_Pradesh,,1,0,1,6e-06,31
wuu.wikipedia.org/wiki/北方邦,,1,0,1,6e-06,31
yi.wikipedia.org/wiki/אוטאר_פראדעש,,1,0,1,6e-06,31
yo.wikipedia.org/wiki/Uttar_Pradesh,,1,0,1,6e-06,31
zh-yue.wikipedia.org/wiki/北方邦,,1,0,1,6e-06,31
zh.wikipedia.org/wiki/北方邦,,1,0,1,6e-06,31
kge.wikipedia.org/wiki/Uttar_Pradesh,,1,0,1,6e-06,31
wikidata.org/wiki/Special:EntityPage/Q1498,,1,0,1,6e-06,31
en.wikipedia.org/wiki/Talk:Uttar_Pradesh,,1,0,1,6e-06,31
en.wikipedia.org/w/index.php?title=Uttar_Pradesh&action=edit,,1,0,1,6e-06,31
en.wikipedia.org/w/index.php?title=Uttar_Pradesh&action=history,,1,0,1,6e-06,31
en.wikipedia.org/wiki/Special:WhatLinksHere/Uttar_Pradesh,,1,0,1,6e-06,31
en.wikipedia.org/wiki/Special:RecentChangesLinked/Uttar_Pradesh,,1,0,1,6e-06,31
en.wikipedia.org/w/index.php?title=Uttar_Pradesh&oldid=1307966073,,1,0,1,6e-06,31
en.wikipedia.org/w/index.php?title=Uttar_Pradesh&action=info,,1,0,1,6e-06,31
en.wikipedia.org/w/index.php?title=Uttar_Pradesh&printable=yes,,1,0,1,6e-06,31
en.wikinews.org/wiki/Category:Uttar_Pradesh,,1,0,1,6e-06,31
en.wikiquote.org/wiki/Uttar_Pradesh,,1,0,1,6e-06,31
en.wikivoyage.org/wiki/Uttar_Pradesh,,1,0,1,6e-06,31
en.wikipedia.org/wiki/File:Taj_Mahal_(Edited).jpeg,,1,0,1,6e-06,31
en.wikipedia.org/wiki/File:India-5163_-_Flickr_-_archer10_(Dennis).jpg,,1,0,1,6e-06,31
en.wikipedia.org/wiki/Dudhwa_National_Park,,6,0,6,7e-06,31
en.wikipedia.org/wiki/File:Fatehpur_Sikri_near_Agra_2016-03_img09.jpg,,1,0,1,6e-06,31
en.wikipedia.org/wiki/Fatehpur_Sikri,,4,0,4,7e-06,31
en.wikipedia.org/wiki/File:Agra_03-2016_14_Agra_Fort.jpg,,1,0,1,6e-06,31
en.wikipedia.org/wiki/File:Seal_of_Uttar_Pradesh.svg,,1,0,1,6e-06,31
en.wikipedia.org/wiki/List_of_Indian_state_mottos,,1,0,1,6e-06,31
en.wikipedia.org/wiki/File:IN-UP.svg,,1,0,1,6e-06,31
en.wikipedia.org/wiki/List_of_Indian_state_foundation_days,,1,0,1,6e-06,31
en.wikipedia.org/wiki/List_of_deputy_chief_ministers_of_Uttar_Pradesh,,1,0,1,6e-06,31
en.wikipedia.org/wiki/Keshav_Prasad_Maurya,,1,0,1,6e-06,31
en.wikipedia.org/wiki/BJP,,4,0,4,7e-06,31
en.wikipedia.org/wiki/Brajesh_Pathak,,2,0,2,6e-06,31
en.wikipedia.org/wiki/State_Legislature,,1,0,1,6e-06,31
en.wikipedia.org/wiki/List_of_states_and_union_territories_of_India_by_area,,1,0,1,6e-06,31
en.wikipedia.org/wiki/List_of_states_and_union_territories_of_India_by_population,,1,0,1,6e-06,31
en.wikipedia.org/wiki/Official_scripts_of_the_Indian_Republic,,1,0,1,6e-06,31
en.wikipedia.org/wiki/GDP,,1,0,1,6e-06,31
en.wikipedia.org/wiki/List_of_Indian_states_and_union_territories_by_GDP,,1,0,1,6e-06,31
en.wikipedia.org/wiki/List_of_Indian_states_and_union_territories_by_GDP_per_capita,,1,0,1,6e-06,31
en.wikipedia.org/wiki/UTC%2B05:30,,8,0,8,7e-06,31
en.wikipedia.org/wiki/List_of_Regional_Transport_Office_districts_in_India,,1,0,1,6e-06,31
en.wikipedia.org/wiki/List_of_Indian_states_and_union_territories_by_Human_Development_Index,,1,0,1,6e-06,31
en.wikipedia.org/wiki/List_of_Indian_states_and_union_territories_by_literacy_rate,,1,0,1,6e-06,31
en.wikipedia.org/wiki/Sex_ratio,,8,0,8,7e-06,31
en.wikipedia.org/wiki/List_of_states_and_union_territories_of_India_by_sex_ratio,,1,0,1,6e-06,31
en.wikipedia.org/wiki/Uttar_Pradesh_Day,,1,0,1,6e-06,31
en.wikipedia.org/wiki/Sarus_crane,,2,0,2,6e-06,31
en.wikipedia.org/wiki/Barasingha,,2,0,2,6e-06,31
en.wikipedia.org/wiki/File:SH_IN-UP.png,,1,0,1,6e-06,31
en.wikipedia.org/wiki/List_of_first-level_administrative_divisions_by_population,,1,0,1,6e-06,31
en.wikipedia.org/wiki/List_of_states_of_India_by_area,,1,0,1,6e-06,31
en.wikipedia.org/wiki/State_capital,,1,0,1,6e-06,31
en.wikipedia.org/wiki/List_of_Chief_Commissioners_of_Oudh,,1,0,1,6e-06,31
en.wikipedia.org/wiki/Hotel_industry,,1,0,1,6e-06,31
en.wikipedia.org/wiki/Ghaghara,,10,0,10,7e-06,31
en.wikipedia.org/wiki/Bhojpuri_people,,1,0,1,6e-06,31
en.wikipedia.org/wiki/Braj,,7,0,7,7e-06,31
en.wikipedia.org/wiki/Harsha_Empire,,1,0,1,6e-06,31
en.wikipedia.org/wiki/Princely_states,,1,0,1,6e-06,31
en.wikipedia.org/wiki/Special:EditPage/Uttar_Pradesh,,1,0,1,6e-06,31
en.wikipedia.org/wiki/List_of_Indian_state_and_union_territory_name_etymologies,,1,0,1,6e-06,31
en.wikipedia.org/wiki/Pradesh,,1,0,1,6e-06,31
en.wikipedia.org/wiki/Early_modern_human,,1,0,1,6e-06,31
en.wikipedia.org/wiki/Middle_Paleolithic,,1,0,1,6e-06,31
en.wikipedia.org/wiki/Upper_Paleolithic,,1,0,1,6e-06,31
en.wikipedia.org/wiki/Mesolithic,,1,0,1,6e-06,31
en.wikipedia.org/wiki/Microlithic,,1,0,1,6e-06,31
en.wikipedia.org/wiki/Hunter-gatherer,,1,0,1,6e-06,31
en.wikipedia.org/wiki/File:Dhamek_Stupta_and_the_Ancient_Buddhist_Site_at_Sarnath.jpg,,1,0,1,6e-06,31
en.wikipedia.org/wiki/Dhamekh_Stupa,,1,0,1,6e-06,31
en.wikipedia.org/wiki/Sangha_(Buddhism),,1,0,1,6e-06,31
en.wikipedia.org/wiki/Enlightenment_in_Buddhism,,1,0,1,6e-06,31
en.wikipedia.org/wiki/Kondanna_Buddha,,1,0,1,6e-06,31
en.wikipedia.org/wiki/Yudhishthira,,1,0,1,6e-06,31
en.wikipedia.org/wiki/Black_and_Red_Ware,,1,0,1,6e-06,31
en.wikipedia.org/wiki/Painted_Gray_Ware,,1,0,1,6e-06,31
en.wikipedia.org/wiki/Harshavardhana,,1,0,1,6e-06,31
en.wikipedia.org/wiki/Chero_dynasty,,1,0,1,6e-06,31
en.wikipedia.org/wiki/Qutb_ud-Din_Aibak,,1,0,1,6e-06,31
en.wikipedia.org/wiki/Balban,,1,0,1,6e-06,31
en.wikipedia.org/wiki/Alauddin_Khilji,,1,0,1,6e-06,31
en.wikipedia.org/wiki/Sufism,,1,0,1,6e-06,31
en.wikipedia.org/wiki/Nizamuddin_Auliya,,1,0,1,6e-06,31
en.wikipedia.org/wiki/Qutbuddin_Bakhtiar_Kaki,,1,0,1,6e-06,31
en.wikipedia.org/wiki/Atala_Masjid,,1,0,1,6e-06,31
"en.wikipedia.org/wiki/Jaunpur,_Uttar_Pradesh",,2,0,2,7e-06,31
en.wikipedia.org/wiki/Jama_Masjid,,1,0,1,6e-06,31
en.wikipedia.org/wiki/Ghiyath_al-Din_Tughluq%27s_Tomb,,1,0,1,6e-06,31
en.wikipedia.org/wiki/Tughlaqabad,,1,0,1,6e-06,31
en.wikipedia.org/wiki/Babur,,3,0,3,6e-06,31
en.wikipedia.org/wiki/Timur,,1,0,1,6e-06,31
en.wikipedia.org/wiki/Descent_from_Genghis_Khan,,1,0,1,6e-06,31
en.wikipedia.org/wiki/Fergana_Valley,,1,0,1,6e-06,31
en.wikipedia.org/wiki/Turkic_people,,1,0,1,6e-06,31
en.wikipedia.org/wiki/Mongol,,1,0,1,6e-06,31
en.wikipedia.org/wiki/Hemu,,1,0,1,6e-06,31
en.wikipedia.org/wiki/Vikramāditya,,1,0,1,6e-06,31
en.wikipedia.org/wiki/Second_Battle_of_Panipat,,1,0,1,6e-06,31
en.wikipedia.org/wiki/Raghunath_Rao,,1,0,1,6e-06,31
en.wikipedia.org/wiki/Malhar_Rao_Holkar,,1,0,1,6e-06,31
en.wikipedia.org/wiki/Ghulam_Kadir,,1,0,1,6e-06,31
en.wikipedia.org/wiki/Mahadji_Scindia,,1,0,1,6e-06,31
en.wikipedia.org/wiki/Ceded_and_Conquered_Provinces,,1,0,1,6e-06,31
en.wikipedia.org/wiki/Presidency_of_Agra,,1,0,1,6e-06,31
en.wikipedia.org/wiki/Oudh,,3,0,3,6e-06,31
en.wikipedia.org/wiki/Punjab_(British_India),,1,0,1,6e-06,31
"en.wikipedia.org/wiki/Kekri,_Rajasthan",,1,0,1,6e-06,31
en.wikipedia.org/wiki/Regiment,,1,0,1,6e-06,31
en.wikipedia.org/wiki/Motilal_Nehru,,1,0,1,6e-06,31
en.wikipedia.org/wiki/Zamindari,,1,0,1,6e-06,31
en.wikipedia.org/wiki/Chittu_Pandey,,1,0,1,6e-06,31
en.wikipedia.org/wiki/Communal_violence,,1,0,1,6e-06,31
en.wikipedia.org/wiki/Demolition_of_the_Babri_Masjid,,1,0,1,6e-06,31
en.wikipedia.org/wiki/Saccharum_ravennae,,1,0,1,6e-06,31
en.wikipedia.org/wiki/Marshes,,1,0,1,6e-06,31
en.wikipedia.org/wiki/Swamps,,1,0,1,6e-06,31
en.wikipedia.org/wiki/Eastern_Uttar_Pradesh,,1,0,1,6e-06,31
en.wikipedia.org/wiki/Floods,,1,0,1,6e-06,31
en.wikipedia.org/wiki/Droughts,,1,0,1,6e-06,31
en.wikipedia.org/wiki/Central_Uttar_Pradesh,,1,0,1,6e-06,31
en.wikipedia.org/wiki/Saraswati_river,,1,0,1,6e-06,31
en.wikipedia.org/wiki/Sarayu,,1,0,1,6e-06,31
en.wikipedia.org/wiki/Tillage,,1,0,1,6e-06,31
en.wikipedia.org/wiki/Valley,,1,0,1,6e-06,31
en.wikipedia.org/wiki/Siwalik_Range,,1,0,1,6e-06,31
en.wikipedia.org/wiki/Torrent_(stream),,1,0,1,6e-06,31
en.wikipedia.org/wiki/File:Sunset_in_Indirapuram_Uttar_Pradesh.jpg,,1,0,1,6e-06,31
en.wikipedia.org/wiki/Indirapuram,,1,0,1,6e-06,31
en.wikipedia.org/wiki/Loo_(wind),,1,0,1,6e-06,31
en.wikipedia.org/wiki/Monsoon_of_India,,1,0,1,6e-06,31
en.wikipedia.org/wiki/Western_disturbances,,1,0,1,6e-06,31
en.wikipedia.org/wiki/Precipitation,,3,0,3,6e-06,31
en.wikipedia.org/wiki/Sunshine_duration,,4,0,4,6e-06,31
en.wikipedia.org/wiki/Plateau,,1,0,1,6e-06,31
en.wikipedia.org/wiki/Pilibhit_Tiger_Reserve,,6,0,6,7e-06,31
en.wikipedia.org/wiki/Swamp_deer,,1,0,1,6e-06,31
en.wikipedia.org/wiki/File:The_barasingha.jpg,,1,0,1,6e-06,31
en.wikipedia.org/wiki/File:Grus_antigone_Luc_viatour.jpg,,1,0,1,6e-06,31
en.wikipedia.org/wiki/File:Ashoka_(Polyalthia_longifolia)_flowers_W_IMG_7050.jpg,,1,0,1,6e-06,31
en.wikipedia.org/wiki/File:STS_001_Butea_monosperma.jpg,,1,0,1,6e-06,31
en.wikipedia.org/wiki/File:Kathak_3511900193_986f6440f6_b_retouched.jpg,,1,0,1,6e-06,31
en.wikipedia.org/wiki/File:Field_hockey.jpg,,1,0,1,6e-06,31
en.wikipedia.org/wiki/Fungi,,1,0,1,6e-06,31
en.wikipedia.org/wiki/Lichens,,1,0,1,6e-06,31
en.wikipedia.org/wiki/Bryophytes,,1,0,1,6e-06,31
en.wikipedia.org/wiki/Gymnosperms,,1,0,1,6e-06,31
en.wikipedia.org/wiki/Angiosperms,,1,0,1,6e-06,31
en.wikipedia.org/wiki/Mammals,,1,0,1,6e-06,31
en.wikipedia.org/wiki/Reptiles,,1,0,1,6e-06,31
en.wikipedia.org/wiki/Temperate,,1,0,1,6e-06,31
en.wikipedia.org/wiki/Deciduous,,1,0,1,6e-06,31
en.wikipedia.org/wiki/Amphibians,,1,0,1,6e-06,31
en.wikipedia.org/wiki/Scrubland,,1,0,1,6e-06,31
en.wikipedia.org/wiki/Babool,,1,0,1,6e-06,31
en.wikipedia.org/wiki/Chinkara,,1,0,1,6e-06,31
en.wikipedia.org/wiki/Acacia_nilotica,,1,0,1,6e-06,31
en.wikipedia.org/wiki/Columbidae,,1,0,1,6e-06,31
en.wikipedia.org/wiki/Peafowl,,2,0,2,6e-06,31
en.wikipedia.org/wiki/Junglefowl,,1,0,1,6e-06,31
en.wikipedia.org/wiki/House_sparrow,,1,0,1,6e-06,31
en.wikipedia.org/wiki/Songbirds,,1,0,1,6e-06,31
en.wikipedia.org/wiki/Blue_jay,,1,0,1,6e-06,31
en.wikipedia.org/wiki/Parakeet,,1,0,1,6e-06,31
en.wikipedia.org/wiki/Quail,,1,0,1,6e-06,31
en.wikipedia.org/wiki/Bulbul,,1,0,1,6e-06,31
en.wikipedia.org/wiki/Knob-billed_duck,,1,0,1,6e-06,31
en.wikipedia.org/wiki/Kingfisher,,1,0,1,6e-06,31
en.wikipedia.org/wiki/Woodpecker,,1,0,1,6e-06,31
en.wikipedia.org/wiki/Snipe,,2,0,2,6e-06,31
en.wikipedia.org/wiki/Bakhira_Sanctuary,,5,0,5,7e-06,31
en.wikipedia.org/wiki/Chandra_Prabha_Wildlife_Sanctuary,,3,0,3,6e-06,31
en.wikipedia.org/wiki/Hastinapur_Wildlife_Sanctuary,,3,0,3,6e-06,31
en.wikipedia.org/wiki/Kaimoor_Wildlife_Sanctuary,,3,0,3,6e-06,31
en.wikipedia.org/wiki/Okhla_Sanctuary,,6,0,6,7e-06,31
en.wikipedia.org/wiki/Lizard,,1,0,1,6e-06,31
en.wikipedia.org/wiki/Cobra,,2,0,2,6e-06,31
en.wikipedia.org/wiki/Bungarus,,1,0,1,6e-06,31
en.wikipedia.org/wiki/Mahseer,,1,0,1,6e-06,31
en.wikipedia.org/wiki/Trout,,1,0,1,6e-06,31
en.wikipedia.org/wiki/File:Anandabodhi.jpg,,1,0,1,6e-06,31
en.wikipedia.org/wiki/Sravasti,,1,0,1,6e-06,31
en.wikipedia.org/wiki/File:Tropaeolum_majus.jpg,,1,0,1,6e-06,31
en.wikipedia.org/wiki/Tropaeolum_majus,,1,0,1,6e-06,31
en.wikipedia.org/wiki/File:Ganges_River_Dolphin_cropped.jpg,,1,0,1,6e-06,31
en.wikipedia.org/wiki/Ganges_river_dolphin,,2,0,2,6e-06,31
en.wikipedia.org/wiki/File:Ganges_calling.jpg,,1,0,1,6e-06,31
"en.wikipedia.org/wiki/File:Gavialis_gangeticus,_ZOO_Praha_045.jpg",,2,0,2,6e-06,31
en.wikipedia.org/wiki/List_of_urban_local_bodies_in_Uttar_Pradesh,,1,0,1,6e-06,31
en.wikipedia.org/wiki/File:Uttar_Pradesh_administrative_divisions.svg,,1,0,1,6e-06,31
en.wikipedia.org/wiki/Block_(country_subdivision),,1,0,1,6e-06,31
en.wikipedia.org/wiki/Panchayats,,1,0,1,6e-06,31
en.wikipedia.org/wiki/Municipalities,,1,0,1,6e-06,31
en.wikipedia.org/wiki/Census_towns,,1,0,1,6e-06,31
en.wikipedia.org/wiki/Gram_panchayat,,2,0,2,6e-06,31
en.wikipedia.org/wiki/List_of_most_populous_cities_in_India,,2,0,2,6e-06,31
en.wikipedia.org/wiki/Nagar_Nigam,,1,0,1,6e-06,31
en.wikipedia.org/wiki/Nagar_Palika_Parishad,,1,0,1,6e-06,31
en.wikipedia.org/wiki/Bela_Pratapgarh,,1,0,1,6e-06,31
"en.wikipedia.org/wiki/Bisalpur,_Pilibhit",,1,0,1,6e-06,31
en.wikipedia.org/wiki/Nagar_Panchayat,,1,0,1,6e-06,31
"en.wikipedia.org/wiki/Badlapur,_Jaunpur",,1,0,1,6e-06,31
en.wikipedia.org/wiki/Bikapur,,2,0,2,6e-06,31
en.wikipedia.org/wiki/Chilkana_Sultanpur,,1,0,1,6e-06,31
en.wikipedia.org/wiki/Municipal_Corporations_in_India,,1,0,1,6e-06,31
en.wikipedia.org/wiki/List_of_people_from_Uttar_Pradesh,,1,0,1,6e-06,31
en.wikipedia.org/wiki/Christianity_in_Uttar_Pradesh,,3,0,3,6e-06,31
en.wikipedia.org/wiki/Female_infanticide,,1,0,1,6e-06,31
en.wikipedia.org/wiki/Poverty_threshold,,1,0,1,6e-06,31
"en.wikipedia.org/wiki/Vidhan_Bhavan,_Lucknow",,7,0,7,7e-06,31
en.wikipedia.org/wiki/File:Vidhan_Sabha_(at_day).jpg,,1,0,1,6e-06,31
en.wikipedia.org/wiki/Representative_democracy,,1,0,1,6e-06,31
en.wikipedia.org/wiki/Vidhan_Parishad,,1,0,1,6e-06,31
en.wikipedia.org/wiki/Chief_Secretary_(India),,1,0,1,6e-06,31
en.wikipedia.org/wiki/Additional_Chief_Secretary_(India),,1,0,1,6e-06,31
en.wikipedia.org/wiki/Principal_Secretary_(India),,1,0,1,6e-06,31
en.wikipedia.org/wiki/Block_(district_subdivision),,1,0,1,6e-06,31
en.wikipedia.org/wiki/Superintendent_of_Police,,1,0,1,6e-06,31
en.wikipedia.org/wiki/Provincial_Forest_Service_(Uttar_Pradesh),,1,0,1,6e-06,31
en.wikipedia.org/wiki/File:Allahabad_high_court.jpg,,1,0,1,6e-06,31
en.wikipedia.org/wiki/Political_polarization,,1,0,1,6e-06,31
en.wikipedia.org/wiki/National_Human_Rights_Commission_of_India,,1,0,1,6e-06,31
en.wikipedia.org/wiki/Encounter_killings_by_police,,1,0,1,6e-06,31
en.wikipedia.org/wiki/National_Crime_Records_Bureau,,1,0,1,6e-06,31
en.wikipedia.org/wiki/2006_Varanasi_bombings,,2,0,2,7e-06,31
en.wikipedia.org/wiki/2007_Uttar_Pradesh_bombings,,1,0,1,6e-06,31
en.wikipedia.org/wiki/2010_Varanasi_bombing,,2,0,2,7e-06,31
en.wikipedia.org/wiki/List_of_urban_agglomerations_in_Uttar_Pradesh,,1,0,1,6e-06,31
en.wikipedia.org/wiki/File:Common_Indian_Sunflower.jpg,,1,0,1,6e-06,31
en.wikipedia.org/wiki/Common_sunflower,,1,0,1,6e-06,31
en.wikipedia.org/wiki/Indian_states_ranking_by_ease_of_doing_business,,1,0,1,6e-06,31
"en.wikipedia.org/wiki/File:IT_Park,_Noida,_Uttar_Pradesh_(2011-06-18).jpg",,2,0,2,6e-06,31
en.wikipedia.org/wiki/Business_park,,2,0,2,6e-06,31
en.wikipedia.org/wiki/Tertiary_sector_of_the_economy,,1,0,1,6e-06,31
en.wikipedia.org/wiki/File:Delhi_Noida_Direct_flyway_(Uttar_Pradesh_-_2011-06-18).jpg,,4,0,4,6e-06,31
en.wikipedia.org/wiki/Lucknow_Swarna_Shatabdi_Express,,2,0,2,6e-06,31
en.wikipedia.org/wiki/Shatabdi_Express,,5,0,5,7e-06,31
en.wikipedia.org/wiki/LHB_coaches,,1,0,1,6e-06,31
en.wikipedia.org/wiki/Prayagraj_Junction,,1,0,1,6e-06,31
en.wikipedia.org/wiki/Agra_Cantonment,,1,0,1,6e-06,31
en.wikipedia.org/wiki/Gorakhpur_Junction,,1,0,1,6e-06,31
en.wikipedia.org/wiki/Mathura_Junction,,1,0,1,6e-06,31
en.wikipedia.org/wiki/Varanasi_Junction,,1,0,1,6e-06,31
en.wikipedia.org/wiki/Controlled-access_highway,,1,0,1,6e-06,31
en.wikipedia.org/wiki/Uttar_Pradesh_Expressways_Industrial_Development_Authority,,1,0,1,6e-06,31
en.wikipedia.org/wiki/Allahabad_Airport,,1,0,1,6e-06,31
en.wikipedia.org/wiki/Jewar,,3,0,3,6e-06,31
en.wikipedia.org/wiki/Gautam_Buddha_Nagar,,2,0,2,6e-06,31
en.wikipedia.org/wiki/Indian_Grand_Prix,,2,0,2,6e-06,31
en.wikipedia.org/wiki/Uttar_Pradesh_Cricket_Association,,3,0,3,6e-06,31
en.wikipedia.org/wiki/File:Force_india_Buddh.jpg,,1,0,1,6e-06,31
en.wikipedia.org/wiki/Force_India,,1,0,1,6e-06,31
en.wikipedia.org/wiki/Buddh_International_Circuit,,2,0,2,6e-06,31
en.wikipedia.org/wiki/Wrestling,,4,0,4,6e-06,31
en.wikipedia.org/wiki/Swimming_(sport),,4,0,4,6e-06,31
en.wikipedia.org/wiki/List_of_water_sports,,1,0,1,6e-06,31
en.wikipedia.org/wiki/Shaheed_Vijay_Singh_Pathik_Sports_Complex,,2,0,2,6e-06,31
en.wikipedia.org/wiki/Akhara,,2,0,2,6e-06,31
en.wikipedia.org/wiki/Uttar_Pradesh_football_team,,1,0,1,6e-06,31
en.wikipedia.org/wiki/All_India_Football_Federation,,1,0,1,6e-06,31
en.wikipedia.org/wiki/Badminton_Association_of_India,,1,0,1,6e-06,31
en.wikipedia.org/wiki/List_of_Formula_One_Grands_Prix,,1,0,1,6e-06,31
en.wikipedia.org/wiki/Formula_One,,2,0,2,6e-06,31
en.wikipedia.org/wiki/File:Chattar_Manzil_2005.jpg,,1,0,1,6e-06,31
en.wikipedia.org/wiki/Christian_missionaries,,1,0,1,6e-06,31
en.wikipedia.org/wiki/Indian_Certificate_of_Secondary_Education,,2,0,2,7e-06,31
en.wikipedia.org/wiki/10%2B2%2B3_plan,,1,0,1,6e-06,31
en.wikipedia.org/wiki/Child_Rights_and_You,,1,0,1,6e-06,31
en.wikipedia.org/wiki/Absenteeism,,1,0,1,6e-06,31
en.wikipedia.org/wiki/Uttar_Pradesh_government,,1,0,1,6e-06,31
"en.wikipedia.org/wiki/File:La_Martiniere,_lucknow_39.jpg",,1,0,1,6e-06,31
en.wikipedia.org/wiki/AIIMS_Rae_Bareli,,1,0,1,6e-06,31
en.wikipedia.org/wiki/La_Martiniere_Lucknow,,1,0,1,6e-06,31
en.wikipedia.org/wiki/Integral_University_(Lucknow),,1,0,1,6e-06,31
en.wikipedia.org/wiki/Maulana_Azad_Library,,1,0,1,6e-06,31
en.wikipedia.org/wiki/Rampur_Raza_Library,,1,0,1,6e-06,31
en.wikipedia.org/wiki/Faizullah_Khan,,1,0,1,6e-06,31
en.wikipedia.org/wiki/Thornhill_Mayne_Memorial,,1,0,1,6e-06,31
en.wikipedia.org/wiki/Harish_Chandra,,1,0,1,6e-06,31
"en.wikipedia.org/wiki/File:Kumbh_Mela_2013_Sangam,_Allahabd.jpg",,1,0,1,6e-06,31
en.wikipedia.org/wiki/World_Heritage_Sites,,1,0,1,6e-06,31
en.wikipedia.org/wiki/Religious_tourism,,1,0,1,6e-06,31
en.wikipedia.org/wiki/Sapta_Puri,,1,0,1,6e-06,31
en.wikipedia.org/wiki/Shravasti,,2,0,2,7e-06,31
en.wikipedia.org/wiki/Suttas,,1,0,1,6e-06,31
en.wikipedia.org/wiki/Magh_Mela,,1,0,1,6e-06,31
en.wikipedia.org/wiki/Stupas,,1,0,1,6e-06,31
en.wikipedia.org/wiki/Monasteries,,1,0,1,6e-06,31
en.wikipedia.org/wiki/Buddhists,,2,0,2,6e-06,31
en.wikipedia.org/wiki/Lion_Capital_of_Ashoka,,1,0,1,6e-06,31
en.wikipedia.org/wiki/Lord_Cornwallis,,1,0,1,6e-06,31
en.wikipedia.org/wiki/File:District_Hospital.jpg,,2,0,2,6e-06,31
en.wikipedia.org/wiki/Community_health_centers,,1,0,1,6e-06,31
en.wikipedia.org/wiki/District_hospital,,1,0,1,6e-06,31
en.wikipedia.org/wiki/Medical_colleges,,1,0,1,6e-06,31
en.wikipedia.org/wiki/Out-of-pocket_expense,,1,0,1,6e-06,31
en.wikipedia.org/wiki/Contagious_disease,,1,0,1,6e-06,31
en.wikipedia.org/wiki/Tuberculosis,,2,0,2,6e-06,31
en.wikipedia.org/wiki/Maternal_mortality,,1,0,1,6e-06,31
en.wikipedia.org/wiki/Ante-natal_care,,1,0,1,6e-06,31
en.wikipedia.org/wiki/Home_birth,,1,0,1,6e-06,31
en.wikipedia.org/wiki/Child_mortality,,1,0,1,6e-06,31
en.wikipedia.org/wiki/Neonatal_mortality_rate,,1,0,1,6e-06,31
en.wikipedia.org/wiki/Languages_of_Uttar_Pradesh,,1,0,1,6e-06,31
en.wikipedia.org/wiki/File:Kurukshetra.jpg,,1,0,1,6e-06,31
en.wikipedia.org/wiki/Battle_of_Kurukshetra,,1,0,1,6e-06,31
en.wikipedia.org/wiki/Bundeli,,1,0,1,6e-06,31
en.wikipedia.org/wiki/Music_of_Uttar_Pradesh,,1,0,1,6e-06,31
"en.wikipedia.org/wiki/Banda,_Uttar_Pradesh",,2,0,2,6e-06,31
en.wikipedia.org/wiki/Kajari,,1,0,1,6e-06,31
en.wikipedia.org/wiki/Ghazal,,1,0,1,6e-06,31
en.wikipedia.org/wiki/Thumri,,1,0,1,6e-06,31
en.wikipedia.org/wiki/Qawwali,,1,0,1,6e-06,31
en.wikipedia.org/wiki/Sufi_poetry,,1,0,1,6e-06,31
en.wikipedia.org/wiki/Rasiya,,2,0,2,7e-06,31
en.wikipedia.org/wiki/Khayal,,1,0,1,6e-06,31
en.wikipedia.org/wiki/Biraha,,1,0,1,6e-06,31
en.wikipedia.org/wiki/Chaiti,,1,0,1,6e-06,31
en.wikipedia.org/wiki/Chowtal,,1,0,1,6e-06,31
en.wikipedia.org/wiki/Alha-Khand,,1,0,1,6e-06,31
en.wikipedia.org/wiki/Sawani,,1,0,1,6e-06,31
en.wikipedia.org/wiki/Nautanki,,3,0,3,7e-06,31
en.wikipedia.org/wiki/Gharana,,2,0,2,6e-06,31
en.wikipedia.org/wiki/Lucknow_gharana,,1,0,1,6e-06,31
en.wikipedia.org/wiki/Benares_gharana,,1,0,1,6e-06,31
en.wikipedia.org/wiki/Charkula,,1,0,1,6e-06,31
en.wikipedia.org/wiki/File:Vegetarian_Curry.jpeg,,2,0,2,6e-06,31
en.wikipedia.org/wiki/Naan,,1,0,1,6e-06,31
en.wikipedia.org/wiki/Dal,,2,0,2,6e-06,31
en.wikipedia.org/wiki/Raita,,2,0,2,6e-06,31
en.wikipedia.org/wiki/Shahi_paneer,,1,0,1,6e-06,31
en.wikipedia.org/wiki/Maagha,,1,0,1,6e-06,31
en.wikipedia.org/wiki/Lathmar_Holi,,1,0,1,6e-06,31
en.wikipedia.org/wiki/Barsana,,1,0,1,6e-06,31
en.wikipedia.org/wiki/Taj_Mahotsav,,4,0,4,7e-06,31
en.wikipedia.org/wiki/Cuisine_of_Uttar_Pradesh,,1,0,1,6e-06,31
en.wikipedia.org/wiki/Mughlai_cuisine,,1,0,1,6e-06,31
en.wiktionary.org/wiki/imperial,,1,0,1,6e-06,31
en.wikipedia.org/wiki/Central_Asian_cuisine,,1,0,1,6e-06,31
en.wikipedia.org/wiki/Awadhi_cuisine,,1,0,1,6e-06,31
en.wikipedia.org/wiki/Bhojpuri_cuisine,,1,0,1,6e-06,31
en.wikipedia.org/wiki/UP_Gaurav_Samman,,1,0,1,6e-06,31
newindianexpress.com/nation/2017/may/02/uttar-pradesh-introduces-new-transfer-policy-1600219.html,,1,0,1,6e-06,31
up.gov.in/upmap.aspx,,1,0,1,6e-06,31
web.archive.org/web/20170415123851/http://up.gov.in/upmap.aspx,,1,0,1,6e-06,31
archive.india.gov.in/knowindia/districts/andhra1.php?stateid=UP,,1,0,1,6e-06,31
web.archive.org/web/20170503081924/http://uplegisassembly.gov.in/ENGLISH/governor_current.htm,,1,0,1,6e-06,31
uplegisassembly.gov.in/ENGLISH/governor_current.htm,,1,0,1,6e-06,31
wordpandit.com/list-highest-mountain-peaks-state-wise/,,1,0,1,6e-06,31
web.archive.org/web/20230324212911/https://wordpandit.com/list-highest-mountain-peaks-state-wise/,,1,0,1,6e-06,31
web.archive.org/web/20161115133948/http://nclm.nic.in/shared/linkimages/NCLM52ndReport.pdf,,1,0,1,6e-06,31
rbidocs.rbi.org.in/rdocs/Publications/PDFs/0HBS19112022_FLFE4F2F9158294692B030A251E00555F8.PDF,,1,0,1,6e-06,31
globaldatalab.org/shdi/table/shdi/IND/,,1,0,1,6e-06,31
mospi.gov.in/sites/default/files/publication_reports/AnnualReport_PLFS2023-24L2.pdf,,1,0,1,6e-06,31
main.mohfw.gov.in/basicpage-14,,1,0,1,6e-06,31
web.archive.org/web/20230108164803/https://main.mohfw.gov.in/basicpage-14,,1,0,1,6e-06,31
britannica.com/place/Uttar-Pradesh,,1,0,1,6e-06,31
web.archive.org/web/20200401072447/https://www.britannica.com/place/Uttar-Pradesh,,1,0,1,6e-06,31
niti.gov.in/planningcommission.gov.in/docs/plans/stateplan/upsdr/vol-2/Chap_b1.pdf,,1,0,1,6e-06,31
traveldreams.in/uttarakhand/,,1,0,1,6e-06,31
books.google.com/books?id=gMoJj-0Z94UC&pg=PA69,,1,0,1,6e-06,31
en.wikipedia.org/wiki/Special:BookSources/9004075127,,1,0,1,6e-06,31
web.archive.org/web/20180303134041/https://books.google.com/books?id=gMoJj-0Z94UC&pg=PA69,,1,0,1,6e-06,31
books.google.com/books?id=r4s-YsP6vcIC&pg=PA58,,1,0,1,6e-06,31
en.wikipedia.org/wiki/Special:BookSources/052128550X,,1,0,1,6e-06,31
web.archive.org/web/20170325035117/https://books.google.com/books?id=r4s-YsP6vcIC&pg=PA58,,1,0,1,6e-06,31
books.google.com/books?id=35DP1Z-2dnYC&pg=PA96,,1,0,1,6e-06,31
en.wikipedia.org/wiki/Special:BookSources/978-0861320882,,1,0,1,6e-06,31
web.archive.org/web/20170324205017/https://books.google.com/books?id=35DP1Z-2dnYC&pg=PA96,,1,0,1,6e-06,31
ui.adsabs.harvard.edu/abs/2008QSRv...27..391G,,1,0,1,6e-06,31
doi.org/10.1016%2Fj.quascirev.2007.11.001,,1,0,1,6e-06,31
search.worldcat.org/issn/0277-3791,,1,0,1,6e-06,31
api.semanticscholar.org/CorpusID:129392697,,1,0,1,6e-06,31
books.google.com/books?id=W6zQHNavWlsC&pg=PA263,,1,0,1,6e-06,31
en.wikipedia.org/wiki/Special:BookSources/0472110136,,1,0,1,6e-06,31
web.archive.org/web/20170324214237/https://books.google.com/books?id=W6zQHNavWlsC&pg=PA263,,1,0,1,6e-06,31
books.google.com/books?id=r4s-YsP6vcIC&pg=PA119,,1,0,1,6e-06,31
web.archive.org/web/20180303134041/https://books.google.com/books?id=r4s-YsP6vcIC&pg=PA119,,1,0,1,6e-06,31
ias.ac.in/describe/article/jbsc/026/04/0491-0531,,1,0,1,6e-06,31
doi.org/10.1007%2Fbf02704749,,1,0,1,6e-06,31
pubmed.ncbi.nlm.nih.gov/11779962,,1,0,1,6e-06,31
api.semanticscholar.org/CorpusID:26248907,,1,0,1,6e-06,31
web.archive.org/web/20171007171203/http://www.ias.ac.in/describe/article/jbsc/026/04/0491-0531,,1,0,1,6e-06,31
books.google.com/books?id=Wk4_ICH_g1EC&pg=PA105,,1,0,1,6e-06,31
en.wikipedia.org/wiki/Special:BookSources/978-8122411980,,1,0,1,6e-06,31
web.archive.org/web/20130528155843/http://books.google.com/books?id=Wk4_ICH_g1EC&pg=PA105,,1,0,1,6e-06,31
books.google.com/books?id=vvuIp2kqIkMC,,1,0,1,6e-06,31
en.wikipedia.org/wiki/Special:BookSources/978-8120817203,,1,0,1,6e-06,31
web.archive.org/web/20130604213755/http://books.google.com/books?id=vvuIp2kqIkMC,,1,0,1,6e-06,31
books.google.com/books?id=fHLfiOZVzmMC,,1,0,1,6e-06,31
en.wikipedia.org/wiki/Special:BookSources/978-1107005624,,1,0,1,6e-06,31
web.archive.org/web/20130528145049/http://books.google.com/books?id=fHLfiOZVzmMC,,1,0,1,6e-06,31
books.google.com/books?id=V1pQkwIXTG0C&pg=PA331,,1,0,1,6e-06,31
en.wikipedia.org/wiki/Special:BookSources/978-0761476313,,1,0,1,6e-06,31
web.archive.org/web/20130605122741/http://books.google.com/books?id=V1pQkwIXTG0C&pg=PA331,,1,0,1,6e-06,31
books.google.com/books?id=gE7udqBkACwC&pg=PA196,,1,0,1,6e-06,31
en.wikipedia.org/wiki/Special:BookSources/978-8120725034,,1,0,1,6e-06,31
web.archive.org/web/20130528140148/http://books.google.com/books?id=gE7udqBkACwC&pg=PA196,,1,0,1,6e-06,31
archive.org/details/columbiachronolo00john,,1,0,1,6e-06,31
archive.org/details/columbiachronolo00john/page/273,,1,0,1,6e-06,31
en.wikipedia.org/wiki/Special:BookSources/978-0231110044,,1,0,1,6e-06,31
books.google.com/books?id=399UDwAAQBAJ&q=chero+dynasty&pg=PT71,,1,0,1,6e-06,31
en.wikipedia.org/wiki/Special:BookSources/978-9352667697,,1,0,1,6e-06,31
en.wikipedia.org/wiki/Ashirbadi_Lal_Srivastava,,1,0,1,6e-06,31
archive.org/stream/sultanateofdelhi001929mbp,,1,0,1,6e-06,31
web.archive.org/web/20160408110410/https://archive.org/stream/sultanateofdelhi001929mbp,,1,0,1,6e-06,31
books.google.com/books?id=18eABeokpjEC&pg=PA269,,1,0,1,6e-06,31
en.wikipedia.org/wiki/Special:BookSources/978-9231034671,,1,0,1,6e-06,31
web.archive.org/web/20240328162944/https://books.google.com/books?id=18eABeokpjEC&pg=PA269,,1,0,1,6e-06,31
jaunpur.nic.in/tourist-place/atala-masjid/,,1,0,1,6e-06,31
archive.org/details/empireofgreatmug00anne,,1,0,1,6e-06,31
en.wikipedia.org/wiki/Special:BookSources/978-1861891853,,1,0,1,6e-06,31
books.google.com/books?id=VW2HJL689wgC,,1,0,1,6e-06,31
en.wikipedia.org/wiki/Special:BookSources/978-0144001491,,1,0,1,6e-06,31
web.archive.org/web/20130528160214/http://books.google.com/books?id=VW2HJL689wgC,,1,0,1,6e-06,31
books.google.com/books?id=gGKsS-9h4BYC&pg=PA171,,1,0,1,6e-06,31
en.wikipedia.org/wiki/Special:BookSources/978-8126907755,,1,0,1,6e-06,31
web.archive.org/web/20130528155918/http://books.google.com/books?id=gGKsS-9h4BYC&pg=PA171,,1,0,1,6e-06,31
books.google.com/books?id=PVrSYgEACAAJ&q=hindustan+by+mughal,,1,0,1,6e-06,31
en.wikipedia.org/wiki/Special:BookSources/9788174366962,,1,0,1,6e-06,31
books.google.com/books?id=AZdCrUxFAHEC&pg=PA30,,1,0,1,6e-06,31
en.wikipedia.org/wiki/Special:BookSources/978-8120823266,,1,0,1,6e-06,31
web.archive.org/web/20130528153902/http://books.google.com/books?id=AZdCrUxFAHEC&pg=PA30,,1,0,1,6e-06,31
en.wikipedia.org/wiki/Special:BookSources/978-0231127318,,1,0,1,6e-06,31
en.wikipedia.org/wiki/Special:BookSources/978-3825820978,,1,0,1,6e-06,31
books.google.com/books?id=TM7oYBG4M04C&pg=PA240,,1,0,1,6e-06,31
en.wikipedia.org/wiki/Special:BookSources/978-0804745567,,1,0,1,6e-06,31
web.archive.org/web/20130528135332/http://books.google.com/books?id=TM7oYBG4M04C&pg=PA240,,1,0,1,6e-06,31
books.google.com/books?id=UFaGME0XDBkC&q=Naini&pg=PA151,,1,0,1,6e-06,31
en.wikipedia.org/wiki/Special:BookSources/978-8189422820,,1,0,1,6e-06,31
books.google.com/books?id=-SluAAAAMAAJ,,1,0,1,6e-06,31
en.wikipedia.org/wiki/Special:BookSources/978-0143032564,,1,0,1,6e-06,31
web.archive.org/web/20130605164801/http://books.google.com/books?id=-SluAAAAMAAJ,,1,0,1,6e-06,31
books.google.com/books?id=VUNuAAAAMAAJ,,1,0,1,6e-06,31
web.archive.org/web/20130528131217/http://books.google.com/books?id=VUNuAAAAMAAJ,,1,0,1,6e-06,31
books.google.com/books?id=ADZuAAAAMAAJ,,1,0,1,6e-06,31
en.wikipedia.org/wiki/Special:BookSources/978-8121507509,,1,0,1,6e-06,31
web.archive.org/web/20130528140749/http://books.google.com/books?id=ADZuAAAAMAAJ,,1,0,1,6e-06,31
books.google.com/books?id=uIalYaenrTkC,,1,0,1,6e-06,31
en.wikipedia.org/wiki/Special:BookSources/978-0691000435,,1,0,1,6e-06,31
web.archive.org/web/20130528150524/http://books.google.com/books?id=uIalYaenrTkC,,1,0,1,6e-06,31
books.google.com/books?id=ChwRC6hQttoC&pg=PA18,,1,0,1,6e-06,31
en.wikipedia.org/wiki/Special:BookSources/978-0791440872,,1,0,1,6e-06,31
web.archive.org/web/20240328164501/https://books.google.com/books?id=ChwRC6hQttoC&pg=PA18,,1,0,1,6e-06,31
allahabadhighcourt.in/event/AHistoryLucknowBenchPNMathur.pdf,,1,0,1,6e-06,31
books.google.com/books?id=gujNYPcNETMC,,1,0,1,6e-06,31
en.wikipedia.org/wiki/Special:BookSources/978-8126903597,,1,0,1,6e-06,31
web.archive.org/web/20130528143730/http://books.google.com/books?id=gujNYPcNETMC,,1,0,1,6e-06,31
en.wikipedia.org/wiki/Orient_Longman,,1,0,1,6e-06,31
en.wikipedia.org/wiki/Special:BookSources/978-8125025962,,1,0,1,6e-06,31
books.google.com/books?id=7Gmjn63ogDUC,,1,0,1,6e-06,31
en.wikipedia.org/wiki/Special:BookSources/978-8122201307,,1,0,1,6e-06,31
web.archive.org/web/20130528130144/http://books.google.com/books?id=7Gmjn63ogDUC,,1,0,1,6e-06,31
archive.india.gov.in/knowindia/state_uts.php?id=28,,1,0,1,6e-06,31
web.archive.org/web/20150715014814/http://www.archive.india.gov.in/knowindia/state_uts.php?id=28,,1,0,1,6e-06,31
whatisindia.com/issues/uttarpra/uttar_general.html,,1,0,1,6e-06,31
web.archive.org/web/20161012021112/http://www.whatisindia.com/issues/uttarpra/uttar_general.html,,1,0,1,6e-06,31
en.wikipedia.org/wiki/Ananda_Publishers,,1,0,1,6e-06,31
tehelka.com/what-led-to-the-muzaffarnagar-communal-riots/,,1,0,1,6e-06,31
books.google.com/books?id=alRh51xE_v0C&pg=PA391,,1,0,1,6e-06,31
en.wikipedia.org/wiki/Special:BookSources/978-8170225720,,1,0,1,6e-06,31
web.archive.org/web/20170324171535/https://books.google.com/books?id=alRh51xE_v0C&pg=PA391,,1,0,1,6e-06,31
web.archive.org/web/20121215063439/http://upenvis.nic.in/Database/Land_830.aspx,,1,0,1,6e-06,31
upenvis.nic.in/Database/Land_830.aspx,,1,0,1,6e-06,31
uponline.in/About/Profile/Geography/index.html,,1,0,1,6e-06,31
web.archive.org/web/20120723070728/http://www.uponline.in/About/Profile/geography/index.html,,1,0,1,6e-06,31
web.archive.org/web/20131226202743/http://www.gecafs.org/publications/Publications/IGP_Paper.pdf,,1,0,1,6e-06,31
gecafs.org/publications/Publications/IGP_Paper.pdf,,1,0,1,6e-06,31
web.archive.org/web/20120406104938/http://zeenews.india.com/state-elections-2012/up/profile.html/2,,1,0,1,6e-06,31
en.wikipedia.org/wiki/Zee_news,,1,0,1,6e-06,31
zeenews.india.com/state-elections-2012/up/profile.html/2,,1,0,1,6e-06,31
jagranjosh.com/general-knowledge/list-of-major-canals-and-dams-in-uttar-pradesh-1534427496-1,,1,0,1,6e-06,31
web.archive.org/web/20220401145006/https://thehaider.com/4.2.1.pdf,,1,0,1,6e-06,31
thehaider.com/4.2.1.pdf,,1,0,1,6e-06,31
jagranjosh.com/general-knowledge/the-great-plains-of-india-1448281967-1,,1,0,1,6e-06,31
jstor.org/stable/4365953,,1,0,1,6e-06,31
web.archive.org/web/20211030043546/https://www.jstor.org/stable/4365953,,1,0,1,6e-06,31
books.google.com/books?id=I2fQDwAAQBAJ&pg=PT6,,1,0,1,6e-06,31
web.archive.org/web/20240328164948/https://books.google.com/books?id=I2fQDwAAQBAJ&pg=PT6,,1,0,1,6e-06,31
economictimes.indiatimes.com/topiclist/Rivers-of-Uttar-Pradesh,,1,0,1,6e-06,31
web.archive.org/web/20121005143046/http://amsglossary.allenpress.com/glossary/preface2,,1,0,1,6e-06,31
amsglossary.allenpress.com/glossary/preface2,,1,0,1,6e-06,31
farmech.dac.gov.in/FarmerGuide/UP/index1.html,,1,0,1,6e-06,31
web.archive.org/web/20210516065713/https://www.farmech.dac.gov.in/FarmerGuide/UP/index1.html,,1,0,1,6e-06,31
web.archive.org/web/20120213084300/http://irrigation.up.nic.in/aboutus_irrigation_potential.htm,,1,0,1,6e-06,31
irrigation.up.nic.in/aboutus_irrigation_potential.htm,,1,0,1,6e-06,31
web.archive.org/web/20120712214139/http://amsglossary.allenpress.com/glossary/preface1,,1,0,1,6e-06,31
amsglossary.allenpress.com/glossary/preface1,,1,0,1,6e-06,31
books.google.com/books?id=SX7ML4-0oGQC&pg=PA102,,1,0,1,6e-06,31
en.wikipedia.org/wiki/Special:BookSources/978-8173870811,,1,0,1,6e-06,31
web.archive.org/web/20130528155028/http://books.google.com/books?id=SX7ML4-0oGQC&pg=PA102,,1,0,1,6e-06,31
books.google.com/books?id=_ce8FpJzR-4C&pg=PA26,,1,0,1,6e-06,31
en.wikipedia.org/wiki/Special:BookSources/978-8174824080,,1,0,1,6e-06,31
web.archive.org/web/20130605095943/http://books.google.com/books?id=_ce8FpJzR-4C&pg=PA26,,1,0,1,6e-06,31
web.archive.org/web/20121115211430/http://upenvis.nic.in/Database/Climate_861.aspx,,1,0,1,6e-06,31
upenvis.nic.in/Database/Climate_861.aspx,,1,0,1,6e-06,31
books.google.com/books?id=IAPKG4LEBbQC,,1,0,1,6e-06,31
en.wikipedia.org/wiki/Special:BookSources/978-81-203-3300-0,,1,0,1,6e-06,31
timesofindia.indiatimes.com/india/Met-dept-blames-it-on-western-disturbance/articleshow/1600979.cms,,1,0,1,6e-06,31
web.archive.org/web/20120501134209/http://125.21.185.44/citywx/city_weather1.php?id=42369,,1,0,1,6e-06,31
125.21.185.44/citywx/city_weather1.php?id=42369,,1,0,1,6e-06,31
pannatigerreserve.in/kids/state.htm,,1,0,1,6e-06,31
web.archive.org/web/20141013002319/http://www.pannatigerreserve.in/kids/state.htm,,1,0,1,6e-06,31
uptourism.gov.in/pages/top/experience/top-experience-music-and-dance,,1,0,1,6e-06,31
web.archive.org/web/20130120145111/http://www.upforestcorporation.in/Default.aspx,,1,0,1,6e-06,31
web.archive.org/web/20131107201030/http://www.fsi.org.in/cover_2011/uttarapradesh.pdf,,1,0,1,6e-06,31
fsi.org.in/cover_2011/uttarapradesh.pdf,,1,0,1,6e-06,31
upsbdb.org/diversity-of-up.php,,1,0,1,6e-06,31
web.archive.org/web/20190705034421/http://upsbdb.org/diversity-of-up.php,,1,0,1,6e-06,31
web.archive.org/web/20090506192204/http://bsienvis.nic.in/medi.htm,,1,0,1,6e-06,31
bsienvis.nic.in/medi.htm,,1,0,1,6e-06,31
web.archive.org/web/20120704191031/http://www.up-tourism.com/destination/wild_life/wild_life.htm,,1,0,1,6e-06,31
up-tourism.com/destination/wild_life/wild_life.htm,,1,0,1,6e-06,31
up-tourism.com/destination/wild_life/places_of_interest.htm,,1,0,1,6e-06,31
web.archive.org/web/20120520140217/http://upgov.nic.in/upwealth.aspx,,1,0,1,6e-06,31
upgov.nic.in/upwealth.aspx,,1,0,1,6e-06,31
web.archive.org/web/20121115214704/http://upenvis.nic.in/Database/Forest_838.aspx,,1,0,1,6e-06,31
upenvis.nic.in/Database/Forest_838.aspx,,1,0,1,6e-06,31
ww.orientalbirdclub.org/publications/forktail/14pdfs/Javed-Dudwa.pdf,,1,0,1,6e-06,31
upforest.gov.in/StaticPages/bakhirabird_Home.aspx,,1,0,1,6e-06,31
web.archive.org/web/20170204170352/http://upforest.gov.in/StaticPages/bakhirabird_Home.aspx,,1,0,1,6e-06,31
web.archive.org/web/20170101110955/http://www.nationalchambalsanctuary.in/,,1,0,1,6e-06,31
nationalchambalsanctuary.in/,,1,0,1,6e-06,31
uptourism.gov.in/pages/top/explore/top-explore-chandra-prabha,,1,0,1,6e-06,31
upforest.gov.in/STATICpages/hastinapurwild_Home.aspx,,1,0,1,6e-06,31
web.archive.org/web/20170204170724/http://upforest.gov.in/STATICpages/hastinapurwild_Home.aspx,,1,0,1,6e-06,31
upforest.gov.in/StaticPages/kaimoorwildlife_Home.aspx,,1,0,1,6e-06,31
web.archive.org/web/20170204171033/http://upforest.gov.in/StaticPages/kaimoorwildlife_Home.aspx,,1,0,1,6e-06,31
upforest.gov.in/STATICpages/okhlabird_Home.aspx,,1,0,1,6e-06,31
web.archive.org/web/20170204171135/http://upforest.gov.in/STATICpages/okhlabird_Home.aspx,,1,0,1,6e-06,31
books.google.com/books?id=0UeDTX6HEK8C&pg=PA61,,1,0,1,6e-06,31
en.wikipedia.org/wiki/Special:BookSources/978-8131302941,,1,0,1,6e-06,31
web.archive.org/web/20130523073400/http://books.google.com/books?id=0UeDTX6HEK8C&pg=PA61,,1,0,1,6e-06,31
zsi.gov.in/right_menu/Annual%20Meeting/Annual%20Meeting%202011-12/HQ/Fauna.pdf,,1,0,1,6e-06,31
web.archive.org/web/20120510202421/http://india.gov.in/knowindia/districts/andhra1.php?stateid=UP,,1,0,1,6e-06,31
india.gov.in/knowindia/districts/andhra1.php?stateid=UP,,1,0,1,6e-06,31
census2011.co.in/district.php,,2,0,2,6e-06,31
web.archive.org/web/20110611224943/http://www.census2011.co.in/district.php,,1,0,1,6e-06,31
panchayatiraj.up.nic.in/Acts%20And%20Rules%20Pdfs/Panchayat%20Raj%20Act_1947_ch4.38-50.pdf,,1,0,1,6e-06,31
panchayatiraj.up.nic.in/Acts%20And%20Rules%20Pdfs/Panchayat%20Raj%20Act_1947_ch6.57-70.pdf,,1,0,1,6e-06,31
indianexpress.com/news/panels-to-draft-development-plans-for-13-cities/674326/,,1,0,1,6e-06,31
urbanindia.nic.in/theministry/subordinateoff/tcpo/AREA_POP/CHAPTER-4.PDF,,1,0,1,6e-06,31
censusindia.gov.in/2011-prov-results/prov_data_products_up.html,,1,0,1,6e-06,31
cag.gov.in/uploads/download_audit_report/2021/5%20CHAPTER%20I-063076629450a19.40071813.pdf,,1,0,1,6e-06,31
indiacode.nic.in/bitstream/123456789/16228/1/Municipality_1916.pdf,,1,0,1,6e-06,31
janaagraha.org/asics/report/Uttar-Pradesh-Uttarakhand-Municipal-Corporation-Act-1959.pdf,,1,0,1,6e-06,31
sec.up.nic.in/acts_rules/MUNICIPAL%20CORPORATION_1959_eng/Municipal_Corp_Act_1959_chap1.pdf,,1,0,1,6e-06,31
web.archive.org/web/20170812211441/http://www.noidaauthorityonline.com/UPIndAreaDevp.pdf,,2,0,2,6e-06,31
noidaauthorityonline.com/UPIndAreaDevp.pdf,,2,0,2,6e-06,31
greaternoida.com/files/attachments/inddevact.pdf,,1,0,1,6e-06,31
web.archive.org/web/20150511075823/http://www.greaternoida.com/files/attachments/inddevact.pdf,,1,0,1,6e-06,31
thehindu.com/todays-paper/article2631472.ece,,1,0,1,6e-06,31
web.archive.org/web/20140112191630/http://www.thehindu.com/todays-paper/article2631472.ece,,1,0,1,6e-06,31
thehindu.com/news/national/religious-communities-census-2011-what-the-numbers-say/article7582284.ece,,1,0,1,6e-06,31
web.archive.org/web/20210224155157/https://www.censusindia.gov.in/2011Census/Language_MTs.html,,1,0,1,6e-06,31
web.archive.org/web/20121215062041/http://upenvis.nic.in/Database/Overview_847.aspx,,1,0,1,6e-06,31
upenvis.nic.in/Database/Overview_847.aspx,,1,0,1,6e-06,31
censusindia.gov.in/2011-prov-results/paper2/data_files/UP/7-pop-12-22.pdf,,1,0,1,6e-06,31
up.gov.in/upstateglance.aspx,,1,0,1,6e-06,31
web.archive.org/web/20170412224507/http://www.up.gov.in/upstateglance.aspx,,1,0,1,6e-06,31
censusindia.gov.in/Census_And_You/scheduled_castes_and_sceduled_tribes.aspx,,1,0,1,6e-06,31
documents.worldbank.org/curated/en/467821468035383950/pdf/IPP7630P14786400Box385405B00PUBLIC0.pdf,,1,0,1,6e-06,31
planningcommission.gov.in/data/datatable/data_2312/DatabookDec2014%20307.pdf,,1,0,1,6e-06,31
web.archive.org/web/20090410021912/http://www.cwc.nic.in/Water_Data_Pocket_Book_2006/t9.01final.pdf,,1,0,1,6e-06,31
cwc.nic.in/Water_Data_Pocket_Book_2006/t9.01final.pdf,,1,0,1,6e-06,31
pib.nic.in/newsite/erelease.aspx?relid=49731,,1,0,1,6e-06,31
web.archive.org/web/20130208074013/http://pib.nic.in/newsite/erelease.aspx?relid=49731,,1,0,1,6e-06,31
web.archive.org/web/20140628120737/http://planningcommission.nic.in/news/pre_pov2307.pdf,,1,0,1,6e-06,31
planningcommission.nic.in/news/pre_pov2307.pdf,,1,0,1,6e-06,31
jagranjosh.com/general-knowledge/per-capita-income-of-indian-states-1468997157-1,,1,0,1,6e-06,31
deccanherald.com/content/497347/muslim-population-grew-faster-census.html,,1,0,1,6e-06,31
censusindia.gov.in/2011census/censusinfodashboard/stock/profiles/en/IND009_Uttar%20Pradesh.pdf,,1,0,1,6e-06,31
censusmp.gov.in/censusmp/All-PDF/6Literacy21.12.pdf,,1,0,1,6e-06,31
web.archive.org/web/20120417110338/http://censusmp.gov.in/censusmp/All-PDF/6Literacy21.12.pdf,,1,0,1,6e-06,31
census2011.co.in/census/state/uttar+pradesh.html,,1,0,1,6e-06,31
web.archive.org/web/20110430133506/http://www.census2011.co.in/census/state/uttar+pradesh.html,,1,0,1,6e-06,31
books.google.com/books?id=4D44EAAAQBAJ&dq=bhojpuri+second+language+uttar+pradesh&pg=PA117,,1,0,1,6e-06,31
en.wikipedia.org/wiki/Special:BookSources/978-93-90486-72-4,,1,0,1,6e-06,31
censusindia.gov.in/2011Census/C-16_25062018_NEW.pdf,,2,0,2,6e-06,31
web.archive.org/web/20181114073412/http://www.censusindia.gov.in/2011Census/C-16_25062018_NEW.pdf,,1,0,1,6e-06,31
web.archive.org/web/20160417175655/http://legislativebodiesinindia.nic.in/UttarPradesh-LC.htm,,1,0,1,6e-06,31
legislativebodiesinindia.nic.in/UttarPradesh-LC.htm,,1,0,1,6e-06,31
web.archive.org/web/20160417175232/http://legislativebodiesinindia.nic.in/UTTAR%20PRADESH.htm,,1,0,1,6e-06,31
legislativebodiesinindia.nic.in/UTTAR%20PRADESH.htm,,1,0,1,6e-06,31
aljazeera.com/news/asia/2012/02/2012286478579763.html,,1,0,1,6e-06,31
en.wikipedia.org/wiki/Al_Jazeera_Arabic,,1,0,1,6e-06,31
web.archive.org/web/20120210194222/http://www.aljazeera.com/news/asia/2012/02/2012286478579763.html,,1,0,1,6e-06,31
books.google.com/books?id=fRqrO0Hx0Y0C&pg=PA37,,1,0,1,6e-06,31
en.wikipedia.org/wiki/Special:BookSources/978-8171001934,,1,0,1,6e-06,31
web.archive.org/web/20130528132659/http://books.google.com/books?id=fRqrO0Hx0Y0C&pg=PA37,,1,0,1,6e-06,31
web.archive.org/web/20160305020442/http://rajyasabha.nic.in/rsnew/rsat_work/chapter-2.pdf,,1,0,1,6e-06,31
rajyasabha.nic.in/rsnew/rsat_work/chapter-2.pdf,,1,0,1,6e-06,31
web.archive.org/web/20170407230227/http://www.upgovernor.gov.in/upgovernor.gov.in/roleofgov.htm,,1,0,1,6e-06,31
upgovernor.gov.in/upgovernor.gov.in/roleofgov.htm,,1,0,1,6e-06,31
en.wikipedia.org/wiki/Special:BookSources/978-8125019886,,1,0,1,6e-06,31
forest.uk.gov.in/uploads/fbd/1637060091.pdf,,1,0,1,6e-06,31
mapsofindia.com/uttar-pradesh/local-government/judiciary.html,,1,0,1,6e-06,31
allahabadhighcourt.in/rules/TheUttarPradeshJudicialServiceRules2001.pdf,,1,0,1,6e-06,31
allahabadhighcourt.in/event/TheHistoryRoleSubordinateJudiciaryBBPrasad.pdf,,1,0,1,6e-06,31
frontline.thehindu.com/cover-story/social-apartheid-is-the-norm/article32882917.ece,,1,0,1,6e-06,31
web.archive.org/web/20120524062808/http://zeenews.india.com/state-elections-2012/up/issues.html,,1,0,1,6e-06,31
zeenews.india.com/state-elections-2012/up/issues.html,,1,0,1,6e-06,31
ndtv.com/india-news/communal-violence-goes-up-in-country-uttar-pradesh-still-tops-list-1823917,,1,0,1,6e-06,31
sbi.co.in/documents/13958/14472/Ecowrap_20190308.pdf,,1,0,1,6e-06,31
web.archive.org/web/20200406004223/https://sbi.co.in/documents/13958/14472/Ecowrap_20190308.pdf,,1,0,1,6e-06,31
hdr.undp.org/sites/default/files/india_uttar_pradesh_2007.pdf,,1,0,1,6e-06,31
web.archive.org/web/20111110085726/http://ncrb.nic.in/CII2010/cii-2010/Chapter%2017.pdf,,1,0,1,6e-06,31
ncrb.nic.in/CII2010/cii-2010/Chapter%2017.pdf,,1,0,1,6e-06,31
uppolice.gov.in/pages/en/topmenu/about-us/en-general-information,,1,0,1,6e-06,31
indianexpress.com/article/india/up-road-accidents-up-6-5-this-yr-fatalities-rise-4-9051922/,,1,0,1,6e-06,31
zeenews.india.com/news/uttar-pradesh/delhi-blast-raid-at-huji-militant-s-house-in-up_730458.html,,1,0,1,6e-06,31
in.rediff.com/news/2006/mar/07up.htm,,1,0,1,6e-06,31
web.archive.org/web/20160809032928/http://in.rediff.com/news/2006/mar/07up.htm,,1,0,1,6e-06,31
ndtv.com/article/india/varanasi-blast-18-month-old-killed-25-injured-71186,,1,0,1,6e-06,31
web.archive.org/web/20120126061742/http://www.hindu.com/2007/11/25/stories/2007112555861000.htm,,1,0,1,6e-06,31
hindu.com/2007/11/25/stories/2007112555861000.htm,,1,0,1,6e-06,31
web.archive.org/web/20080304213229/http://www.hindu.com/2007/12/26/stories/2007122653691200.htm,,1,0,1,6e-06,31
hindu.com/2007/12/26/stories/2007122653691200.htm,,1,0,1,6e-06,31
thesundayindian.com/en/story/massive-terror-attacks-in-india-in-the-last-20-years/14/26333/,,1,0,1,6e-06,31
en.wikipedia.org/wiki/Yahoo,,1,0,1,6e-06,31
in.news.yahoo.com/chronology-recent-terror-attacks-india-153913362.html,,1,0,1,6e-06,31
timesofindia.indiatimes.com/city/kanpur/freak-blast-sets-panic-alarm-ringing/articleshow/4230409.cms,,1,0,1,6e-06,31
rbidocs.rbi.org.in/rdocs/Publications/PDFs/27T_15112023E301A02422494F73BFAFD6CDD84EEEAE.PDF,,1,0,1,6e-06,31
ibef.org/download/Uttar%20Pradesh-November-2015.pdf,,1,0,1,6e-06,31
web.archive.org/web/20180921230048/https://www.ibef.org/download/Uttar%20Pradesh-November-2015.pdf,,1,0,1,6e-06,31
indiansugar.com/NewsDetails.aspx?nid=4584,,1,0,1,6e-06,31
web.archive.org/web/20160826083928/http://www.indiansugar.com/NewsDetails.aspx?nid=4584,,1,0,1,6e-06,31
web.archive.org/web/20120530154018/http://www.ijest.info/docs/IJEST10-02-07-13.pdf,,1,0,1,6e-06,31
web.archive.org/web/20121116014458/http://www.upfcindia.com/rti/manual-vi.pdf,,1,0,1,6e-06,31
upfcindia.com/rti/manual-vi.pdf,,1,0,1,6e-06,31
web.archive.org/web/20121116014535/http://www.upfcindia.com/rti/manual-xi.pdf,,1,0,1,6e-06,31
upfcindia.com/rti/manual-xi.pdf,,1,0,1,6e-06,31
timesofindia.indiatimes.com/city/pune/state-slipping-into-debt-burden/articleshow/8840055.cms,,1,0,1,6e-06,31
censusindia.gov.in/Data_Products/Data_Highlights/Data_Highlights_link/data_highlights_D1D2D3.pdf,,1,0,1,6e-06,31
ngji.in/index.php/ngji/article/view/299,,1,0,1,6e-06,31
doi.org/10.48008%2Fngji.1789,,1,0,1,6e-06,31
search.worldcat.org/issn/0027-9374,,1,0,1,6e-06,31
ibef.org/download/Uttar_Pradesh_060710.pdf,,1,0,1,6e-06,31
web.archive.org/web/20130510142802/http://www.ibef.org/download/Uttar_Pradesh_060710.pdf,,1,0,1,6e-06,31
moneycontrol.com/news/economy/only-5-states-exceed-11th-plan-growth-targets-govt_584266.html,,1,0,1,6e-06,31
en.wikipedia.org/wiki/CNBC,,3,0,3,6e-06,31
rbi.org.in/scripts/BS_PressReleaseDisplay.aspx?prid=22105,,1,0,1,6e-06,31
mospi.nic.in/Mospi_New/upload/State_wise_SDP_2004-05_14mar12.pdf,,1,0,1,6e-06,31
web.archive.org/web/20090410141303/http://indiabudget.nic.in/ub2004-05(I)/eb/sbe84.pdf,,1,0,1,6e-06,31
indiabudget.nic.in/ub2004-05(I)/eb/sbe84.pdf,,1,0,1,6e-06,31
web.archive.org/web/20120814075641/http://lko.railnet.gov.in/,,1,0,1,6e-06,31
lko.railnet.gov.in/,,1,0,1,6e-06,31
indianrailways.gov.in/railwayboard/uploads/directorate/stat_econ/IRSP_2015-16/Year_Book_Eng/9.pdf,,1,0,1,6e-06,31
"ncr.indianrailways.gov.in/view_section.jsp?lang=0&id=0,1,396,403",,1,0,1,6e-06,31
ner.indianrailways.gov.in/,,1,0,1,6e-06,31
web.archive.org/web/20110411221732/http://www.ner.indianrailways.gov.in/,,1,0,1,6e-06,31
timesofindia.indiatimes.com/topic/North-Eastern-Railway,,1,0,1,6e-06,31
web.archive.org/web/20130514093655/http://timesofindia.indiatimes.com/topic/North-Eastern-Railway,,1,0,1,6e-06,31
timesofindia.indiatimes.com/topic/Lucknow-New-Delhi-Shatabdi-Express,,1,0,1,6e-06,31
web.archive.org/web/20111014170737/http://dipp.nic.in/English/Investor/Investers_Gudlines/roads.pdf,,1,0,1,6e-06,31
dipp.nic.in/English/Investor/Investers_Gudlines/roads.pdf,,1,0,1,6e-06,31
morth.nic.in/sites/default/files/Basic%20Road%20Statistics%20in%20India-2018-19.pdf,,1,0,1,6e-06,31
ibef.org/download/uttar_pradesh_190111.pdf,,1,0,1,6e-06,31
web.archive.org/web/20120907052302/http://www.ibef.org/download/uttar_pradesh_190111.pdf,,1,0,1,6e-06,31
web.archive.org/web/20160712131932/http://www.upeida.in/project_8.htm,,1,0,1,6e-06,31
upeida.in/project_8.htm,,1,0,1,6e-06,31
planningcommission.nic.in/plans/stateplan/upsdr/vol-2/Chap_b8.pdf,,1,0,1,6e-06,31
web.archive.org/web/20120629091735/http://www.aai.aero/allAirports/varanasi_generalinfo.jsp,,1,0,1,6e-06,31
aai.aero/allAirports/varanasi_generalinfo.jsp,,1,0,1,6e-06,31
dfccil.com/Home/DynemicPages?MenuId=76,,1,0,1,6e-06,31
web.archive.org/web/20200701102211/https://dfccil.com/Home/DynemicPages?MenuId=76,,1,0,1,6e-06,31
hindustantimes.com/india-news/lucknow/up-to-seek-dgca-nod-for-taj-airport/article1-1080013.aspx,,1,0,1,6e-06,31
web.archive.org/web/20140608140626/http://paper.hindustantimes.com/epaper/viewer.aspx,,1,0,1,6e-06,31
paper.hindustantimes.com/epaper/viewer.aspx,,1,0,1,6e-06,31
books.google.com/books?id=9p1cojMJUtkC&pg=PA244,,1,0,1,6e-06,31
en.wikipedia.org/wiki/Special:BookSources/978-0761932697,,1,0,1,6e-06,31
web.archive.org/web/20130604230402/http://books.google.com/books?id=9p1cojMJUtkC&pg=PA244,,1,0,1,6e-06,31
indianexpress.com/news/hapless-victim-of-a-tv-sting-this-hockey-player-is-now-a-rising-star/938634/,,1,0,1,6e-06,31
jagranjosh.com/general-knowledge/uttar-pradesh-sports-1371707833-1,,1,0,1,6e-06,31
rediff.com/cricket/report/ranji-up/20060202.htm,,1,0,1,6e-06,31
web.archive.org/web/20121019103708/http://www.rediff.com/cricket/report/ranji-up/20060202.htm,,1,0,1,6e-06,31
zeenews.india.com/sports/cricket/up-to-get-one-more-cricket-stadium-by-2011_25512.html,,1,0,1,6e-06,31
uttarpradeshfootballsangh.com/kanpur-football-association/,,1,0,1,6e-06,31
uttarpradeshfootballsangh.com/about-us/,,1,0,1,6e-06,31
ibnlive.in.com/news/buddh-circuit-wins-global-award/203294-5-24.html,,1,0,1,6e-06,31
bbc.co.uk/news/business-24659690,,1,0,1,6e-06,31
web.archive.org/web/20131027223718/http://www.bbc.co.uk/news/business-24659690,,1,0,1,6e-06,31
archive.today/20130103081247/http://articles.timesofindia.indiatimes.com/keyword/madrassas,,1,0,1,6e-06,31
articles.timesofindia.indiatimes.com/keyword/madrassas,,1,0,1,6e-06,31
web.archive.org/web/20030421195013/http://upeducation.net/,,1,0,1,6e-06,31
web.archive.org/web/20110403071219/http://www.upeducation.net/facts/,,1,0,1,6e-06,31
nber.org/system/files/working_papers/w20299/w20299.pdf,,1,0,1,6e-06,31
educationinfoindia.com/Universities/U-up.htm,,1,0,1,6e-06,31
web.archive.org/web/20170411015723/http://www.educationinfoindia.com/Universities/U-up.htm,,1,0,1,6e-06,31
web.archive.org/web/20120621081900/http://www.upeducation.net/universities/,,1,0,1,6e-06,31
web.archive.org/web/20120413144029/http://www.iiml.ac.in/,,1,0,1,6e-06,31
rediff.com/getahead/report/career-indias-best-schools-of-2014/20140922.htm,,1,0,1,6e-06,31
web.archive.org/web/20120107225558/http://www.upeducation.net/universities/Integral_University/,,1,0,1,6e-06,31
rrrlf.nic.in/Docs/pdf/PUBLIC_LIBRARY_DATA.pdf,,1,0,1,6e-06,31
library.up.gov.in/Pages/public_library_network/en,,1,0,1,6e-06,31
library.up.gov.in/home/toplibrary/en,,1,0,1,6e-06,31
jagranjosh.com/general-knowledge/list-of-famous-freedom-fighters-from-uttar-pradesh-1536056996-1,,1,0,1,6e-06,31
books.google.com/books?id=_ce8FpJzR-4C&pg=PA46,,1,0,1,6e-06,31
web.archive.org/web/20130528155016/http://books.google.com/books?id=_ce8FpJzR-4C&pg=PA46,,1,0,1,6e-06,31
asci.org.in/journal/Vol.40(2010-11)/40_1_Masood%20H%20Siddiqui.pdf,,1,0,1,6e-06,31
ibef.org/states/uttar-pradesh,,1,0,1,6e-06,31
web.archive.org/web/20230122094328/https://www.ibef.org/states/uttar-pradesh,,1,0,1,6e-06,31
web.archive.org/web/20160827000214/https://whc.unesco.org/en/list/252,,1,0,1,6e-06,31
whc.unesco.org/en/list/251,,1,0,1,6e-06,31
web.archive.org/web/20100717221242/https://whc.unesco.org/en/list/251/,,1,0,1,6e-06,31
whc.unesco.org/en/list/255,,1,0,1,6e-06,31
web.archive.org/web/20110514052508/https://whc.unesco.org/en/list/255,,1,0,1,6e-06,31
en.wikipedia.org/wiki/Special:BookSources/9781119473169,,1,0,1,6e-06,31
search.worldcat.org/oclc/1066742384,,1,0,1,6e-06,31
en.wikipedia.org/wiki/Diana_Eck,,2,0,2,6e-06,31
books.google.com/books?id=r10f4uwzcosC,,1,0,1,6e-06,31
en.wikipedia.org/wiki/Special:BookSources/9780521466257,,1,0,1,6e-06,31
en.wikipedia.org/wiki/Special:BookSources/978-0190123987,,1,0,1,6e-06,31
archive.org/details/indiathroughages00mada/page/176,,1,0,1,6e-06,31
pib.gov.in/PressReleseDetailm.aspx?PRID=1653937,,1,0,1,6e-06,31
en.wikipedia.org/wiki/Special:BookSources/978-3-447-05723-3,,1,0,1,6e-06,31
ayodhya.nic.in/,,1,0,1,6e-06,31
web.archive.org/web/20201108190706/https://ayodhya.nic.in/,,1,0,1,6e-06,31
ayodhya.nic.in/about-district/,,1,0,1,6e-06,31
web.archive.org/web/20191109061219/https://ayodhya.nic.in/about-district/,,1,0,1,6e-06,31
books.google.com/books?id=MALacgnsroMC,,2,0,2,6e-06,31
en.wikipedia.org/wiki/Special:BookSources/978-0195338942,,2,0,2,6e-06,31
web.archive.org/web/20130527022328/http://books.google.com/books?id=MALacgnsroMC,,1,0,1,6e-06,31
web.archive.org/web/20120508235741/http://varanasi.nic.in/tourist/tourist7.html,,1,0,1,6e-06,31
varanasi.nic.in/tourist/tourist7.html,,1,0,1,6e-06,31
books.google.com/books?id=E9YfW2709psC&pg=RA2-PA93,,1,0,1,6e-06,31
en.wikipedia.org/wiki/Special:BookSources/978-0070706453,,1,0,1,6e-06,31
web.archive.org/web/20130528151112/http://books.google.com/books?id=E9YfW2709psC&pg=RA2-PA93,,1,0,1,6e-06,31
jhansi.nic.in/forts/,,1,0,1,6e-06,31
web.archive.org/web/20230323181613/https://jhansi.nic.in/forts/,,1,0,1,6e-06,31
asi.nic.in/jhansi-fort/,,1,0,1,6e-06,31
web.archive.org/web/20231205043357/https://asi.nic.in/jhansi-fort/,,1,0,1,6e-06,31
doi.org/10.4103%2F0019-557X.138624,,1,0,1,6e-06,31
search.worldcat.org/issn/0019-557X,,1,0,1,6e-06,31
pubmed.ncbi.nlm.nih.gov/25116823,,1,0,1,6e-06,31
censusindia.gov.in/vital_statistics/AHSBulletins/AHS_Factsheets_2012-13/FACTSHEET-UTTAR_PRADESH.pdf,,1,0,1,6e-06,31
sansad.in/getFile/loksabhaquestions/annex/171/AU3334.pdf?source=pqals,,1,0,1,6e-06,31
sansad.in/getFile/loksabhaquestions/annex/171/AU3295.pdf?source=pqals,,1,0,1,6e-06,31
sansad.in/getFile/annex/262/AU263.pdf?source=pqars,,1,0,1,6e-06,31
main.mohfw.gov.in/sites/default/files/03Chapter.pdf,,1,0,1,6e-06,31
niti.gov.in/content/maternal-mortality-ratio-mmr-100000-live-births,,1,0,1,6e-06,31
uhrc.in/downloads/Reports/up.pdf,,1,0,1,6e-06,31
web.archive.org/web/20170722150012/http://www.uhrc.in/downloads/Reports/up.pdf,,1,0,1,6e-06,31
wcd.nic.in/sites/default/files/RHS_1.pdf,,1,0,1,6e-06,31
web.archive.org/web/20170829050157/http://wcd.nic.in/sites/default/files/RHS_1.pdf,,1,0,1,6e-06,31
books.google.com/books?id=AIU4LzftaPAC&pg=PA167,,1,0,1,6e-06,31
en.wikipedia.org/wiki/Special:BookSources/978-8175974340,,1,0,1,6e-06,31
web.archive.org/web/20090619093010/http://www.uplegassembly.nic.in/UPLL.HTML,,1,0,1,6e-06,31
uplegassembly.nic.in/UPLL.HTML,,1,0,1,6e-06,31
web.archive.org/web/20190707095531/http://www.lawsofindia.org/pdf/uttar_pradesh/1989/1989UP28.pdf,,1,0,1,6e-06,31
ethnologue.com/show_language.asp?code=bfy,,1,0,1,6e-06,31
web.archive.org/web/20090416015135/http://www.ethnologue.com/show_language.asp?code=bfy,,1,0,1,6e-06,31
books.google.com/books?id=sl_dDVctycgC&dq=Bhojpuri+eastern+indo+aryan+language&pg=PA481,,1,0,1,6e-06,31
en.wikipedia.org/wiki/Special:BookSources/978-0-19-513977-8,,1,0,1,6e-06,31
jagranjosh.com/general-knowledge/list-of-folk-music-of-uttar-pradesh-1531391804-1,,1,0,1,6e-06,31
books.google.com/books?id=nC83DAAAQBAJ&pg=PA100,,1,0,1,6e-06,31
en.wikipedia.org/wiki/Special:BookSources/978-1-317-11737-7,,1,0,1,6e-06,31
doi.org/10.2307%2F1145152,,1,0,1,6e-06,31
jstor.org/stable/1145152,,1,0,1,6e-06,31
jagranjosh.com/general-knowledge/lists-of-states-and-folk-dances-of-india-1466770456-1,,1,0,1,6e-06,31
thestatesman.com/travel/kathak-cultural-gem-uttar-pradesh-1503037669.html,,1,0,1,6e-06,31
web.archive.org/web/20200126222148/http://charkula.com/dance_charkula.asp,,1,0,1,6e-06,31
charkula.com/dance_charkula.asp,,1,0,1,6e-06,31
doi.org/10.2307%2F3591863,,1,0,1,6e-06,31
jstor.org/stable/3591863,,1,0,1,6e-06,31
api.semanticscholar.org/CorpusID:162404242,,1,0,1,6e-06,31
indiatoday.intoday.in/story/why-is-lathmar-holi-celebrated-in-barsana-and-nandgaon/1/624875.html,,1,0,1,6e-06,31
hindustantimes.com/entertainment/the-braj-holi-legend-in-real-life/story-KolfzC30FW5KEZtKs5v9gN.html,,1,0,1,6e-06,31
web.archive.org/web/20120629052417/http://www.up-tourism.com/destination/varanasi/fair_festival.htm,,1,0,1,6e-06,31
up-tourism.com/destination/varanasi/fair_festival.htm,,1,0,1,6e-06,31
uptourism.gov.in/en,,1,0,1,6e-06,31
web.archive.org/web/20230127065629/https://uptourism.gov.in/en,,1,0,1,6e-06,31
e-district.info/,,1,0,1,6e-06,31
ucblibraries.summon.serialssolutions.com/#!/search?ho=t&l=en&q=Uttar%20Pradesh,,1,0,1,6e-06,31
britannica.com/EBchecked/topic/620898,,1,0,1,6e-06,31
commons.wikimedia.org/wiki/Atlas_of_Uttar_Pradesh,,1,0,1,6e-06,31
openstreetmap.org/relation/1942587,,1,0,1,6e-06,31
en.wikipedia.org/wiki/Gandaki_Province,,1,0,1,6e-06,31
en.wikipedia.org/wiki/Template:Uttar_Pradesh_topics,,1,0,1,6e-06,31
en.wikipedia.org/wiki/Template_talk:Uttar_Pradesh_topics,,1,0,1,6e-06,31
en.wikipedia.org/wiki/Special:EditPage/Template:Uttar_Pradesh_topics,,1,0,1,6e-06,31
en.wikipedia.org/wiki/Sunga_Empire,,1,0,1,6e-06,31
en.wikipedia.org/wiki/File:Uttar_Pradesh_locator_map.svg,,1,0,1,6e-06,31
en.wikipedia.org/wiki/File:Taj_Mahal_in_March_2004.jpg,,2,0,2,6e-06,31
en.wikipedia.org/wiki/File:CharBagh_Lucknow.jpg,,1,0,1,6e-06,31
en.wikipedia.org/wiki/Chandra_Prabha_Sanctuary,,1,0,1,6e-06,31
en.wikipedia.org/wiki/Dudhwa_Tiger_Reserve,,5,0,5,7e-06,31
en.wikipedia.org/wiki/Hastinapur_Sanctuary,,1,0,1,6e-06,31
en.wikipedia.org/wiki/Kachhua_Sanctuary,,3,0,3,6e-06,31
en.wikipedia.org/wiki/Kaimoor_Sanctuary,,1,0,1,6e-06,31
en.wikipedia.org/wiki/Katarniaghat_Wildlife_Sanctuary,,4,0,4,7e-06,31
en.wikipedia.org/wiki/Kishanpur_Wildlife_Sanctuary,,4,0,4,7e-06,31
en.wikipedia.org/wiki/Mahavir_Swami_Sanctuary,,2,0,2,7e-06,31
en.wikipedia.org/wiki/Patna_Bird_Sanctuary,,5,0,5,7e-06,31
en.wikipedia.org/wiki/Saman_Sanctuary,,3,0,3,7e-06,31
en.wikipedia.org/wiki/Samaspur_Sanctuary,,1,0,1,6e-06,31
en.wikipedia.org/wiki/Sandi_Bird_Sanctuary,,6,0,6,7e-06,31
en.wikipedia.org/wiki/Sohagi_Barwa_Wildlife_Sanctuary,,4,0,4,7e-06,31
en.wikipedia.org/wiki/Suhelva_Sanctuary,,4,0,4,7e-06,31
en.wikipedia.org/wiki/Vijai_Sagar_Sanctuary,,2,0,2,7e-06,31
en.wikipedia.org/wiki/Uttar_Pradesh_Vidhan_Parishad,,1,0,1,6e-06,31
en.wikipedia.org/wiki/Bhojpuri_literature,,1,0,1,6e-06,31
en.wikipedia.org/wiki/Uttar_Pradesh_cricket_team,,2,0,2,6e-06,31
en.wikipedia.org/wiki/Template:Protected_areas_in_Uttar_Pradesh,,3,0,3,6e-06,31
en.wikipedia.org/wiki/Template_talk:Protected_areas_in_Uttar_Pradesh,,3,0,3,6e-06,31
en.wikipedia.org/wiki/Special:EditPage/Template:Protected_areas_in_Uttar_Pradesh,,3,0,3,6e-06,31
en.wikipedia.org/wiki/Mahavir_Swami_Wildlife_Sanctuary,,3,0,3,6e-06,31
en.wikipedia.org/wiki/Parvati_Arga_Bird_Sanctuary,,4,0,4,7e-06,31
en.wikipedia.org/wiki/Ranipur_Wildlife_Sanctuary,,3,0,3,6e-06,31
en.wikipedia.org/wiki/Saman_Bird_Sanctuary,,5,0,5,7e-06,31
en.wikipedia.org/wiki/Samaspur_Bird_Sanctuary,,6,0,6,7e-06,31
en.wikipedia.org/wiki/Sur_Sarovar_Sanctuary,,3,0,3,6e-06,31
en.wikipedia.org/wiki/Surha_Tal,,3,0,3,6e-06,31
en.wikipedia.org/wiki/Vijai_Sagar_Wildlife_Sanctuary,,3,0,3,6e-06,31
en.wiktionary.org/wiki/Special:Search/Uttar_Pradesh,,1,0,1,6e-06,31
commons.wikimedia.org/wiki/Category:Uttar_Pradesh,,1,0,1,6e-06,31
en.wikisource.org/wiki/Special:Search/Uttar_Pradesh,,1,0,1,6e-06,31
en.wikibooks.org/wiki/Special:Search/Uttar_Pradesh,,1,0,1,6e-06,31
en.wikiversity.org/wiki/Special:Search/Uttar_Pradesh,,1,0,1,6e-06,31
viaf.org/viaf/237706282,,1,0,1,6e-06,31
d-nb.info/gnd/4062226-5,,1,0,1,6e-06,31
id.loc.gov/authorities/n80125998,,1,0,1,6e-06,31
catalogue.bnf.fr/ark:/12148/cb119463735,,1,0,1,6e-06,31
data.bnf.fr/ark:/12148/cb119463735,,1,0,1,6e-06,31
aleph.nkp.cz/F/?func=find-c&local_base=aut&ccl_term=ica=xx0084211&CON_LNG=ENG,,1,0,1,6e-06,31
nli.org.il/en/authorities/987007559777705171,,1,0,1,6e-06,31
musicbrainz.org/area/842ce4dd-4e61-420d-aabf-f3005487ce60,,1,0,1,6e-06,31
trove.nla.gov.au/people/1289683,,1,0,1,6e-06,31
lux.collections.yale.edu/view/place/ff2ae00f-5a8e-4f32-af81-1ad0a6023844,,1,0,1,6e-06,31
en.wikipedia.org/wiki/Category:Countries_and_territories_where_Urdu_is_an_official_language,,1,0,1,6e-06,31
en.wikipedia.org/wiki/Category:States_and_territories_established_in_1950,,1,0,1,6e-06,31
en.wikipedia.org/wiki/Category:States_and_union_territories_of_India,,1,0,1,6e-06,31
en.wikipedia.org/wiki/Category:Articles_containing_potentially_dated_statements_from_2019,,4,0,4,6e-06,31
en.wikipedia.org/wiki/Category:Articles_containing_potentially_dated_statements_from_December_2023,,1,0,1,6e-06,31
en.wikipedia.org/wiki/Category:Articles_with_Encyclopædia_Britannica_links,,1,0,1,6e-06,31
en.m.wikipedia.org/w/index.php?title=Uttar_Pradesh&mobileaction=toggle_view_mobile,,1,0,1,6e-06,31
upload.wikimedia.org/wikipedia/commons/thumb/9/91/IN-UP.svg/330px-IN-UP.svg.png,,1,0,1,6e-06,31
upload.wikimedia.org/wikipedia/commons/thumb/b/b1/SH_IN-UP.png/120px-SH_IN-UP.png,,1,0,1,6e-06,31
upload.wikimedia.org/wikipedia/commons/thumb/8/83/The_barasingha.jpg/60px-The_barasingha.jpg,,1,0,1,6e-06,31
upload.wikimedia.org/wikipedia/commons/thumb/7/78/Field_hockey.jpg/60px-Field_hockey.jpg,,1,0,1,6e-06,31
upload.wikimedia.org/wikipedia/commons/thumb/7/7a/Anandabodhi.jpg/250px-Anandabodhi.jpg,,1,0,1,6e-06,31
upload.wikimedia.org/wikipedia/commons/thumb/7/7b/Tropaeolum_majus.jpg/250px-Tropaeolum_majus.jpg,,1,0,1,6e-06,31
upload.wikimedia.org/wikipedia/commons/thumb/4/4e/Ganges_calling.jpg/250px-Ganges_calling.jpg,,1,0,1,6e-06,31
upload.wikimedia.org/wikipedia/commons/thumb/d/d1/Force_india_Buddh.jpg/250px-Force_india_Buddh.jpg,,1,0,1,6e-06,31
upload.wikimedia.org/wikipedia/commons/thumb/c/c4/District_Hospital.jpg/250px-District_Hospital.jpg,,1,0,1,6e-06,31
upload.wikimedia.org/wikipedia/commons/thumb/8/81/Kurukshetra.jpg/250px-Kurukshetra.jpg,,1,0,1,6e-06,31
upload.wikimedia.org/wikipedia/commons/thumb/4/49/Vegetarian_Curry.jpeg/250px-Vegetarian_Curry.jpeg,,1,0,1,6e-06,31
upload.wikimedia.org/wikipedia/commons/thumb/5/5d/CharBagh_Lucknow.jpg/120px-CharBagh_Lucknow.jpg,,1,0,1,6e-06,31
en.wikipedia.org/wiki/Financial_Times,,4,0,4,6e-06,31
en.wikipedia.org/wiki/Category:Articles_with_dead_external_links_from_December_2024,,6,0,6,7e-06,31
en.wikipedia.org/w/index.php?title=Special:CreateAccount&returnto=Template+talk%3AKanpur,,1,0,1,7e-06,31
en.wikipedia.org/w/index.php?title=Special:UserLogin&returnto=Template+talk%3AKanpur,,1,0,1,7e-06,31
en.wikipedia.org/w/index.php?title=Template_talk:Kanpur&action=edit,,1,0,1,7e-06,31
en.wikipedia.org/w/index.php?title=Template_talk:Kanpur&action=edit&section=new,,1,0,1,7e-06,31
en.wikipedia.org/w/index.php?title=Template_talk:Kanpur&action=history,,1,0,1,7e-06,31
en.wikipedia.org/wiki/Special:WhatLinksHere/Template_talk:Kanpur,,1,0,1,7e-06,31
en.wikipedia.org/wiki/Special:RecentChangesLinked/Template_talk:Kanpur,,1,0,1,7e-06,31
en.wikipedia.org/w/index.php?title=Template_talk:Kanpur&oldid=1232504279,,1,0,1,7e-06,31
en.wikipedia.org/w/index.php?title=Template_talk:Kanpur&action=info,,1,0,1,7e-06,31
en.wikipedia.org/wiki/File:Symbol_template_class_pink.svg,,4,0,4,7e-06,31
en.wikipedia.org/wiki/Category:Template-Class_India_pages,,3,0,3,7e-06,31
en.wikipedia.org/wiki/Category:NA-importance_India_pages,,3,0,3,7e-06,31
en.wikipedia.org/wiki/Category:WikiProject_India_articles,,4,0,4,7e-06,31
en.m.wikipedia.org/w/index.php?title=Template_talk:Kanpur&mobileaction=toggle_view_mobile,,1,0,1,7e-06,31
upload.wikimedia.org/wikipedia/en/thumb/4/41/Flag_of_India.svg/120px-Flag_of_India.svg.png,,5,0,5,7e-06,31
en.wikipedia.org/wiki/Mysore,,6,0,6,7e-06,31
en.wikipedia.org/wiki/Navi_Mumbai,,2,0,2,6e-06,31
en.wikipedia.org/wiki/Category:Use_dmy_dates_from_December_2018,,8,0,8,7e-06,31
en.wikipedia.org/w/index.php?title=Special:CreateAccount&returnto=Template%3AKanpur,,1,0,1,6e-06,31
en.wikipedia.org/w/index.php?title=Special:UserLogin&returnto=Template%3AKanpur,,1,0,1,6e-06,31
ml.wikipedia.org/wiki/ഫലകം:Kanpur,,1,0,1,6e-06,31
wikidata.org/wiki/Special:EntityPage/Q22717769,,1,0,1,6e-06,31
en.wikipedia.org/w/index.php?title=Template:Kanpur&action=edit,,1,0,1,6e-06,31
en.wikipedia.org/w/index.php?title=Template:Kanpur&action=history,,1,0,1,6e-06,31
en.wikipedia.org/wiki/Special:WhatLinksHere/Template:Kanpur,,1,0,1,6e-06,31
en.wikipedia.org/wiki/Special:RecentChangesLinked/Template:Kanpur,,1,0,1,6e-06,31
en.wikipedia.org/w/index.php?title=Template:Kanpur&oldid=1304505967,,1,0,1,6e-06,31
en.wikipedia.org/w/index.php?title=Template:Kanpur&action=info,,1,0,1,6e-06,31
en.wikipedia.org/wiki/Template:Navbox_documentation,,2,0,2,7e-06,31
en.wikipedia.org/wiki/Special:EditPage/Template:Navbox_documentation,,2,0,2,7e-06,31
en.wikipedia.org/wiki/Special:PageHistory/Template:Navbox_documentation,,2,0,2,7e-06,31
en.wikipedia.org/wiki/Special:Purge/Template:Kanpur,,1,0,1,6e-06,31
en.wikipedia.org/wiki/Template:Navbox_visibility,,2,0,2,7e-06,31
en.wikipedia.org/wiki/Template:Navbox,,2,0,2,7e-06,31
en.wikipedia.org/wiki/Template:Sidebar,,2,0,2,7e-06,31
en.m.wikipedia.org/,,2,0,2,7e-06,31
phabricator.wikimedia.org/T124168,,2,0,2,7e-06,31
en.wikipedia.org/w/index.php?title=Template:Navbox_documentation&action=edit&templatedata=edit,,2,0,2,7e-06,31
templatetransclusioncheck.toolforge.org/?lang=en&name=Template:Kanpur,,1,0,1,6e-06,31
en.wikipedia.org/wiki/Special:PrefixIndex/Template:Kanpur/,,1,0,1,6e-06,31
en.wikipedia.org/wiki/Category:Uttar_Pradesh_templates,,1,0,1,6e-06,31
en.wikipedia.org/wiki/Category:India_city_and_town_templates,,1,0,1,6e-06,31
en.m.wikipedia.org/w/index.php?title=Template:Kanpur&mobileaction=toggle_view_mobile,,1,0,1,6e-06,31
en.wikipedia.org/wiki/Category:Articles_needing_additional_references_from_December_2020,,3,0,3,6e-06,31
en.wikipedia.org/wiki/Diabetes,,3,0,3,6e-06,31
en.wikipedia.org/wiki/Vivek_Express,,2,0,2,6e-06,31
en.wikipedia.org/w/index.php?title=Special:CreateAccount&returnto=Siege+of+Cawnpore,,1,0,1,6e-06,31
en.wikipedia.org/w/index.php?title=Special:UserLogin&returnto=Siege+of+Cawnpore,,1,0,1,6e-06,31
de.wikipedia.org/wiki/Belagerung_von_Kanpur,,1,0,1,6e-06,31
gu.wikipedia.org/wiki/કાનપુરનો_ઘેરો,,1,0,1,6e-06,31
he.wikipedia.org/wiki/המצור_על_קאנפור,,1,0,1,6e-06,31
ml.wikipedia.org/wiki/കാൺപൂർ_ഉപരോധം_1857,,1,0,1,6e-06,31
pnb.wikipedia.org/wiki/کان_پون_دا_گھیراو,,1,0,1,6e-06,31
ru.wikipedia.org/wiki/Осада_Канпура,,1,0,1,6e-06,31
sr.wikipedia.org/wiki/Опсада_Канпура,,1,0,1,6e-06,31
fi.wikipedia.org/wiki/Cawnporen_piiritys,,1,0,1,6e-06,31
sv.wikipedia.org/wiki/Belägringen_av_Cawnpore,,1,0,1,6e-06,31
ur.wikipedia.org/wiki/کانپور_کا_محاصرہ,,1,0,1,6e-06,31
wikidata.org/wiki/Special:EntityPage/Q627881,,1,0,1,6e-06,31
en.wikipedia.org/wiki/Talk:Siege_of_Cawnpore,,1,0,1,6e-06,31
en.wikipedia.org/w/index.php?title=Siege_of_Cawnpore&action=edit,,1,0,1,6e-06,31
en.wikipedia.org/w/index.php?title=Siege_of_Cawnpore&action=history,,1,0,1,6e-06,31
en.wikipedia.org/wiki/Special:WhatLinksHere/Siege_of_Cawnpore,,1,0,1,6e-06,31
en.wikipedia.org/wiki/Special:RecentChangesLinked/Siege_of_Cawnpore,,1,0,1,6e-06,31
en.wikipedia.org/w/index.php?title=Siege_of_Cawnpore&oldid=1309823237,,1,0,1,6e-06,31
en.wikipedia.org/w/index.php?title=Siege_of_Cawnpore&action=info,,1,0,1,6e-06,31
en.wikipedia.org/w/index.php?title=Siege_of_Cawnpore&printable=yes,,1,0,1,6e-06,31
commons.wikimedia.org/wiki/Category:Siege_of_Cawnpore,,1,0,1,6e-06,31
en.wikipedia.org/wiki/Tantya_Tope,,2,0,2,6e-06,31
en.wikipedia.org/wiki/Battle_cry,,1,0,1,6e-06,31
en.wikipedia.org/w/index.php?title=Siege_of_Cawnpore&action=edit&section=1,,1,0,1,6e-06,31
en.wikipedia.org/wiki/Sind_Division,,1,0,1,6e-06,31
en.wikipedia.org/wiki/84th_(York_and_Lancaster)_Regiment_of_Foot,,1,0,1,6e-06,31
en.wikipedia.org/wiki/32nd_Regiment_of_Foot,,1,0,1,6e-06,31
en.wikipedia.org/wiki/Magazine_(artillery),,1,0,1,6e-06,31
en.wikipedia.org/wiki/Barracks,,1,0,1,6e-06,31
en.wikipedia.org/wiki/Dragoon,,1,0,1,6e-06,31
en.wikipedia.org/w/index.php?title=Siege_of_Cawnpore&action=edit&section=2,,1,0,1,6e-06,31
en.wikipedia.org/wiki/Fatehgarh,,9,0,9,7e-06,31
en.wikipedia.org/wiki/Magistrate,,1,0,1,6e-06,31
en.wikipedia.org/w/index.php?title=Siege_of_Cawnpore&action=edit&section=3,,1,0,1,6e-06,31
en.wikipedia.org/wiki/Fortification,,1,0,1,6e-06,31
en.wikipedia.org/wiki/Risaldar-Major,,1,0,1,6e-06,31
en.wikipedia.org/wiki/Crossfire,,1,0,1,6e-06,31
en.wikipedia.org/w/index.php?title=Siege_of_Cawnpore&action=edit&section=4,,1,0,1,6e-06,31
en.wikipedia.org/wiki/Maratha_Confederacy,,1,0,1,6e-06,31
en.wikipedia.org/wiki/Dewan,,1,0,1,6e-06,31
en.wikipedia.org/w/index.php?title=Siege_of_Cawnpore&action=edit&section=5,,1,0,1,6e-06,31
en.wikipedia.org/wiki/Sunstroke,,1,0,1,6e-06,31
en.wikipedia.org/wiki/Dysentery,,2,0,2,6e-06,31
en.wikipedia.org/wiki/Smallpox,,1,0,1,6e-06,31
en.wikipedia.org/wiki/File:Savada_Kothi_Kanpur.jpg,,1,0,1,6e-06,31
en.wikipedia.org/wiki/Embrasure,,1,0,1,6e-06,31
en.wikipedia.org/wiki/Sortie,,1,0,1,6e-06,31
en.wikipedia.org/wiki/Round_shot,,1,0,1,6e-06,31
en.wikipedia.org/wiki/Canister_shot,,1,0,1,6e-06,31
en.wikipedia.org/w/index.php?title=Siege_of_Cawnpore&action=edit&section=6,,1,0,1,6e-06,31
en.wikipedia.org/wiki/File:India;_(1909)_(14753085992).jpg,,1,0,1,6e-06,31
en.wikipedia.org/wiki/Sniper,,1,0,1,6e-06,31
en.wikipedia.org/wiki/Bombardment,,1,0,1,6e-06,31
en.wikipedia.org/wiki/Volley_fire_(infantry_tactic),,1,0,1,6e-06,31
en.wikipedia.org/w/index.php?title=Siege_of_Cawnpore&action=edit&section=7,,1,0,1,6e-06,31
en.wikipedia.org/w/index.php?title=Siege_of_Cawnpore&action=edit&section=8,,1,0,1,6e-06,31
en.wikipedia.org/wiki/File:Massacre_Ghat_Kanpur.jpg,,1,0,1,6e-06,31
en.wikipedia.org/wiki/Palanquin,,1,0,1,6e-06,31
en.wikipedia.org/wiki/Satichaura_Ghat,,2,0,2,6e-06,31
en.wikipedia.org/wiki/Bugle_(instrument),,1,0,1,6e-06,31
en.wikipedia.org/wiki/Sandbank,,1,0,1,6e-06,31
en.wikipedia.org/wiki/Matchlock,,1,0,1,6e-06,31
archive.org/details/storycawnpore00thomgoog/page/n9/mode/1up,,1,0,1,6e-06,31
en.wikipedia.org/wiki/Ulrica_Wheeler,,1,0,1,6e-06,31
en.wikipedia.org/wiki/Amelia_Horne,,1,0,1,6e-06,31
en.wikipedia.org/wiki/Eliza_Fanthome,,1,0,1,6e-06,31
en.wikipedia.org/wiki/Anglo-Indian,,3,0,3,6e-06,31
en.wikipedia.org/wiki/Margaret_Frances_Wheeler,,1,0,1,6e-06,31
en.wikipedia.org/wiki/Highland_Brigade_(Scottish),,1,0,1,6e-06,31
en.wikipedia.org/w/index.php?title=Siege_of_Cawnpore&action=edit&section=9,,1,0,1,6e-06,31
en.wikipedia.org/wiki/File:The_Indian_Mutiny_1857-1859_Q112127.jpg,,1,0,1,6e-06,31
en.wikipedia.org/wiki/64th_(2nd_Staffordshire)_Regiment_of_Foot,,1,0,1,6e-06,31
en.wikipedia.org/wiki/78th_Regiment_of_Foot,,1,0,1,6e-06,31
en.wikipedia.org/wiki/5th_Regiment_of_Foot,,1,0,1,6e-06,31
en.wikipedia.org/wiki/90th_Regiment_of_Foot,,1,0,1,6e-06,31
"en.wikipedia.org/wiki/Fatehpur,_Fatehpur",,2,0,2,6e-06,31
en.wikipedia.org/wiki/Flanking_maneuver,,1,0,1,6e-06,31
en.wikipedia.org/wiki/Cleaver_(knife),,1,0,1,6e-06,31
en.wikipedia.org/w/index.php?title=Siege_of_Cawnpore&action=edit&section=10,,1,0,1,6e-06,31
en.wikipedia.org/wiki/Force-feeding,,1,0,1,6e-06,31
en.wikipedia.org/wiki/Scottish_regiment,,1,0,1,6e-06,31
en.wikipedia.org/w/index.php?title=Siege_of_Cawnpore&action=edit&section=11,,1,0,1,6e-06,31
en.wikipedia.org/wiki/Madras_Fusiliers,,1,0,1,6e-06,31
en.wikipedia.org/w/index.php?title=Siege_of_Cawnpore&action=edit&section=12,,1,0,1,6e-06,31
en.wikipedia.org/wiki/File:The_well_as_it_was_in_Cawnpore_in_1860_ILN-1874-1031-0017.jpg,,1,0,1,6e-06,31
en.wikipedia.org/wiki/The_Illustrated_London_News,,1,0,1,6e-06,31
en.wikipedia.org/wiki/Carlo_Marochetti,,2,0,2,6e-06,31
"en.wikipedia.org/wiki/Charlotte_Canning,_Countess_Canning",,1,0,1,6e-06,31
en.wikipedia.org/wiki/Exeter_Cathedral,,1,0,1,6e-06,31
en.wikipedia.org/w/index.php?title=Siege_of_Cawnpore&action=edit&section=13,,1,0,1,6e-06,31
en.wikipedia.org/wiki/Julian_Rathbone,,1,0,1,6e-06,31
en.wikipedia.org/wiki/Philip_Sclater,,1,0,1,6e-06,31
en.wikipedia.org/wiki/Zoological_Society_of_London,,1,0,1,6e-06,31
en.wikipedia.org/w/index.php?title=Siege_of_Cawnpore&action=edit&section=14,,1,0,1,6e-06,31
en.wikipedia.org/wiki/Patharighat,,1,0,1,6e-06,31
en.wikipedia.org/wiki/List_of_massacres_in_India,,1,0,1,6e-06,31
en.wikipedia.org/w/index.php?title=Siege_of_Cawnpore&action=edit&section=15,,1,0,1,6e-06,31
web.archive.org/web/20070805225742/http://www.chilit.org/SAXENA1.HTM,,1,0,1,6e-06,31
chilit.org/SAXENA1.HTM,,1,0,1,6e-06,31
web.archive.org/web/20070928030636/http://www.arklowsc.ie/Club_Details/cawnpore_cup.htm,,1,0,1,6e-06,31
arklowsc.ie/Club_Details/cawnpore_cup.htm,,1,0,1,6e-06,31
britishempire.co.uk/forces/armycampaigns/indiancampaigns/mutiny/cawnpore.htm,,2,0,2,6e-06,31
scribd.com/document/191327780/The-Kanpur-Massacres-in-India-in-the-Revolt-of-1857-pdf,,1,0,1,6e-06,31
financialexpress.com/fe_full_story.php?content_id=160464,,1,0,1,6e-06,31
archive.org/details/storycawnpore00thomgoog/page/n187/mode/1up,,1,0,1,6e-06,31
archive.org/details/greatmutinyindia00hibb/page/194,,1,0,1,6e-06,31
en.wikipedia.org/wiki/Special:BookSources/0-670-34983-6,,1,0,1,6e-06,31
archive.org/details/in.gov.ignca.6048/page/n122/mode/1up?q=ghat,,1,0,1,6e-06,31
en.wikipedia.org/wiki/Special:BookSources/978-0-14-310238-0,,1,0,1,6e-06,31
archive.org/details/penguin1857reade0000unse/page/12/mode/2up?q=Ghat,,1,0,1,6e-06,31
en.wikipedia.org/wiki/Special:BookSources/81-230-0093-6,,1,0,1,6e-06,31
archive.org/details/revoltinhindusta00wood/page/65/mode/1up?q=Massacre,,1,0,1,6e-06,31
archive.org/details/revoltinhindusta00wood/page/n101/mode/1up?q=Massacre,,1,0,1,6e-06,31
archive.org/details/abiographicalsk02brocgoog,,1,0,1,6e-06,31
en.wikipedia.org/wiki/Tauchnitz,,1,0,1,6e-06,31
archive.org/details/abiographicalsk02brocgoog/page/n172,,1,0,1,6e-06,31
archive.org/details/ourbonesarescatt00ward/page/373/mode/1up?q=Bibighar+,,1,0,1,6e-06,31
en.wikipedia.org/wiki/Special:BookSources/978-0-8050-2437-1,,1,0,1,6e-06,31
archive.org/details/in.ernet.dli.2015.51912/page/n149/mode/2up?q=beebeeghur,,1,0,1,6e-06,31
en.wikipedia.org/wiki/Special:BookSources/1-85532-369-9,,1,0,1,6e-06,31
archive.org/details/ahistorysepoywa02kayegoog/page/371/mode/1up,,1,0,1,6e-06,31
archive.org/details/storycawnpore00thomgoog/page/n232/mode/1up?q=Bibi+ghar,,1,0,1,6e-06,31
archive.org/details/kayesmallesonshi02kaye/page/280/mode/1up?q=massacre,,1,0,1,6e-06,31
archive.org/details/ourbonesarescatt00ward/page/414/mode/2up?q=Bibighar+,,1,0,1,6e-06,31
archive.org/details/ourbonesarescatt00ward/page/428/mode/2up?,,1,0,1,6e-06,31
archive.org/details/dli.csl.5424/page/n417/mode/2up?,,1,0,1,6e-06,31
archive.org/details/havelockbyarchib00forb/page/n155/mode/2up?,,1,0,1,6e-06,31
archive.org/details/dli.csl.5424/page/n417/mode/2up?q=massa&view=theater,,1,0,1,6e-06,31
en.wikipedia.org/wiki/Special:BookSources/0-14-004752-2,,2,0,2,6e-06,31
en.wikipedia.org/wiki/Special:BookSources/81-206-0552-7,,1,0,1,6e-06,31
britishempire.co.uk/forces/armycampaigns/indiancampaigns/mutiny/cawnporewell6.htm,,2,0,2,6e-06,31
en.wikipedia.org/wiki/Special:BookSources/978-1-872914-41-1,,1,0,1,6e-06,31
web.archive.org/web/20070928231621/http://www.battlefieldtoursindia.com/indian-mutiny.html,,1,0,1,6e-06,31
battlefieldtoursindia.com/indian-mutiny.html,,1,0,1,6e-06,31
doi.org/10.1017%2F9781009052276,,1,0,1,6e-06,31
en.wikipedia.org/wiki/Special:BookSources/978-1-009052-27-6,,1,0,1,6e-06,31
api.semanticscholar.org/CorpusID:248341742,,1,0,1,6e-06,31
archive.org/details/mutinynovel0000rath,,1,0,1,6e-06,31
en.wikipedia.org/wiki/Special:BookSources/978-0-316-73113-3,,1,0,1,6e-06,31
en.wikipedia.org/wiki/Special:BookSources/978-1-59013-019-3,,1,0,1,6e-06,31
en.wikipedia.org/wiki/Special:BookSources/978-1-61152-270-9,,1,0,1,6e-06,31
philoid.com/epub/ncert/9/119/ihks105,,1,0,1,6e-06,31
archive.org/details/zoologicalsociet00scheuoft,,1,0,1,6e-06,31
archive.org/details/zoologicalsociet00scheuoft/page/167,,1,0,1,6e-06,31
en.wikipedia.org/w/index.php?title=Siege_of_Cawnpore&action=edit&section=16,,1,0,1,6e-06,31
web.archive.org/web/20050510005945/http://www.geocities.com/Broadway/Alley/5443/indmut4.htm,,1,0,1,6e-06,31
britishempire.co.uk/forces/armycampaigns/indiancampaigns/mutiny/cawnporeimages.htm,,1,0,1,6e-06,31
wikidata.org/wiki/Q627881,,1,0,1,6e-06,31
id.loc.gov/authorities/sh95002124,,1,0,1,6e-06,31
nli.org.il/en/authorities/987007539530205171,,1,0,1,6e-06,31
en.wikipedia.org/wiki/Category:Battles_of_the_Indian_Rebellion_of_1857,,2,0,2,6e-06,31
en.wikipedia.org/wiki/Category:Sieges_involving_the_United_Kingdom,,1,0,1,6e-06,31
en.wikipedia.org/wiki/Category:History_of_Uttar_Pradesh,,4,0,4,7e-06,31
en.wikipedia.org/wiki/Category:Massacres_in_India,,1,0,1,6e-06,31
en.wikipedia.org/wiki/Category:Sieges_involving_the_Indian_kingdoms,,1,0,1,6e-06,31
en.wikipedia.org/wiki/Category:June_1857,,1,0,1,6e-06,31
en.wikipedia.org/wiki/Category:Massacres_in_1857,,1,0,1,6e-06,31
en.wikipedia.org/wiki/Category:Use_dmy_dates_from_August_2024,,7,0,7,7e-06,31
en.m.wikipedia.org/w/index.php?title=Siege_of_Cawnpore&mobileaction=toggle_view_mobile,,1,0,1,6e-06,31
en.wikipedia.org/wiki/Category:Use_Indian_English_from_December_2018,,6,0,6,7e-06,31
en.wikipedia.org/wiki/Arun_Kumar_Shukla,,2,0,2,6e-06,31
en.wikipedia.org/wiki/Ram_Charan_Mehrotra,,2,0,2,6e-06,31
en.wikipedia.org/w/index.php?title=Special:CreateAccount&returnto=Second+Battle+of+Cawnpore,,1,0,1,6e-06,31
en.wikipedia.org/w/index.php?title=Special:UserLogin&returnto=Second+Battle+of+Cawnpore,,1,0,1,6e-06,31
ru.wikipedia.org/wiki/Канпурское_сражение,,1,0,1,6e-06,31
sr.wikipedia.org/wiki/Друга_битка_за_Канпур,,1,0,1,6e-06,31
uk.wikipedia.org/wiki/Канпурська_битва,,1,0,1,6e-06,31
wikidata.org/wiki/Special:EntityPage/Q4212577,,1,0,1,6e-06,31
en.wikipedia.org/wiki/Talk:Second_Battle_of_Cawnpore,,1,0,1,6e-06,31
en.wikipedia.org/w/index.php?title=Second_Battle_of_Cawnpore&action=edit,,1,0,1,6e-06,31
en.wikipedia.org/w/index.php?title=Second_Battle_of_Cawnpore&action=history,,1,0,1,6e-06,31
en.wikipedia.org/wiki/Special:WhatLinksHere/Second_Battle_of_Cawnpore,,1,0,1,6e-06,31
en.wikipedia.org/wiki/Special:RecentChangesLinked/Second_Battle_of_Cawnpore,,1,0,1,6e-06,31
en.wikipedia.org/w/index.php?title=Second_Battle_of_Cawnpore&oldid=1306563688,,1,0,1,6e-06,31
en.wikipedia.org/w/index.php?title=Second_Battle_of_Cawnpore&action=info,,1,0,1,6e-06,31
en.wikipedia.org/w/index.php?title=Second_Battle_of_Cawnpore&printable=yes,,1,0,1,6e-06,31
commons.wikimedia.org/wiki/Category:Second_Battle_of_Cawnpore,,1,0,1,6e-06,31
geohack.toolforge.org/geohack.php?pagename=Second_Battle_of_Cawnpore&params=26.449923_N_80.331874_E_,,1,0,1,6e-06,31
en.wikipedia.org/wiki/Special:EditPage/Second_Battle_of_Cawnpore,,1,0,1,6e-06,31
"google.com/search?as_eq=wikipedia&q=""Second+Battle+of+Cawnpore""",,1,0,1,6e-06,31
"google.com/search?tbm=nws&q=""Second+Battle+of+Cawnpore""+-wikipedia&tbs=ar:1",,1,0,1,6e-06,31
"google.com/search?&q=""Second+Battle+of+Cawnpore""&tbs=bkt:s&tbm=bks",,1,0,1,6e-06,31
"google.com/search?tbs=bks:1&q=""Second+Battle+of+Cawnpore""+-wikipedia",,1,0,1,6e-06,31
"scholar.google.com/scholar?q=""Second+Battle+of+Cawnpore""",,1,0,1,6e-06,31
"jstor.org/action/doBasicSearch?Query=""Second+Battle+of+Cawnpore""&acc=on&wc=on",,1,0,1,6e-06,31
"en.wikipedia.org/wiki/File:Plan_of_Battle_of_Cawnpoor,_6_December_1857_(Guyot_%26_Wood).jpg",,1,0,1,6e-06,31
en.wikipedia.org/wiki/File:Flag_of_the_British_East_India_Company_(1801).svg,,1,0,1,6e-06,31
en.wikipedia.org/w/index.php?title=Second_Battle_of_Cawnpore&action=edit&section=1,,1,0,1,6e-06,31
en.wikipedia.org/wiki/Unnao,,5,0,5,7e-06,31
en.wikipedia.org/wiki/Charles_Ash_Windham,,1,0,1,6e-06,31
en.wikipedia.org/wiki/Pontoon_bridge,,1,0,1,6e-06,31
en.wikipedia.org/wiki/Sevastopol,,1,0,1,6e-06,31
en.wikipedia.org/wiki/Jumna_River,,1,0,1,6e-06,31
en.wikipedia.org/w/index.php?title=Second_Battle_of_Cawnpore&action=edit&section=2,,1,0,1,6e-06,31
en.wikipedia.org/w/index.php?title=Second_Battle_of_Cawnpore&action=edit&section=3,,1,0,1,6e-06,31
en.wikipedia.org/w/index.php?title=Second_Battle_of_Cawnpore&action=edit&section=4,,1,0,1,6e-06,31
en.wikipedia.org/wiki/Naval_Brigade,,1,0,1,6e-06,31
en.wikipedia.org/w/index.php?title=Second_Battle_of_Cawnpore&action=edit&section=5,,1,0,1,6e-06,31
en.wikipedia.org/w/index.php?title=Second_Battle_of_Cawnpore&action=edit&section=6,,1,0,1,6e-06,31
en.wikipedia.org/w/index.php?title=Second_Battle_of_Cawnpore&action=edit&section=7,,1,0,1,6e-06,31
en.wikipedia.org/wiki/Thomas_Flynn_(VC),,1,0,1,6e-06,31
en.wikipedia.org/w/index.php?title=Second_Battle_of_Cawnpore&action=edit&section=8,,1,0,1,6e-06,31
en.wikipedia.org/w/index.php?title=Second_Battle_of_Cawnpore&action=edit&section=9,,1,0,1,6e-06,31
defencejournal.com/2000/june/cawnpore.htm,,1,0,1,6e-06,31
en.wikipedia.org/wiki/Category:November_1857,,1,0,1,6e-06,31
en.wikipedia.org/wiki/Category:December_1857,,1,0,1,6e-06,31
en.wikipedia.org/wiki/Category:Articles_needing_additional_references_from_May_2022,,1,0,1,6e-06,31
en.wikipedia.org/wiki/Category:Use_dmy_dates_from_August_2018,,4,0,4,7e-06,31
en.m.wikipedia.org/w/index.php?title=Second_Battle_of_Cawnpore&mobileaction=toggle_view_mobile,,1,0,1,6e-06,31
en.wikipedia.org/wiki/Faxian,,3,0,3,6e-06,31
en.wikipedia.org/wiki/Rice,,3,0,3,7e-06,31
en.wikipedia.org/wiki/District_magistrate,,3,0,3,7e-06,31
en.wikipedia.org/wiki/Category:People_from_Bagpat_district,,3,0,3,7e-06,31
en.wikipedia.org/wiki/Category:University_of_Allahabad_alumni,,3,0,3,7e-06,31
upload.wikimedia.org/wikipedia/en/thumb/9/9e/Flag_of_Japan.svg/40px-Flag_of_Japan.svg.png,,4,0,4,6e-06,31
upload.wikimedia.org/wikipedia/commons/thumb/a/a9/Flag_of_Thailand.svg/40px-Flag_of_Thailand.svg.png,,3,0,3,6e-06,31
en.wikipedia.org/wiki/Category:Articles_with_dead_external_links_from_January_2023,,4,0,4,6e-06,31
en.wikipedia.org/wiki/Category:Articles_with_dead_external_links_from_June_2025,,7,0,7,7e-06,31
en.wikipedia.org/wiki/Member_of_Parliament,,5,0,5,7e-06,31
en.wikipedia.org/wiki/Nehru–Gandhi_family,,3,0,3,7e-06,31
en.wikipedia.org/wiki/MTR,,2,0,2,6e-06,31
en.wikipedia.org/wiki/Portal:History,,2,0,2,7e-06,31
upload.wikimedia.org/wikipedia/commons/thumb/4/48/P_history.svg/40px-P_history.svg.png,,2,0,2,7e-06,31
en.wikipedia.org/w/index.php?title=Special:CreateAccount&returnto=Phool+Bagh,,1,0,1,6e-06,31
en.wikipedia.org/w/index.php?title=Special:UserLogin&returnto=Phool+Bagh,,1,0,1,6e-06,31
es.wikipedia.org/wiki/Ganesh_Shankar_Vidyarthi_Udyan,,1,0,1,6e-06,31
"hi.wikipedia.org/wiki/फूल_बाग,_कानपुर",,1,0,1,6e-06,31
wikidata.org/wiki/Special:EntityPage/Q12439751,,1,0,1,6e-06,31
en.wikipedia.org/wiki/Talk:Phool_Bagh,,1,0,1,6e-06,31
en.wikipedia.org/w/index.php?title=Phool_Bagh&action=edit,,1,0,1,6e-06,31
en.wikipedia.org/w/index.php?title=Phool_Bagh&action=history,,1,0,1,6e-06,31
en.wikipedia.org/wiki/Special:WhatLinksHere/Phool_Bagh,,1,0,1,6e-06,31
en.wikipedia.org/wiki/Special:RecentChangesLinked/Phool_Bagh,,1,0,1,6e-06,31
en.wikipedia.org/w/index.php?title=Phool_Bagh&oldid=1214645915,,1,0,1,6e-06,31
en.wikipedia.org/w/index.php?title=Phool_Bagh&action=info,,1,0,1,6e-06,31
en.wikipedia.org/w/index.php?title=Special:DownloadAsPdf&page=Phool_Bagh&action=show-download-screen,,1,0,1,6e-06,31
en.wikipedia.org/w/index.php?title=Phool_Bagh&printable=yes,,1,0,1,6e-06,31
geohack.toolforge.org/geohack.php?pagename=Phool_Bagh&params=26.467308_N_80.360248_E_type:landmark,,1,0,1,6e-06,31
en.wikipedia.org/wiki/Special:EditPage/Phool_Bagh,,1,0,1,6e-06,31
"google.com/search?as_eq=wikipedia&q=""Phool+Bagh""",,1,0,1,6e-06,31
"google.com/search?tbm=nws&q=""Phool+Bagh""+-wikipedia&tbs=ar:1",,1,0,1,6e-06,31
"google.com/search?&q=""Phool+Bagh""&tbs=bkt:s&tbm=bks",,1,0,1,6e-06,31
"google.com/search?tbs=bks:1&q=""Phool+Bagh""+-wikipedia",,1,0,1,6e-06,31
"scholar.google.com/scholar?q=""Phool+Bagh""",,1,0,1,6e-06,31
"jstor.org/action/doBasicSearch?Query=""Phool+Bagh""&acc=on&wc=on",,1,0,1,6e-06,31
en.wikipedia.org/wiki/City_park,,2,0,2,7e-06,31
en.wikipedia.org/wiki/File:Kanpur_Sangrahalaya.JPG,,3,0,3,7e-06,31
en.wikipedia.org/w/index.php?title=Phool_Bagh&action=edit&section=1,,1,0,1,6e-06,31
en.wikipedia.org/w/index.php?title=Phool_Bagh&action=edit&section=2,,1,0,1,6e-06,31
en.wikipedia.org/w/index.php?title=Phool_Bagh&action=edit&section=3,,1,0,1,6e-06,31
en.wikipedia.org/wiki/Edward_VII_of_the_United_Kingdom,,1,0,1,6e-06,31
en.wikipedia.org/wiki/Royal_prince,,1,0,1,6e-06,31
en.wikipedia.org/w/index.php?title=Phool_Bagh&action=edit&section=4,,1,0,1,6e-06,31
en.wikipedia.org/wiki/Merchant,,1,0,1,6e-06,31
en.wikipedia.org/wiki/Amusement_center,,1,0,1,6e-06,31
en.wikipedia.org/wiki/Memorial,,1,0,1,6e-06,31
en.wikipedia.org/wiki/Wooden,,1,0,1,6e-06,31
en.wikipedia.org/wiki/Soldiers,,1,0,1,6e-06,31
en.wikipedia.org/wiki/World_War,,1,0,1,6e-06,31
en.wikipedia.org/w/index.php?title=K.E.M._Hall&action=edit&redlink=1,,1,0,1,6e-06,31
en.wikipedia.org/wiki/Settler,,1,0,1,6e-06,31
en.wikipedia.org/wiki/Municipal,,1,0,1,6e-06,31
en.wikipedia.org/w/index.php?title=Phool_Bagh&action=edit&section=5,,1,0,1,6e-06,31
en.wikipedia.org/w/index.php?title=Phool_Bagh&action=edit&section=6,,1,0,1,6e-06,31
en.wikipedia.org/w/index.php?title=Phool_Bagh&action=edit&section=7,,1,0,1,6e-06,31
en.wikipedia.org/wiki/Ram_Manohar_Lohia,,2,0,2,7e-06,31
en.wikipedia.org/w/index.php?title=Phool_Bagh&action=edit&section=8,,1,0,1,6e-06,31
en.wikipedia.org/wiki/Category:Gardens_in_Uttar_Pradesh,,1,0,1,6e-06,31
en.wikipedia.org/wiki/Category:Indian_independence_movement_in_Uttar_Pradesh,,1,0,1,6e-06,31
en.wikipedia.org/wiki/Category:Articles_lacking_sources_from_February_2019,,1,0,1,6e-06,31
en.wikipedia.org/wiki/Category:All_articles_lacking_sources,,6,0,6,7e-06,31
en.wikipedia.org/wiki/Category:Use_dmy_dates_from_February_2019,,3,0,3,6e-06,31
en.wikipedia.org/wiki/Category:Use_Indian_English_from_February_2019,,3,0,3,7e-06,31
en.m.wikipedia.org/w/index.php?title=Phool_Bagh&mobileaction=toggle_view_mobile,,1,0,1,6e-06,31
en.wikipedia.org/wiki/GAIL,,5,0,5,7e-06,31
en.wikipedia.org/wiki/Oil_India,,5,0,5,7e-06,31
en.wikipedia.org/wiki/1951–52_Indian_general_election,,4,0,4,7e-06,31
en.wikipedia.org/w/index.php?title=Special:CreateAccount&returnto=Panki+Thermal+Power+Station,,1,0,1,6e-06,31
en.wikipedia.org/w/index.php?title=Special:UserLogin&returnto=Panki+Thermal+Power+Station,,1,0,1,6e-06,31
hi.wikipedia.org/wiki/पनकी_ताप_विद्युत_गृह,,1,0,1,6e-06,31
no.wikipedia.org/wiki/Panki_kraftverk,,1,0,1,6e-06,31
wikidata.org/wiki/Special:EntityPage/Q3445852,,1,0,1,6e-06,31
en.wikipedia.org/wiki/Talk:Panki_Thermal_Power_Station,,1,0,1,6e-06,31
en.wikipedia.org/w/index.php?title=Panki_Thermal_Power_Station&action=edit,,1,0,1,6e-06,31
en.wikipedia.org/w/index.php?title=Panki_Thermal_Power_Station&action=history,,1,0,1,6e-06,31
en.wikipedia.org/wiki/Special:WhatLinksHere/Panki_Thermal_Power_Station,,1,0,1,6e-06,31
en.wikipedia.org/wiki/Special:RecentChangesLinked/Panki_Thermal_Power_Station,,1,0,1,6e-06,31
en.wikipedia.org/w/index.php?title=Panki_Thermal_Power_Station&oldid=1242136599,,1,0,1,6e-06,31
en.wikipedia.org/w/index.php?title=Panki_Thermal_Power_Station&action=info,,1,0,1,6e-06,31
en.wikipedia.org/w/index.php?title=Panki_Thermal_Power_Station&printable=yes,,1,0,1,6e-06,31
en.wikipedia.org/wiki/Tallest_structures_in_India,,1,0,1,6e-06,31
en.wikipedia.org/w/index.php?title=Panki_Thermal_Power_Station&action=edit&section=1,,1,0,1,6e-06,31
en.wikipedia.org/wiki/Bharat_Coking_Coal_Limited,,1,0,1,6e-06,31
en.wikipedia.org/wiki/Eastern_Coalfields_Limited,,1,0,1,6e-06,31
en.wikipedia.org/w/index.php?title=Panki_Thermal_Power_Station&action=edit&section=2,,1,0,1,6e-06,31
en.wikipedia.org/wiki/BHEL,,1,0,1,6e-06,31
en.wikipedia.org/w/index.php?title=Panki_Thermal_Power_Station&action=edit&section=3,,1,0,1,6e-06,31
en.wikipedia.org/wiki/Anpara_Thermal_Power_Station,,2,0,2,7e-06,31
en.wikipedia.org/wiki/Obra_Thermal_Power_Station,,2,0,2,7e-06,31
en.wikipedia.org/wiki/Parichha_Thermal_Power_Station,,2,0,2,7e-06,31
en.wikipedia.org/wiki/Harduaganj_Thermal_Power_Station,,2,0,2,7e-06,31
en.wikipedia.org/w/index.php?title=Panki_Thermal_Power_Station&action=edit&section=4,,1,0,1,6e-06,31
timesofindia.indiatimes.com/city/kanpur/panki-power-plant-ceases-operation/articleshow/62453674.cms,,1,0,1,6e-06,31
web.archive.org/web/20100613053448/http://uprvunl.org/location_panki.htm,,1,0,1,6e-06,31
uprvunl.org/location_panki.htm,,1,0,1,6e-06,31
equitybulls.com/admin/news2006/news_det.asp?id=225352,,1,0,1,6e-06,31
uprvunl.org/site/writereaddata/UploadNews/corrigendum/pdf/C_201905101649143135.pdf,,1,0,1,6e-06,31
en.wikipedia.org/wiki/Template:Power_stations_of_Uttar_Pradesh,,1,0,1,6e-06,31
en.wikipedia.org/wiki/Template_talk:Power_stations_of_Uttar_Pradesh,,1,0,1,6e-06,31
en.wikipedia.org/wiki/Special:EditPage/Template:Power_stations_of_Uttar_Pradesh,,1,0,1,6e-06,31
en.wikipedia.org/wiki/Bara_Thermal_Power_Station,,1,0,1,6e-06,31
en.wikipedia.org/wiki/Feroze_Gandhi_Unchahar_Thermal_Power_Station,,5,0,5,7e-06,31
en.wikipedia.org/wiki/Ghatampur_Thermal_Power_Station,,1,0,1,6e-06,31
en.wikipedia.org/wiki/Jawaharpur_Super_Thermal_Power_Station,,1,0,1,6e-06,31
en.wikipedia.org/wiki/Karchana_Thermal_Power_Station,,1,0,1,6e-06,31
en.wikipedia.org/wiki/Lalitpur_Thermal_Power_Station,,1,0,1,6e-06,31
en.wikipedia.org/wiki/Narora_Atomic_Power_Station,,1,0,1,6e-06,31
en.wikipedia.org/wiki/NTPC_Auraiya,,1,0,1,6e-06,31
en.wikipedia.org/wiki/NTPC_Dadri,,4,0,4,7e-06,31
en.wikipedia.org/wiki/NTPC_Tanda,,1,0,1,6e-06,31
en.wikipedia.org/wiki/Renusagar_Power_Plant,,1,0,1,6e-06,31
en.wikipedia.org/wiki/Rihand_Thermal_Power_Station,,3,0,3,7e-06,31
en.wikipedia.org/wiki/Rosa_Thermal_Power_Plant,,1,0,1,6e-06,31
en.wikipedia.org/wiki/Singrauli_Super_Thermal_Power_Station,,3,0,3,7e-06,31
en.wikipedia.org/wiki/Template:India-powerstation-stub,,1,0,1,6e-06,31
en.wikipedia.org/wiki/Template_talk:India-powerstation-stub,,1,0,1,6e-06,31
en.wikipedia.org/wiki/Special:EditPage/Template:India-powerstation-stub,,1,0,1,6e-06,31
en.wikipedia.org/wiki/Category:Coal-fired_power_stations_in_Uttar_Pradesh,,1,0,1,6e-06,31
en.wikipedia.org/wiki/Category:Energy_infrastructure_completed_in_1977,,1,0,1,6e-06,31
en.wikipedia.org/wiki/Category:Indian_power_station_stubs,,1,0,1,6e-06,31
en.m.wikipedia.org/w/index.php?title=Panki_Thermal_Power_Station&mobileaction=toggle_view_mobile,,1,0,1,6e-06,31
en.wikipedia.org/w/index.php?title=Special:CreateAccount&returnto=Outlook+(Indian+magazine),,1,0,1,7e-06,31
en.wikipedia.org/w/index.php?title=Special:UserLogin&returnto=Outlook+(Indian+magazine),,1,0,1,7e-06,31
as.wikipedia.org/wiki/আউটলুক_(আলোচনী),,1,0,1,7e-06,31
bn.wikipedia.org/wiki/আউটলুক_(পত্রিকা),,1,0,1,7e-06,31
hi.wikipedia.org/wiki/आउटलुक,,1,0,1,7e-06,31
id.wikipedia.org/wiki/Outlook_(majalah_India),,1,0,1,7e-06,31
kn.wikipedia.org/wiki/ಔಟ್ಲುಕ್_(ನಿಯತಕಾಲಿಕೆ),,1,0,1,7e-06,31
ml.wikipedia.org/wiki/ഔട്ട്‌ലുക്_മാഗസിൻ,,1,0,1,7e-06,31
mr.wikipedia.org/wiki/आउटलुक_(भारतीय_नियतकालिक),,1,0,1,7e-06,31
ja.wikipedia.org/wiki/アウトルック_(インドの雑誌),,1,0,1,7e-06,31
pa.wikipedia.org/wiki/﻿ਆਊਟਲੁੱਕ,,1,0,1,7e-06,31
ru.wikipedia.org/wiki/Outlook_(журнал),,1,0,1,7e-06,31
ta.wikipedia.org/wiki/அவுட்லுக்_(இதழ்),,1,0,1,7e-06,31
te.wikipedia.org/wiki/ఔట్‌లుక్_(భారతీయ_పత్రిక),,1,0,1,7e-06,31
ur.wikipedia.org/wiki/آؤٹ_لک,,1,0,1,7e-06,31
wikidata.org/wiki/Special:EntityPage/Q1955600,,1,0,1,7e-06,31
en.wikipedia.org/wiki/Talk:Outlook_(Indian_magazine),,1,0,1,7e-06,31
en.wikipedia.org/w/index.php?title=Outlook_(Indian_magazine)&action=edit,,1,0,1,7e-06,31
en.wikipedia.org/w/index.php?title=Outlook_(Indian_magazine)&action=history,,1,0,1,7e-06,31
en.wikipedia.org/wiki/Special:WhatLinksHere/Outlook_(Indian_magazine),,1,0,1,7e-06,31
en.wikipedia.org/wiki/Special:RecentChangesLinked/Outlook_(Indian_magazine),,1,0,1,7e-06,31
en.wikipedia.org/w/index.php?title=Outlook_(Indian_magazine)&oldid=1299610361,,1,0,1,7e-06,31
en.wikipedia.org/w/index.php?title=Outlook_(Indian_magazine)&action=info,,1,0,1,7e-06,31
en.wikipedia.org/w/index.php?title=Outlook_(Indian_magazine)&printable=yes,,1,0,1,7e-06,31
"en.wikipedia.org/wiki/File:Outlook_(magazine)_india,_17th_anniversary_cover_pic.jpg",,1,0,1,7e-06,31
en.wikipedia.org/wiki/Krishna_Prasad_(journalist),,1,0,1,7e-06,31
en.wikipedia.org/wiki/Vinod_Mehta,,1,0,1,7e-06,31
outlookindia.com/,,1,0,1,7e-06,31
outlookhindi.com/,,1,0,1,7e-06,31
en.wikipedia.org/w/index.php?title=Outlook_(Indian_magazine)&action=edit&section=1,,1,0,1,7e-06,31
en.wikipedia.org/wiki/Editor_in_chief,,1,0,1,7e-06,31
en.wikipedia.org/w/index.php?title=Outlook_(Indian_magazine)&action=edit&section=2,,1,0,1,7e-06,31
en.wikipedia.org/w/index.php?title=Outlook_(Indian_magazine)&action=edit&section=3,,1,0,1,7e-06,31
en.wikipedia.org/w/index.php?title=Outlook_(Indian_magazine)&action=edit&section=4,,1,0,1,7e-06,31
en.wikipedia.org/w/index.php?title=Outlook_(Indian_magazine)&action=edit&section=5,,1,0,1,7e-06,31
en.wikipedia.org/wiki/Tarun_Tejpal,,1,0,1,7e-06,31
en.wikipedia.org/w/index.php?title=Outlook_(Indian_magazine)&action=edit&section=6,,1,0,1,7e-06,31
en.wikipedia.org/wiki/Arundhati_Roy,,2,0,2,7e-06,31
en.wikipedia.org/w/index.php?title=Outlook_(Indian_magazine)&action=edit&section=7,,1,0,1,7e-06,31
outlookindia.com/about-us,,1,0,1,7e-06,31
mruc.net/sites/default/files/IRS%202014%20Topline%20Findings_0.pdf,,1,0,1,7e-06,31
rediff.com/money/2004/feb/20quiz.htm,,1,0,1,7e-06,31
outlookindia.com/pages/privacypolicy,,1,0,1,7e-06,31
worldpress.org/newspapers/ASIA/India.cfm,,1,0,1,7e-06,31
arabnews.com/world/news/715421,,1,0,1,7e-06,31
archive.tehelka.com/commoncode/team/dateam.asp,,1,0,1,7e-06,31
web.archive.org/web/20130728221007/http://archive.tehelka.com/commoncode/team/dateam.asp,,1,0,1,7e-06,31
en.wikipedia.org/w/index.php?title=Outlook_(Indian_magazine)&action=edit&section=8,,1,0,1,7e-06,31
wikidata.org/wiki/Q1955600,,1,0,1,7e-06,31
viaf.org/viaf/156156118,,1,0,1,7e-06,31
id.loc.gov/authorities/n2006173937,,1,0,1,7e-06,31
en.wikipedia.org/wiki/Category:1995_establishments_in_Delhi,,1,0,1,7e-06,31
en.wikipedia.org/wiki/Category:Magazines_established_in_1995,,1,0,1,7e-06,31
en.wikipedia.org/wiki/Category:Magazines_published_in_Delhi,,1,0,1,7e-06,31
en.wikipedia.org/wiki/Category:Use_dmy_dates_from_December_2023,,2,0,2,7e-06,31
en.m.wikipedia.org/w/index.php?title=Outlook_(Indian_magazine)&mobileaction=toggle_view_mobile,,1,0,1,7e-06,31
en.wikipedia.org/wiki/Category:Use_dmy_dates_from_January_2017,,3,0,3,6e-06,31
en.wikipedia.org/wiki/Category:Articles_with_unsourced_statements_from_July_2024,,2,0,2,6e-06,31
en.wikipedia.org/w/index.php?title=Special:CreateAccount&returnto=Noida,,1,0,1,6e-06,31
en.wikipedia.org/w/index.php?title=Special:UserLogin&returnto=Noida,,1,0,1,6e-06,31
ar.wikipedia.org/wiki/نويدا,,1,0,1,6e-06,31
as.wikipedia.org/wiki/নয়দা,,1,0,1,6e-06,31
azb.wikipedia.org/wiki/نویدا,,1,0,1,6e-06,31
bn.wikipedia.org/wiki/নয়ডা,,1,0,1,6e-06,31
zh-min-nan.wikipedia.org/wiki/Noida,,1,0,1,6e-06,31
bh.wikipedia.org/wiki/नोयडा,,1,0,1,6e-06,31
bg.wikipedia.org/wiki/Ноида,,1,0,1,6e-06,31
ca.wikipedia.org/wiki/Noida,,1,0,1,6e-06,31
ceb.wikipedia.org/wiki/Noida,,1,0,1,6e-06,31
cs.wikipedia.org/wiki/Noida,,1,0,1,6e-06,31
de.wikipedia.org/wiki/Noida,,1,0,1,6e-06,31
es.wikipedia.org/wiki/Noida,,1,0,1,6e-06,31
eo.wikipedia.org/wiki/Noida,,1,0,1,6e-06,31
fa.wikipedia.org/wiki/نویدا,,1,0,1,6e-06,31
hif.wikipedia.org/wiki/Noida,,1,0,1,6e-06,31
fr.wikipedia.org/wiki/Noida,,1,0,1,6e-06,31
gu.wikipedia.org/wiki/નોઇડા,,1,0,1,6e-06,31
ko.wikipedia.org/wiki/노이다,,1,0,1,6e-06,31
hi.wikipedia.org/wiki/नोएडा,,1,0,1,6e-06,31
bpy.wikipedia.org/wiki/নোইদা,,1,0,1,6e-06,31
id.wikipedia.org/wiki/Noida,,1,0,1,6e-06,31
it.wikipedia.org/wiki/Noida,,1,0,1,6e-06,31
he.wikipedia.org/wiki/נוידה,,1,0,1,6e-06,31
pam.wikipedia.org/wiki/Noida,,1,0,1,6e-06,31
lld.wikipedia.org/wiki/Noida,,1,0,1,6e-06,31
mg.wikipedia.org/wiki/Noida,,1,0,1,6e-06,31
ml.wikipedia.org/wiki/നോയ്ഡ,,1,0,1,6e-06,31
mr.wikipedia.org/wiki/नोएडा,,1,0,1,6e-06,31
arz.wikipedia.org/wiki/نويدا,,1,0,1,6e-06,31
ms.wikipedia.org/wiki/Noida,,1,0,1,6e-06,31
nl.wikipedia.org/wiki/Noida,,1,0,1,6e-06,31
new.wikipedia.org/wiki/नोइडा,,1,0,1,6e-06,31
ja.wikipedia.org/wiki/ノイダ,,1,0,1,6e-06,31
no.wikipedia.org/wiki/Noida,,1,0,1,6e-06,31
or.wikipedia.org/wiki/ନୋଏଡ଼ା,,1,0,1,6e-06,31
pa.wikipedia.org/wiki/ਨੋਇਡਾ,,1,0,1,6e-06,31
pnb.wikipedia.org/wiki/نوئیڈا,,1,0,1,6e-06,31
ps.wikipedia.org/wiki/نويډا,,1,0,1,6e-06,31
pl.wikipedia.org/wiki/Noida,,1,0,1,6e-06,31
ro.wikipedia.org/wiki/Noida,,1,0,1,6e-06,31
ru.wikipedia.org/wiki/Ноида,,1,0,1,6e-06,31
sa.wikipedia.org/wiki/नोयडा,,1,0,1,6e-06,31
simple.wikipedia.org/wiki/Noida,,1,0,1,6e-06,31
sr.wikipedia.org/wiki/Ноида,,1,0,1,6e-06,31
fi.wikipedia.org/wiki/Noida,,1,0,1,6e-06,31
sv.wikipedia.org/wiki/Noida,,1,0,1,6e-06,31
ta.wikipedia.org/wiki/நொய்டா,,1,0,1,6e-06,31
tt.wikipedia.org/wiki/Нойда,,1,0,1,6e-06,31
te.wikipedia.org/wiki/నోయిడా,,1,0,1,6e-06,31
th.wikipedia.org/wiki/นอยดา,,1,0,1,6e-06,31
tr.wikipedia.org/wiki/Noida,,1,0,1,6e-06,31
uk.wikipedia.org/wiki/Нойда,,1,0,1,6e-06,31
ur.wikipedia.org/wiki/نوئیڈا,,1,0,1,6e-06,31
vi.wikipedia.org/wiki/Noida,,1,0,1,6e-06,31
war.wikipedia.org/wiki/Noida,,1,0,1,6e-06,31
zh.wikipedia.org/wiki/诺伊达,,1,0,1,6e-06,31
tly.wikipedia.org/wiki/Noida,,1,0,1,6e-06,31
wikidata.org/wiki/Special:EntityPage/Q278204,,1,0,1,6e-06,31
en.wikipedia.org/wiki/Talk:Noida,,1,0,1,6e-06,31
en.wikipedia.org/w/index.php?title=Noida&action=edit,,1,0,1,6e-06,31
en.wikipedia.org/w/index.php?title=Noida&action=history,,1,0,1,6e-06,31
en.wikipedia.org/wiki/Special:WhatLinksHere/Noida,,1,0,1,6e-06,31
en.wikipedia.org/wiki/Special:RecentChangesLinked/Noida,,1,0,1,6e-06,31
en.wikipedia.org/w/index.php?title=Noida&oldid=1309270717,,1,0,1,6e-06,31
en.wikipedia.org/w/index.php?title=Noida&action=info,,1,0,1,6e-06,31
en.wikipedia.org/w/index.php?title=Special:QrCode&url=https%3A%2F%2Fen.wikipedia.org%2Fwiki%2FNoida,,1,0,1,6e-06,31
en.wikipedia.org/w/index.php?title=Special:DownloadAsPdf&page=Noida&action=show-download-screen,,1,0,1,6e-06,31
en.wikipedia.org/w/index.php?title=Noida&printable=yes,,1,0,1,6e-06,31
commons.wikimedia.org/wiki/Category:Noida,,1,0,1,6e-06,31
en.wikivoyage.org/wiki/Noida,,1,0,1,6e-06,31
en.wikipedia.org/wiki/File:View_of_Noida_city_from_the_Hilton_Noida.jpg,,1,0,1,6e-06,31
"en.wikipedia.org/wiki/File:IT_Park,_Noida,_Uttar_Pradesh_(2011-06-18)_(2).jpg",,1,0,1,6e-06,31
"en.wikipedia.org/wiki/Sector_62,_Noida",,1,0,1,6e-06,31
en.wikipedia.org/wiki/File:Noidancrdelhiskyline.jpg,,1,0,1,6e-06,31
en.wikipedia.org/wiki/Supernova_Spira,,1,0,1,6e-06,31
en.wikipedia.org/wiki/File:Gautam_Buddha_NagarView_from_Star_Court.jpg,,1,0,1,6e-06,31
en.wikipedia.org/wiki/File:DLF_Mall_of_India.jpg,,1,0,1,6e-06,31
en.wikipedia.org/wiki/Mall_of_India,,1,0,1,6e-06,31
en.wikipedia.org/wiki/File:HCL_Tech_Noida_SEZ_Campus.png,,1,0,1,6e-06,31
en.wikipedia.org/wiki/HCLTech,,2,0,2,6e-06,31
en.wikipedia.org/wiki/File:Noida_Logo.jpg,,1,0,1,6e-06,31
en.wikipedia.org/wiki/File:Noida-brandmark-English.png,,1,0,1,6e-06,31
en.wikipedia.org/wiki/Brandmark,,1,0,1,6e-06,31
en.wikipedia.org/wiki/Country,,3,0,3,6e-06,31
en.wikipedia.org/wiki/Meerut_Division,,1,0,1,6e-06,31
en.wikipedia.org/wiki/Gautam_Buddha_Nagar_Lok_Sabha_constituency,,9,0,9,7e-06,31
noidaauthorityonline.in/,,1,0,1,6e-06,31
en.wikipedia.org/wiki/Okhla,,4,0,4,6e-06,31
en.wikipedia.org/wiki/Gautam_Buddha_Nagar_(Lok_Sabha_constituency),,2,0,2,7e-06,31
en.wikipedia.org/w/index.php?title=Noida&action=edit&section=1,,1,0,1,6e-06,31
en.wikipedia.org/wiki/Sanjay_Gandhi,,1,0,1,6e-06,31
en.wikipedia.org/wiki/Special_economic_zone,,2,0,2,6e-06,31
en.wikipedia.org/w/index.php?title=Noida&action=edit&section=2,,1,0,1,6e-06,31
en.wikipedia.org/wiki/Gautam_Buddh_Nagar_district,,1,0,1,6e-06,31
en.wikipedia.org/w/index.php?title=Noida&action=edit&section=3,,1,0,1,6e-06,31
en.wikipedia.org/w/index.php?title=Noida&action=edit&section=4,,1,0,1,6e-06,31
en.wikipedia.org/wiki/Jainism_in_Uttar_Pradesh,,1,0,1,6e-06,31
en.wikipedia.org/wiki/Mohiyapur,,1,0,1,6e-06,31
en.wikipedia.org/wiki/Bisrakh,,1,0,1,6e-06,31
en.wikipedia.org/w/index.php?title=Noida&action=edit&section=5,,1,0,1,6e-06,31
en.wikipedia.org/w/index.php?title=Noida&action=edit&section=6,,1,0,1,6e-06,31
en.wikipedia.org/w/index.php?title=Noida&action=edit&section=7,,1,0,1,6e-06,31
en.wikipedia.org/wiki/Statutory_authority,,1,0,1,6e-06,31
en.wikipedia.org/wiki/Department_of_Infrastructure_and_Industrial_Development_(Uttar_Pradesh),,1,0,1,6e-06,31
en.wikipedia.org/w/index.php?title=Noida&action=edit&section=8,,1,0,1,6e-06,31
en.wikipedia.org/wiki/Gautam_Budh_Nagar_district,,7,0,7,7e-06,31
en.wikipedia.org/wiki/Municipal_corporation,,3,0,3,6e-06,31
en.wikipedia.org/wiki/Sub-divisional_magistrate,,1,0,1,6e-06,31
en.wikipedia.org/w/index.php?title=Noida&action=edit&section=9,,1,0,1,6e-06,31
en.wikipedia.org/w/index.php?title=Noida&action=edit&section=10,,1,0,1,6e-06,31
en.wikipedia.org/w/index.php?title=Noida&action=edit&section=11,,1,0,1,6e-06,31
en.wikipedia.org/wiki/Noida_(Assembly_constituency),,1,0,1,6e-06,31
en.wikipedia.org/wiki/Pankaj_Singh_(politician),,1,0,1,6e-06,31
en.wikipedia.org/wiki/Mahesh_Sharma,,1,0,1,6e-06,31
en.wikipedia.org/w/index.php?title=Noida&action=edit&section=12,,1,0,1,6e-06,31
gbnagar.nic.in/,,1,0,1,6e-06,31
en.wikipedia.org/w/index.php?title=Noida&action=edit&section=13,,1,0,1,6e-06,31
en.wikipedia.org/w/index.php?title=Noida&action=edit&section=14,,1,0,1,6e-06,31
en.wikipedia.org/wiki/Signature_Bridge,,1,0,1,6e-06,31
en.wikipedia.org/wiki/Noida_Supertech_Twin_Towers,,1,0,1,6e-06,31
en.wikipedia.org/w/index.php?title=Noida&action=edit&section=15,,1,0,1,6e-06,31
en.wikipedia.org/wiki/Yatharth_Hospitals,,1,0,1,6e-06,31
en.wikipedia.org/wiki/Kailash_Hospital,,1,0,1,6e-06,31
en.wikipedia.org/wiki/Metro_Hospital,,1,0,1,6e-06,31
en.wikipedia.org/wiki/Fortis_Hospital,,1,0,1,6e-06,31
en.wikipedia.org/w/index.php?title=Noida&action=edit&section=16,,1,0,1,6e-06,31
en.wikipedia.org/wiki/Arm_Holdings,,1,0,1,6e-06,31
en.wikipedia.org/wiki/Barclays,,2,0,2,6e-06,31
en.wikipedia.org/wiki/Paytm,,2,0,2,6e-06,31
en.wikipedia.org/w/index.php?title=Noida&action=edit&section=17,,1,0,1,6e-06,31
en.wikipedia.org/w/index.php?title=Noida&action=edit&section=18,,1,0,1,6e-06,31
en.wikipedia.org/wiki/Rashtriya_Dalit_Prerna_Sthal_and_Green_Garden,,1,0,1,6e-06,31
en.wikipedia.org/w/index.php?title=Noida&action=edit&section=19,,1,0,1,6e-06,31
en.wikipedia.org/wiki/File:Spoonbills.jpg,,1,0,1,6e-06,31
en.wikipedia.org/wiki/Spoonbill,,1,0,1,6e-06,31
en.wikipedia.org/wiki/Sanctuary,,1,0,1,6e-06,31
en.wikipedia.org/w/index.php?title=Noida&action=edit&section=20,,1,0,1,6e-06,31
en.wikipedia.org/wiki/Botanical_garden,,1,0,1,6e-06,31
en.wikipedia.org/wiki/Cartography_of_India,,1,0,1,6e-06,31
en.wikipedia.org/wiki/Purple-rumped_sunbird,,1,0,1,6e-06,31
en.wikipedia.org/wiki/Psilotum_nudum,,1,0,1,6e-06,31
en.wikipedia.org/wiki/Devonian,,1,0,1,6e-06,31
en.wikipedia.org/wiki/Silurian,,1,0,1,6e-06,31
en.wikipedia.org/wiki/Aloe_vera,,1,0,1,6e-06,31
en.wikipedia.org/wiki/Gymnema_sylvestre,,1,0,1,6e-06,31
en.wikipedia.org/wiki/Withania_somnifera,,1,0,1,6e-06,31
en.wikipedia.org/wiki/Aristolochia_indica,,1,0,1,6e-06,31
en.wikipedia.org/wiki/Cissus_quadrangularis,,1,0,1,6e-06,31
en.wikipedia.org/wiki/Plumbago_zeylanica,,1,0,1,6e-06,31
en.wikipedia.org/wiki/Leucoderma,,1,0,1,6e-06,31
en.wikipedia.org/wiki/Guava,,1,0,1,6e-06,31
en.wikipedia.org/wiki/Sapindus_marginatus,,1,0,1,6e-06,31
en.wikipedia.org/wiki/Pterocarpus_marsupium,,1,0,1,6e-06,31
en.wikipedia.org/wiki/Dalbergia_sissoo,,1,0,1,6e-06,31
en.wikipedia.org/w/index.php?title=Noida&action=edit&section=21,,1,0,1,6e-06,31
en.wikipedia.org/w/index.php?title=Noida&action=edit&section=22,,1,0,1,6e-06,31
en.wikipedia.org/w/index.php?title=Noida&action=edit&section=23,,1,0,1,6e-06,31
en.wikipedia.org/wiki/Botanical_Garden_metro_station,,1,0,1,6e-06,31
en.wikipedia.org/wiki/Aqua_Line_(Noida_Metro),,2,0,2,6e-06,31
en.wikipedia.org/wiki/List_of_Noida_Metro_stations,,1,0,1,6e-06,31
"en.wikipedia.org/wiki/Dwarka,_Delhi",,2,0,2,6e-06,31
en.wikipedia.org/wiki/Vaishali_metro_station,,1,0,1,6e-06,31
en.wikipedia.org/wiki/Yamuna_Bank_metro_station,,1,0,1,6e-06,31
en.wikipedia.org/wiki/Janakpuri,,2,0,2,6e-06,31
en.wikipedia.org/wiki/Janakpuri_West_metro_station,,1,0,1,6e-06,31
en.wikipedia.org/wiki/Ghaziabad_railway_station,,1,0,1,6e-06,31
en.wikipedia.org/wiki/Anand_Vihar_Terminal,,2,0,2,6e-06,31
en.wikipedia.org/wiki/Old_Delhi_Railway_station,,1,0,1,6e-06,31
en.wikipedia.org/w/index.php?title=Noida&action=edit&section=24,,1,0,1,6e-06,31
en.wikipedia.org/wiki/File:Noida_expressway.jpg,,1,0,1,6e-06,31
en.wikipedia.org/wiki/File:Yamuna_Expressway_Delhi_-_Agra.jpg,,1,0,1,6e-06,31
en.wikipedia.org/wiki/Upper_Ganges_Canal_Expressway,,1,0,1,6e-06,31
en.wikipedia.org/wiki/UPSRTC,,3,0,3,7e-06,31
en.wikipedia.org/wiki/Cycle_rickshaw,,2,0,2,6e-06,31
en.wikipedia.org/w/index.php?title=Noida&action=edit&section=25,,1,0,1,6e-06,31
en.wikipedia.org/wiki/Groundbreaking,,2,0,2,6e-06,31
en.wikipedia.org/wiki/Airbus_A320neo_family,,1,0,1,6e-06,31
en.wikipedia.org/w/index.php?title=Noida&action=edit&section=26,,1,0,1,6e-06,31
en.wikipedia.org/wiki/Khair,,2,0,2,7e-06,31
en.wikipedia.org/wiki/Hathras,,3,0,3,6e-06,31
en.wikipedia.org/w/index.php?title=Noida&action=edit&section=27,,1,0,1,6e-06,31
en.wikipedia.org/w/index.php?title=Noida&action=edit&section=28,,1,0,1,6e-06,31
en.wikipedia.org/wiki/File:Amity_University_Noida.jpg,,1,0,1,6e-06,31
en.wikipedia.org/wiki/Government_Post_Graduate_College_Noida,,1,0,1,6e-06,31
en.wikipedia.org/wiki/IMS_Law_College,,1,0,1,6e-06,31
en.wikipedia.org/wiki/JSSATE_Noida,,1,0,1,6e-06,31
en.wikipedia.org/w/index.php?title=Noida&action=edit&section=29,,1,0,1,6e-06,31
en.wikipedia.org/wiki/Delhi_Public_School,,1,0,1,6e-06,31
en.wikipedia.org/wiki/Kendriya_Vidyalaya,,7,0,7,7e-06,31
en.wikipedia.org/wiki/Maharishi_Vidya_Mandir,,1,0,1,6e-06,31
en.wikipedia.org/wiki/Ryan_International_School,,1,0,1,6e-06,31
en.wikipedia.org/w/index.php?title=Noida&action=edit&section=30,,1,0,1,6e-06,31
en.wikipedia.org/wiki/T-Series_(company),,1,0,1,6e-06,31
en.wikipedia.org/wiki/Noida_Film_City,,1,0,1,6e-06,31
en.wikipedia.org/wiki/News_Nation,,1,0,1,6e-06,31
en.wikipedia.org/wiki/TV_Today,,1,0,1,6e-06,31
en.wikipedia.org/wiki/Network_18,,1,0,1,6e-06,31
en.wikipedia.org/wiki/NewsX,,1,0,1,6e-06,31
en.wikipedia.org/wiki/The_Great_India_Place,,1,0,1,6e-06,31
en.wikipedia.org/wiki/Spice_World_Mall,,1,0,1,6e-06,31
en.wikipedia.org/w/index.php?title=Noida&action=edit&section=31,,1,0,1,6e-06,31
en.wikipedia.org/wiki/Noida_Cricket_Stadium,,1,0,1,6e-06,31
en.wikipedia.org/wiki/Jaypee_Sports_City,,1,0,1,6e-06,31
en.wikipedia.org/wiki/Queen%27s_Baton_Relay,,1,0,1,6e-06,31
en.wikipedia.org/wiki/Commonwealth_Games,,1,0,1,6e-06,31
en.wikipedia.org/wiki/Golf_course,,1,0,1,6e-06,31
en.wikipedia.org/wiki/Indian_Golf_Union,,1,0,1,6e-06,31
en.wikipedia.org/wiki/Jaypee_Group,,1,0,1,6e-06,31
en.wikipedia.org/wiki/Feroz_Shah_Kotla_Ground,,1,0,1,6e-06,31
en.wikipedia.org/w/index.php?title=Noida&action=edit&section=32,,1,0,1,6e-06,31
en.wikipedia.org/w/index.php?title=Noida&action=edit&section=33,,1,0,1,6e-06,31
en.wikipedia.org/wiki/Vikram_Seth,,2,0,2,6e-06,31
en.wikipedia.org/w/index.php?title=Noida&action=edit&section=34,,1,0,1,6e-06,31
en.wikipedia.org/wiki/Nawab_Singh_Nagar,,1,0,1,6e-06,31
en.wikipedia.org/wiki/Tejpal_Singh_Nagar,,1,0,1,6e-06,31
en.wikipedia.org/wiki/D._P._Yadav,,1,0,1,6e-06,31
en.wikipedia.org/w/index.php?title=Noida&action=edit&section=35,,1,0,1,6e-06,31
en.wikipedia.org/wiki/Parvinder_Awana,,1,0,1,6e-06,31
en.wikipedia.org/wiki/Varun_Singh_Bhati,,1,0,1,6e-06,31
en.wikipedia.org/wiki/Shivam_Mavi,,1,0,1,6e-06,31
en.wikipedia.org/wiki/Robin_Singh_(footballer),,1,0,1,6e-06,31
en.wikipedia.org/w/index.php?title=Noida&action=edit&section=36,,1,0,1,6e-06,31
en.wikipedia.org/wiki/Nangli_Wazidpur,,1,0,1,6e-06,31
en.wikipedia.org/wiki/Nithari,,1,0,1,6e-06,31
en.wikipedia.org/w/index.php?title=Noida&action=edit&section=37,,1,0,1,6e-06,31
gbnagar.nic.in/dms-profile/,,1,0,1,6e-06,31
censusindia.gov.in/pca/SearchDetails.aspx?Id=128539,,1,0,1,6e-06,31
noidaauthorityonline.in/hi,,1,0,1,6e-06,31
web.archive.org/web/20220327164342/https://noidaauthorityonline.in/,,1,0,1,6e-06,31
abplive.in/india/2015/03/11/article524150.ece/Mumbai-wins-the-Best-City-Award-2015,,1,0,1,6e-06,31
tennews.in/abp-news-awards-noida-city-for-housing-and-best-city-in-uttar-pradesh/,,1,0,1,6e-06,31
sezindia.nic.in/writereaddata/pdf/ListofoperationalSEZs.pdf,,1,0,1,6e-06,31
en.climate-data.org/asia/india/uttar-pradesh/noida-31485/,,1,0,1,6e-06,31
prana.cpcb.gov.in/ncapServices/robust/fetchFilesFromDrive/Swachh_Vayu_Survekshan_2024_Result.pdf,,1,0,1,6e-06,31
indianexpress.com/article/cities/delhi/only-the-elderly-come-to-mourn-ravana-in-birthplace-bisrakh/,,1,0,1,6e-06,31
greaternoidaauthority.in/keyoff,,1,0,1,6e-06,31
noidaauthorityonline.in/en/page/who’s-who,,1,0,1,6e-06,31
yourarticlelibrary.com/india-2/role-and-functions-of-divisional-commissioner/46672/,,1,0,1,6e-06,31
meerutdivision.nic.in/,,1,0,1,6e-06,31
uppolice.gov.in/frmOfficials.aspx?commgbngr&cd=NAA0ADYAMwA=,,1,0,1,6e-06,31
web.archive.org/web/20220808132844/https://districts.ecourts.gov.in/gautam-buddha-nagar,,1,0,1,6e-06,31
districts.ecourts.gov.in/gautam-buddha-nagar,,1,0,1,6e-06,31
apsinghlawyer.com/post/where-is-court-for-noida-greater-noida-situated,,1,0,1,6e-06,31
noidabusinessguide.com/sectors-in-noida/,,1,0,1,6e-06,31
financialexpress.com/news/the-uneven-growth-in-ncr/1025916/0,,1,0,1,6e-06,31
skyscrapercenter.com/city/noida,,1,0,1,6e-06,31
hindustantimes.com/noida/noida-gold-mine-of-uttar-pradesh/story-Gi7dyHwV5QYRoTsnpKZhiJ.html,,1,0,1,6e-06,31
financialexpress.com/money/new-noida-to-emerge-as-an-industrial-amp-corporate-hub/2754425/,,1,0,1,6e-06,31
cnbctv18.com/business/companies/yatharth-hospital-occuapncy-targets-2027-yatharth-tyagi-19483633.htm,,1,0,1,6e-06,31
ehealth.eletsonline.com/2016/12/felix-healthcare-offering-unmatched-healthcare-in-noida/,,1,0,1,6e-06,31
ft.com/high-growth-asia-pacific-ranking-2024,,1,0,1,6e-06,31
obs-up.com/,,1,0,1,6e-06,31
tools.bgci.org/garden.php?id=4195,,1,0,1,6e-06,31
deccanherald.com/content/265017/a-garden-heal.html,,1,0,1,6e-06,31
cityspidey.com/news/21144/noida-s-dog-park-is-to-be-on-lease-for-20-years,,1,0,1,6e-06,31
english.jagran.com/india/dogs-day-out-noida-to-get-its-first-park-for-pet-canines-soon-10082927,,1,0,1,6e-06,31
indianarrative.com/india-news/park-for-pet-dogs-opened-in-noida-145552.html,,1,0,1,6e-06,31
jagranjosh.com/articles/kv-noida-recruitment-2022-1647944824-1,,1,0,1,6e-06,31
nyoooz.com/news/noida/,,1,0,1,6e-06,31
timesofindia.indiatimes.com/city/noida/Rural-Noida-to-enter-digital-domain/articleshow/47007097.cms,,1,0,1,6e-06,31
en.wikipedia.org/w/index.php?title=Noida&action=edit&section=38,,1,0,1,6e-06,31
noidaauthorityonline.com/,,1,0,1,6e-06,31
en.wikipedia.org/wiki/Template_talk:Meerut_division_topics,,2,0,2,7e-06,31
en.wikipedia.org/wiki/Special:EditPage/Template:Meerut_division_topics,,2,0,2,7e-06,31
en.wikipedia.org/wiki/Nauchandi_Mela,,2,0,2,7e-06,31
en.wikipedia.org/wiki/Mayasura,,2,0,2,7e-06,31
en.wikipedia.org/wiki/Mandodari,,2,0,2,7e-06,31
en.wikipedia.org/wiki/Yamuna_River,,10,0,10,7e-06,31
en.wikipedia.org/wiki/Western_Hindi,,6,0,6,7e-06,31
en.wikipedia.org/wiki/Jat_people,,2,0,2,7e-06,31
en.wikipedia.org/wiki/Gujjar,,2,0,2,7e-06,31
en.wikipedia.org/wiki/Meerut_Airport,,2,0,2,7e-06,31
en.wikipedia.org/wiki/Delhi_Meerut_RRTS,,2,0,2,7e-06,31
en.wikipedia.org/wiki/Noida_Greater_Noida_Expressway,,2,0,2,7e-06,31
en.wikipedia.org/wiki/Upper_Ganga_Canal_Expressway,,2,0,2,7e-06,31
en.wikipedia.org/wiki/National_Highway_91_(India),,4,0,4,7e-06,31
en.wikipedia.org/wiki/Baghpat_(Lok_Sabha_constituency),,2,0,2,7e-06,31
en.wikipedia.org/wiki/Bulandshahr_(Lok_Sabha_constituency),,2,0,2,7e-06,31
en.wikipedia.org/wiki/Ghaziabad_(Lok_Sabha_constituency),,2,0,2,7e-06,31
en.wikipedia.org/wiki/Meerut_(Lok_Sabha_constituency),,2,0,2,7e-06,31
en.wikipedia.org/wiki/Template:Bagpat_district,,2,0,2,7e-06,31
en.wikipedia.org/wiki/Template:Bulandshahr_district,,2,0,2,7e-06,31
en.wikipedia.org/wiki/Template:Gautam_Buddha_Nagar_district,,2,0,2,7e-06,31
en.wikipedia.org/wiki/Template:Ghaziabad_district,,2,0,2,7e-06,31
en.wikipedia.org/wiki/Template:Meerut_district,,2,0,2,7e-06,31
en.wikipedia.org/wiki/Template:Hapur_district,,2,0,2,7e-06,31
en.wikipedia.org/wiki/Category:Villages_in_Bagpat_district,,2,0,2,7e-06,31
en.wikipedia.org/wiki/Category:Villages_in_Bulandshahr_district,,2,0,2,7e-06,31
en.wikipedia.org/wiki/Category:Villages_in_Gautam_Buddh_Nagar_district,,2,0,2,7e-06,31
"en.wikipedia.org/wiki/Category:Villages_in_Ghaziabad_district,_India",,2,0,2,7e-06,31
en.wikipedia.org/wiki/Category:People_from_Bulandshahr,,2,0,2,7e-06,31
en.wikipedia.org/wiki/Category:People_from_Gautam_Buddha_Nagar,,2,0,2,7e-06,31
"en.wikipedia.org/wiki/Category:People_from_Ghaziabad_district,_India",,2,0,2,7e-06,31
en.wikipedia.org/wiki/Category:People_from_Meerut,,2,0,2,7e-06,31
wikidata.org/wiki/Q278204,,1,0,1,6e-06,31
viaf.org/viaf/137389861,,1,0,1,6e-06,31
d-nb.info/gnd/7669301-6,,1,0,1,6e-06,31
nli.org.il/en/authorities/987007496681405171,,1,0,1,6e-06,31
lux.collections.yale.edu/view/place/20e0f1b6-4f88-4407-aa42-99c17b9cef46,,1,0,1,6e-06,31
en.wikipedia.org/wiki/Category:Noida,,1,0,1,6e-06,31
en.wikipedia.org/wiki/Category:1976_establishments_in_Uttar_Pradesh,,1,0,1,6e-06,31
en.wikipedia.org/wiki/Category:High-technology_business_districts_in_India,,1,0,1,6e-06,31
en.wikipedia.org/wiki/Category:Planned_communities_in_India,,2,0,2,6e-06,31
en.wikipedia.org/wiki/Category:Populated_places_established_in_1976,,1,0,1,6e-06,31
en.wikipedia.org/wiki/Category:Satellite_Cities_in_India,,1,0,1,6e-06,31
en.wikipedia.org/wiki/Category:Wikipedia_articles_needing_factual_verification_from_August_2021,,1,0,1,6e-06,31
en.m.wikipedia.org/w/index.php?title=Noida&mobileaction=toggle_view_mobile,,1,0,1,6e-06,31
upload.wikimedia.org/wikipedia/commons/thumb/3/3f/DLF_Mall_of_India.jpg/250px-DLF_Mall_of_India.jpg,,1,0,1,6e-06,31
upload.wikimedia.org/wikipedia/commons/thumb/c/ca/Noida_Logo.jpg/120px-Noida_Logo.jpg,,1,0,1,6e-06,31
upload.wikimedia.org/wikipedia/commons/thumb/9/98/Spoonbills.jpg/250px-Spoonbills.jpg,,1,0,1,6e-06,31
upload.wikimedia.org/wikipedia/commons/thumb/a/ab/Noida_expressway.jpg/250px-Noida_expressway.jpg,,1,0,1,6e-06,31
en.wikipedia.org/w/index.php?title=Special:CreateAccount&returnto=Nawabganj+Bird+Sanctuary,,1,0,1,6e-06,31
en.wikipedia.org/w/index.php?title=Special:UserLogin&returnto=Nawabganj+Bird+Sanctuary,,1,0,1,6e-06,31
bh.wikipedia.org/wiki/नवाबगंज_चिरई_बिहार,,1,0,1,6e-06,31
hi.wikipedia.org/wiki/नवाबगंज_पक्षी_अभयारण्य,,1,0,1,6e-06,31
kn.wikipedia.org/wiki/ನವಾಬಗಂಜ್_ಪಕ್ಷಿ_ಧಾಮ,,1,0,1,6e-06,31
ml.wikipedia.org/wiki/നവാബ്‍ഗഞ്ച്,,1,0,1,6e-06,31
wikidata.org/wiki/Special:EntityPage/Q6982793,,1,0,1,6e-06,31
en.wikipedia.org/wiki/Talk:Nawabganj_Bird_Sanctuary,,1,0,1,6e-06,31
en.wikipedia.org/w/index.php?title=Nawabganj_Bird_Sanctuary&action=edit,,1,0,1,6e-06,31
en.wikipedia.org/w/index.php?title=Nawabganj_Bird_Sanctuary&action=history,,1,0,1,6e-06,31
en.wikipedia.org/wiki/Special:WhatLinksHere/Nawabganj_Bird_Sanctuary,,1,0,1,6e-06,31
en.wikipedia.org/wiki/Special:RecentChangesLinked/Nawabganj_Bird_Sanctuary,,1,0,1,6e-06,31
en.wikipedia.org/w/index.php?title=Nawabganj_Bird_Sanctuary&oldid=1308548879,,1,0,1,6e-06,31
en.wikipedia.org/w/index.php?title=Nawabganj_Bird_Sanctuary&action=info,,1,0,1,6e-06,31
en.wikipedia.org/w/index.php?title=Nawabganj_Bird_Sanctuary&printable=yes,,1,0,1,6e-06,31
commons.wikimedia.org/wiki/Category:Nawabganj_Bird_Sanctuary,,1,0,1,6e-06,31
en.wikipedia.org/wiki/IUCN_protected_area_categories,,2,0,2,6e-06,31
"en.wikipedia.org/wiki/File:Nawabganj_Bird_Sanctuary,_Unnao_03.JPG",,1,0,1,6e-06,31
en.wikipedia.org/wiki/File:India_relief_location_map.jpg,,5,0,5,7e-06,31
en.wikipedia.org/wiki/File:591_Spotted-Deer.jpg,,1,0,1,6e-06,31
en.wikipedia.org/wiki/Spotted_deer,,1,0,1,6e-06,31
en.wikipedia.org/wiki/Lake,,3,0,3,7e-06,31
en.wikipedia.org/wiki/Wetlands,,1,0,1,6e-06,31
en.wikipedia.org/wiki/Migratory_birds,,1,0,1,6e-06,31
en.wikipedia.org/w/index.php?title=Nawabganj_Bird_Sanctuary&action=edit&section=1,,1,0,1,6e-06,31
en.wikipedia.org/wiki/Greylag_goose,,1,0,1,6e-06,31
en.wikipedia.org/wiki/Northern_pintail,,1,0,1,6e-06,31
en.wikipedia.org/wiki/Cotton_teal,,1,0,1,6e-06,31
en.wikipedia.org/wiki/Red-crested_pochard,,1,0,1,6e-06,31
en.wikipedia.org/wiki/Gadwall,,1,0,1,6e-06,31
en.wikipedia.org/wiki/Shoveller,,1,0,1,6e-06,31
en.wikipedia.org/wiki/Coot,,1,0,1,6e-06,31
en.wikipedia.org/wiki/Mallard,,1,0,1,6e-06,31
en.wikipedia.org/wiki/Little_grebe,,1,0,1,6e-06,31
en.wikipedia.org/wiki/Open-bill_stork,,1,0,1,6e-06,31
en.wikipedia.org/wiki/White-necked_stork,,1,0,1,6e-06,31
en.wikipedia.org/wiki/Pheasant-tailed_jacana,,1,0,1,6e-06,31
en.wikipedia.org/wiki/Bronze_winged_jacana,,1,0,1,6e-06,31
en.wikipedia.org/wiki/Purple_moorhen,,1,0,1,6e-06,31
en.wikipedia.org/wiki/Lapwing,,1,0,1,6e-06,31
en.wikipedia.org/wiki/Tern,,1,0,1,6e-06,31
en.wikipedia.org/wiki/Vulture,,1,0,1,6e-06,31
en.wikipedia.org/wiki/Pigeon,,1,0,1,6e-06,31
en.wikipedia.org/wiki/Black_drongo,,1,0,1,6e-06,31
en.wikipedia.org/wiki/Indian_roller,,1,0,1,6e-06,31
en.wikipedia.org/wiki/Bee-eater,,1,0,1,6e-06,31
en.wikipedia.org/w/index.php?title=Nawabganj_Bird_Sanctuary&action=edit&section=2,,1,0,1,6e-06,31
en.wikipedia.org/wiki/Viper,,1,0,1,6e-06,31
en.wikipedia.org/wiki/Krait,,1,0,1,6e-06,31
en.wikipedia.org/wiki/Ratsnake,,1,0,1,6e-06,31
en.wikipedia.org/w/index.php?title=Nawabganj_Bird_Sanctuary&action=edit&section=3,,1,0,1,6e-06,31
en.wikipedia.org/w/index.php?title=Nawabganj_Bird_Sanctuary&action=edit&section=4,,1,0,1,6e-06,31
en.wikipedia.org/w/index.php?title=Nawabganj_Bird_Sanctuary&action=edit&section=5,,1,0,1,6e-06,31
"en.wikipedia.org/wiki/File:Nawabganj_Bird_Sanctuary,_Unnao_02.jpg",,1,0,1,6e-06,31
"en.wikipedia.org/wiki/File:Birds_at_Nawabganj_bird_sanctuary,_Unnao_02.JPG",,1,0,1,6e-06,31
"en.wikipedia.org/wiki/File:Nawabganj_Bird_Sanctuary,_Unnao_01.JPG",,1,0,1,6e-06,31
"en.wikipedia.org/wiki/File:Nawabganj_Bird_Sanctuary,_Unnao_05.JPG",,1,0,1,6e-06,31
"en.wikipedia.org/wiki/File:Lake_at_Nawabganj_bird_sanctuary,_Unnao_04.JPG",,1,0,1,6e-06,31
"en.wikipedia.org/wiki/File:Nawabganj_Bird_Sanctuary,_Unnao_06.JPG",,1,0,1,6e-06,31
"en.wikipedia.org/wiki/File:Nawabganj_Bird_Sanctuary,_Unnao_07.JPG",,1,0,1,6e-06,31
"en.wikipedia.org/wiki/File:Nawabganj_Bird_Sanctuary,_Unnao_09.JPG",,1,0,1,6e-06,31
"en.wikipedia.org/wiki/File:Boating_in_lake_at_Nawabganj_bird_sanctuary,_Unnao_01.JPG",,1,0,1,6e-06,31
en.wikipedia.org/wiki/File:Indian_Cormorant_swimming_in_Nawabganj_Bird_Sanctuary.png,,1,0,1,6e-06,31
en.wikipedia.org/w/index.php?title=Nawabganj_Bird_Sanctuary&action=edit&section=6,,1,0,1,6e-06,31
en.wikipedia.org/wiki/Wildlife_refuge,,1,0,1,6e-06,31
en.wikipedia.org/wiki/Nature_reserve,,1,0,1,6e-06,31
en.wikipedia.org/w/index.php?title=Nawabganj_Bird_Sanctuary&action=edit&section=7,,1,0,1,6e-06,31
rsis.ramsar.org/ris/2412,,1,0,1,6e-06,31
en.wikipedia.org/w/index.php?title=Nawabganj_Bird_Sanctuary&action=edit&section=8,,1,0,1,6e-06,31
wild-india.com/NationalParksIndia/index.html,,1,0,1,6e-06,31
web.archive.org/web/20160303193959/http://www.wild-india.com/NationalParksIndia/index.html,,1,0,1,6e-06,31
unnao.nic.in/nawabganjbirds/index.html,,1,0,1,6e-06,31
en.wikipedia.org/wiki/Template:Bird_Sanctuaries,,1,0,1,6e-06,31
en.wikipedia.org/wiki/Template_talk:Bird_Sanctuaries,,1,0,1,6e-06,31
en.wikipedia.org/wiki/Special:EditPage/Template:Bird_Sanctuaries,,1,0,1,6e-06,31
en.wikipedia.org/wiki/Animal_sanctuary,,1,0,1,6e-06,31
en.wikipedia.org/wiki/Attiveri_Bird_Sanctuary,,1,0,1,6e-06,31
en.wikipedia.org/wiki/Bankapura_Peacock_Sanctuary,,1,0,1,6e-06,31
en.wikipedia.org/wiki/Bonal_Bird_Sanctuary,,1,0,1,6e-06,31
en.wikipedia.org/wiki/Cora_Hartshorn_Arboretum_and_Bird_Sanctuary,,1,0,1,6e-06,31
en.wikipedia.org/wiki/Creamer%27s_Field_Migratory_Waterfowl_Refuge,,1,0,1,6e-06,31
en.wikipedia.org/wiki/Khijadiya_Bird_Sanctuary,,2,0,2,6e-06,31
en.wikipedia.org/wiki/Kumarakom_Bird_Sanctuary,,1,0,1,6e-06,31
en.wikipedia.org/wiki/Mangalavanam_bird_sanctuary,,1,0,1,6e-06,31
en.wikipedia.org/wiki/Mayani_Bird_Sanctuary,,1,0,1,6e-06,31
en.wikipedia.org/wiki/Mousehole_Wild_Bird_Hospital_and_Sanctuary,,1,0,1,6e-06,31
en.wikipedia.org/wiki/Nalsarovar_Bird_Sanctuary,,1,0,1,6e-06,31
en.wikipedia.org/wiki/Porbandar_Bird_Sanctuary,,1,0,1,6e-06,31
en.wikipedia.org/wiki/Raiganj_Wildlife_Sanctuary,,1,0,1,6e-06,31
en.wikipedia.org/wiki/Ranganathittu_Bird_Sanctuary,,2,0,2,6e-06,31
en.wikipedia.org/wiki/Suncoast_Seabird_Sanctuary,,1,0,1,6e-06,31
en.wikipedia.org/wiki/Protected_areas_of_Tamil_Nadu,,1,0,1,6e-06,31
en.wikipedia.org/wiki/Thattekad_Bird_Sanctuary,,1,0,1,6e-06,31
en.wikipedia.org/wiki/Wing_Haven_Gardens_and_Bird_Sanctuary,,1,0,1,6e-06,31
en.wikipedia.org/wiki/Template_talk:Lucknow_division_topics,,3,0,3,7e-06,31
en.wikipedia.org/wiki/Special:EditPage/Template:Lucknow_division_topics,,3,0,3,7e-06,31
en.wikipedia.org/wiki/Firangi_Mahal,,3,0,3,7e-06,31
en.wikipedia.org/wiki/Bara_Imambara,,9,0,9,7e-06,31
en.wikipedia.org/wiki/Chota_Imambara,,9,0,9,7e-06,31
en.wikipedia.org/wiki/Lucknow_Zoo,,3,0,3,7e-06,31
en.wikipedia.org/wiki/National_Highway_24B_(India),,4,0,4,7e-06,31
en.wikipedia.org/wiki/National_Highway_25_(India)(old_numbering),,3,0,3,7e-06,31
en.wikipedia.org/wiki/National_Highway_25A_(India),,3,0,3,7e-06,31
en.wikipedia.org/wiki/National_Highway_56_(India)(old_numbering),,3,0,3,7e-06,31
"en.wikipedia.org/wiki/National_Highway_56A_(India,_old_numbering)",,3,0,3,7e-06,31
"en.wikipedia.org/wiki/National_Highway_56B_(India,_old_numbering)",,3,0,3,7e-06,31
en.wikipedia.org/wiki/Kukrail_Reserve_Forest,,9,0,9,7e-06,31
en.wikipedia.org/wiki/Hardoi_(Lok_Sabha_constituency),,3,0,3,7e-06,31
en.wikipedia.org/wiki/Misrikh_(Lok_Sabha_constituency),,4,0,4,7e-06,31
en.wikipedia.org/wiki/Kheri_(Lok_Sabha_constituency),,3,0,3,7e-06,31
en.wikipedia.org/wiki/Dhaurahra_(Lok_Sabha_constituency),,3,0,3,7e-06,31
en.wikipedia.org/wiki/Lucknow_(Lok_Sabha_constituency),,3,0,3,7e-06,31
en.wikipedia.org/wiki/Rae_Bareli_(Lok_Sabha_constituency),,3,0,3,7e-06,31
en.wikipedia.org/wiki/Sitapur_(Lok_Sabha_constituency),,3,0,3,7e-06,31
en.wikipedia.org/wiki/Mohanlalganj_(Lok_Sabha_constituency),,3,0,3,7e-06,31
en.wikipedia.org/wiki/Template:Hardoi_district,,3,0,3,7e-06,31
en.wikipedia.org/wiki/Template:Lakhimpur_Kheri_district,,3,0,3,7e-06,31
en.wikipedia.org/wiki/Template:Lucknow_district,,3,0,3,7e-06,31
en.wikipedia.org/wiki/Template:Raebareli_district,,3,0,3,7e-06,31
en.wikipedia.org/wiki/Template:Sitapur_district,,3,0,3,7e-06,31
en.wikipedia.org/wiki/Template:Unnao_district,,4,0,4,7e-06,31
en.wikipedia.org/wiki/Category:Villages_in_Hardoi_district,,3,0,3,7e-06,31
en.wikipedia.org/wiki/Category:Villages_in_Lakhimpur_Kheri_district,,3,0,3,7e-06,31
en.wikipedia.org/wiki/Category:Villages_in_Lucknow_district,,3,0,3,7e-06,31
en.wikipedia.org/wiki/Category:Villages_in_Raebareli_district,,3,0,3,7e-06,31
en.wikipedia.org/wiki/Category:Villages_in_Unnao_district,,3,0,3,7e-06,31
en.wikipedia.org/wiki/Category:People_from_Hardoi,,3,0,3,7e-06,31
en.wikipedia.org/wiki/Category:People_from_Lakhimpur_Kheri,,3,0,3,7e-06,31
en.wikipedia.org/wiki/Category:People_from_Lucknow,,3,0,3,7e-06,31
en.wikipedia.org/wiki/Category:People_from_Raebareli,,3,0,3,7e-06,31
en.wikipedia.org/wiki/Category:People_from_Unnao,,3,0,3,7e-06,31
en.wikipedia.org/wiki/Template:Ramsar_sites_in_India,,2,0,2,6e-06,31
en.wikipedia.org/wiki/Template_talk:Ramsar_sites_in_India,,2,0,2,6e-06,31
en.wikipedia.org/wiki/Special:EditPage/Template:Ramsar_sites_in_India,,2,0,2,6e-06,31
en.wikipedia.org/wiki/Kolleru_Lake,,2,0,2,6e-06,31
en.wikipedia.org/wiki/Dipor_Bil,,2,0,2,6e-06,31
en.wikipedia.org/wiki/Kanwar_Lake_Bird_Sanctuary,,2,0,2,6e-06,31
en.wikipedia.org/wiki/Nanda_Lake,,2,0,2,6e-06,31
en.wikipedia.org/wiki/Nal_Sarovar_Bird_Sanctuary,,3,0,3,7e-06,31
en.wikipedia.org/wiki/Thol_Lake,,2,0,2,6e-06,31
en.wikipedia.org/wiki/Wadhvana_Wetland,,2,0,2,6e-06,31
en.wikipedia.org/wiki/Sultanpur_National_Park,,2,0,2,6e-06,31
en.wikipedia.org/wiki/Bhindawas_Wildlife_Sanctuary,,2,0,2,6e-06,31
en.wikipedia.org/wiki/Chandra_Taal,,2,0,2,6e-06,31
en.wikipedia.org/wiki/Maharana_Pratap_Sagar,,3,0,3,6e-06,31
en.wikipedia.org/wiki/Renuka_Lake,,3,0,3,6e-06,31
en.wikipedia.org/wiki/Hokersar,,2,0,2,6e-06,31
en.wikipedia.org/w/index.php?title=Hygam_Wetland_Conservation_Reserve&action=edit&redlink=1,,2,0,2,6e-06,31
en.wikipedia.org/w/index.php?title=Shallbugh_Wetland_Conservation_Reserve&action=edit&redlink=1,,2,0,2,6e-06,31
en.wikipedia.org/wiki/Surinsar_Lake,,2,0,2,6e-06,31
en.wikipedia.org/wiki/Mansar_Lake,,2,0,2,6e-06,31
en.wikipedia.org/wiki/Wular_Lake,,2,0,2,6e-06,31
en.wikipedia.org/wiki/Ashtamudi_Lake,,2,0,2,6e-06,31
en.wikipedia.org/wiki/Sasthamcotta_Lake,,2,0,2,6e-06,31
en.wikipedia.org/wiki/Vembanad,,2,0,2,6e-06,31
en.wikipedia.org/wiki/Tso_Moriri,,2,0,2,6e-06,31
en.wikipedia.org/wiki/Tso_Kar,,2,0,2,6e-06,31
en.wikipedia.org/wiki/Madhav_National_Park,,2,0,2,6e-06,31
en.wikipedia.org/wiki/Sirpur_Lake,,2,0,2,6e-06,31
en.wikipedia.org/wiki/Nandur_Madhmeshwar_Bird_Sanctuary,,2,0,2,6e-06,31
en.wikipedia.org/wiki/Lonar_Lake,,2,0,2,6e-06,31
en.wikipedia.org/wiki/Thane_Creek,,4,0,4,7e-06,31
en.wikipedia.org/wiki/Loktak_Lake,,2,0,2,6e-06,31
en.wikipedia.org/wiki/Palak_Dil,,2,0,2,6e-06,31
en.wikipedia.org/wiki/Anshupa_Lake,,2,0,2,6e-06,31
en.wikipedia.org/wiki/Bhitarkanika_Mangroves,,2,0,2,6e-06,31
en.wikipedia.org/wiki/Chilika_Lake,,4,0,4,6e-06,31
en.wikipedia.org/wiki/Hirakud_Dam,,2,0,2,6e-06,31
en.wikipedia.org/wiki/Satkosia_Gorge,,2,0,2,6e-06,31
en.wikipedia.org/wiki/Tampara_Lake,,2,0,2,6e-06,31
en.wikipedia.org/wiki/Beas_Conservation_Reserve,,2,0,2,6e-06,31
en.wikipedia.org/wiki/Harike_Wetland,,2,0,2,6e-06,31
en.wikipedia.org/wiki/Kanjli_Wetland,,2,0,2,6e-06,31
en.wikipedia.org/w/index.php?title=Keshopur-Miani_Community_Reserve&action=edit&redlink=1,,2,0,2,6e-06,31
en.wikipedia.org/wiki/Nangal_Wildlife_Sanctuary,,2,0,2,6e-06,31
en.wikipedia.org/wiki/Ropar_Wetland,,2,0,2,6e-06,31
en.wikipedia.org/wiki/Keoladeo_National_Park,,2,0,2,6e-06,31
en.wikipedia.org/wiki/Sambhar_Salt_Lake,,4,0,4,7e-06,31
en.wikipedia.org/wiki/Chitrangudi_Bird_Sanctuary,,2,0,2,6e-06,31
en.wikipedia.org/wiki/Gulf_of_Mannar_Marine_National_Park,,2,0,2,6e-06,31
en.wikipedia.org/wiki/Point_Calimere,,2,0,2,6e-06,31
en.wikipedia.org/wiki/Kanjirankulam_Bird_Sanctuary,,2,0,2,6e-06,31
en.wikipedia.org/wiki/Karikili_Bird_Sanctuary,,2,0,2,6e-06,31
en.wikipedia.org/wiki/Koonthankulam_Bird_Sanctuary,,2,0,2,6e-06,31
en.wikipedia.org/wiki/Pallikaranai_wetland,,2,0,2,6e-06,31
en.wikipedia.org/wiki/Pichavaram,,2,0,2,6e-06,31
en.wikipedia.org/wiki/Suchindram_Theroor_Birds_Sanctuary,,2,0,2,6e-06,31
en.wikipedia.org/wiki/Therthangal_Bird_Sanctuary,,2,0,2,6e-06,31
en.wikipedia.org/wiki/Udayamarthandapuram_Bird_Sanctuary,,2,0,2,6e-06,31
en.wikipedia.org/wiki/Vaduvoor_Bird_Sanctuary,,2,0,2,6e-06,31
en.wikipedia.org/wiki/Vedanthangal_Bird_Sanctuary,,2,0,2,6e-06,31
en.wikipedia.org/wiki/Vellode_Bird_Sanctuary,,2,0,2,6e-06,31
en.wikipedia.org/wiki/Vembannur_Wetland_Complex,,2,0,2,6e-06,31
en.wikipedia.org/wiki/Rudrasagar_Lake,,2,0,2,6e-06,31
en.wikipedia.org/wiki/Haiderpur_Wetland,,2,0,2,6e-06,31
en.wikipedia.org/wiki/Asan_Barrage,,7,0,7,7e-06,31
en.wikipedia.org/wiki/East_Kolkata_Wetlands,,2,0,2,6e-06,31
en.wikipedia.org/wiki/Sundarbans_National_Park,,2,0,2,6e-06,31
en.wikipedia.org/wiki/Category:IUCN_Category_IV,,2,0,2,6e-06,31
en.wikipedia.org/wiki/Category:Bird_sanctuaries_of_Uttar_Pradesh,,3,0,3,7e-06,31
en.wikipedia.org/wiki/Category:Ramsar_sites_in_India,,2,0,2,6e-06,31
en.wikipedia.org/wiki/Category:Unnao_district,,2,0,2,6e-06,31
en.wikipedia.org/wiki/Category:Protected_areas_established_in_2019,,2,0,2,6e-06,31
en.wikipedia.org/wiki/Category:2019_establishments_in_Uttar_Pradesh,,3,0,3,7e-06,31
en.wikipedia.org/wiki/Category:Use_dmy_dates_from_March_2019,,7,0,7,7e-06,31
en.wikipedia.org/wiki/Category:Use_Indian_English_from_March_2019,,6,0,6,7e-06,31
en.m.wikipedia.org/w/index.php?title=Nawabganj_Bird_Sanctuary&mobileaction=toggle_view_mobile,,1,0,1,6e-06,31
upload.wikimedia.org/wikipedia/commons/thumb/e/e9/591_Spotted-Deer.jpg/250px-591_Spotted-Deer.jpg,,1,0,1,6e-06,31
en.wikipedia.org/wiki/Violet_Line_(Delhi_Metro),,4,0,4,6e-06,31
en.wikipedia.org/wiki/Pink_Line_(Delhi_Metro),,4,0,4,6e-06,31
en.wikipedia.org/wiki/Indian_Premier_League,,2,0,2,6e-06,31
en.wikipedia.org/wiki/Green_Line_(Delhi_Metro),,4,0,4,6e-06,31
imdpune.gov.in/library/public/1981-2010%20CLIM%20NORMALS%20(STATWISE).pdf,,2,0,2,6e-06,31
upload.wikimedia.org/wikipedia/commons/thumb/0/0f/Flag_of_Georgia.svg/40px-Flag_of_Georgia.svg.png,,2,0,2,6e-06,31
en.wikipedia.org/w/index.php?title=Special:CreateAccount&returnto=Nana+Rao+Park,,1,0,1,6e-06,31
en.wikipedia.org/w/index.php?title=Special:UserLogin&returnto=Nana+Rao+Park,,1,0,1,6e-06,31
hi.wikipedia.org/wiki/नाना_राव_पार्क,,1,0,1,6e-06,31
wikidata.org/wiki/Special:EntityPage/Q6962313,,1,0,1,6e-06,31
en.wikipedia.org/wiki/Talk:Nana_Rao_Park,,1,0,1,6e-06,31
en.wikipedia.org/w/index.php?title=Nana_Rao_Park&action=edit,,1,0,1,6e-06,31
en.wikipedia.org/w/index.php?title=Nana_Rao_Park&action=history,,1,0,1,6e-06,31
en.wikipedia.org/wiki/Special:WhatLinksHere/Nana_Rao_Park,,1,0,1,6e-06,31
en.wikipedia.org/wiki/Special:RecentChangesLinked/Nana_Rao_Park,,1,0,1,6e-06,31
en.wikipedia.org/w/index.php?title=Nana_Rao_Park&oldid=1283226760,,1,0,1,6e-06,31
en.wikipedia.org/w/index.php?title=Nana_Rao_Park&action=info,,1,0,1,6e-06,31
en.wikipedia.org/w/index.php?title=Nana_Rao_Park&printable=yes,,1,0,1,6e-06,31
commons.wikimedia.org/wiki/Category:Nana_Rao_Park,,1,0,1,6e-06,31
en.wikipedia.org/w/index.php?title=Nana_Rao_Park&action=edit&section=1,,1,0,1,6e-06,31
en.wikipedia.org/w/index.php?title=Nana_Rao_Park&action=edit&section=2,,1,0,1,6e-06,31
en.wikipedia.org/wiki/Indian_rebellion,,1,0,1,6e-06,31
en.wikipedia.org/w/index.php?title=Nana_Rao_Park&action=edit&section=3,,1,0,1,6e-06,31
en.wikipedia.org/w/index.php?title=Nana_Rao_Park&action=edit&section=4,,1,0,1,6e-06,31
en.wikipedia.org/w/index.php?title=Nana_Rao_Park&action=edit&section=5,,1,0,1,6e-06,31
en.wikipedia.org/wiki/File:Nana_Rao_Park_Renovated.jpg,,1,0,1,6e-06,31
en.wikipedia.org/w/index.php?title=Boodhha_Bargad&action=edit&redlink=1,,1,0,1,6e-06,31
en.wikipedia.org/wiki/Banyan_tree,,1,0,1,6e-06,31
en.wikipedia.org/wiki/Indian_Independence_struggle,,1,0,1,6e-06,31
en.wikipedia.org/wiki/Vyayamshala,,1,0,1,6e-06,31
en.wikipedia.org/wiki/Swing_(seat),,1,0,1,6e-06,31
en.wikipedia.org/wiki/Park,,1,0,1,6e-06,31
en.wikipedia.org/w/index.php?title=Nana_Rao_Park&action=edit&section=6,,1,0,1,6e-06,31
en.wikipedia.org/wiki/Category:Parks_in_India,,1,0,1,6e-06,31
en.m.wikipedia.org/w/index.php?title=Nana_Rao_Park&mobileaction=toggle_view_mobile,,1,0,1,6e-06,31
en.wikipedia.org/w/index.php?title=Special:CreateAccount&returnto=Moti+Jheel,,1,0,1,6e-06,31
en.wikipedia.org/w/index.php?title=Special:UserLogin&returnto=Moti+Jheel,,1,0,1,6e-06,31
pa.wikipedia.org/wiki/ਮੋਤੀ_ਝੀਲ,,1,0,1,6e-06,31
pnb.wikipedia.org/wiki/موتی_جھیل,,1,0,1,6e-06,31
wikidata.org/wiki/Special:EntityPage/Q7363316,,1,0,1,6e-06,31
en.wikipedia.org/wiki/Talk:Moti_Jheel,,1,0,1,6e-06,31
en.wikipedia.org/w/index.php?title=Moti_Jheel&action=edit,,1,0,1,6e-06,31
en.wikipedia.org/w/index.php?title=Moti_Jheel&action=history,,1,0,1,6e-06,31
en.wikipedia.org/wiki/Special:WhatLinksHere/Moti_Jheel,,1,0,1,6e-06,31
en.wikipedia.org/wiki/Special:RecentChangesLinked/Moti_Jheel,,1,0,1,6e-06,31
en.wikipedia.org/w/index.php?title=Moti_Jheel&oldid=1196060996,,1,0,1,6e-06,31
en.wikipedia.org/w/index.php?title=Moti_Jheel&action=info,,1,0,1,6e-06,31
en.wikipedia.org/w/index.php?title=Special:DownloadAsPdf&page=Moti_Jheel&action=show-download-screen,,1,0,1,6e-06,31
en.wikipedia.org/w/index.php?title=Moti_Jheel&printable=yes,,1,0,1,6e-06,31
geohack.toolforge.org/geohack.php?pagename=Moti_Jheel&params=26.4761_N_80.314055_E_type:landmark,,1,0,1,6e-06,31
en.wikipedia.org/wiki/Motijheel_(disambiguation),,1,0,1,6e-06,31
en.wikipedia.org/wiki/Motijheel,,1,0,1,6e-06,31
en.wikipedia.org/wiki/Artificial_lake,,1,0,1,6e-06,31
en.wikipedia.org/w/index.php?title=Benajhabar&action=edit&redlink=1,,1,0,1,6e-06,31
en.wikipedia.org/wiki/Manchester,,1,0,1,6e-06,31
en.wikipedia.org/wiki/East,,1,0,1,6e-06,31
en.wikipedia.org/wiki/Pearl,,1,0,1,6e-06,31
en.wikipedia.org/wiki/Lungs,,1,0,1,6e-06,31
en.wikipedia.org/w/index.php?title=Moti_Jheel&action=edit&section=1,,1,0,1,6e-06,31
en.wikipedia.org/wiki/Water_treatment_plant,,1,0,1,6e-06,31
en.wikipedia.org/w/index.php?title=Moti_Jheel&action=edit&section=2,,1,0,1,6e-06,31
en.wikipedia.org/w/index.php?title=Moti_Jheel&action=edit&section=3,,1,0,1,6e-06,31
en.wikipedia.org/w/index.php?title=Moti_Jheel&action=edit&section=4,,1,0,1,6e-06,31
mapsofindia.com/kanpur/places-of-interest/moti-jheel.html,,1,0,1,6e-06,31
tripadvisor.in/ShowUserReviews-g667805-d4088519-r350971438-Moti_Jheel-Kanpur_Uttar_Pradesh.html,,1,0,1,6e-06,31
india9.com/i9show/Moti-Jheel-19836.htm,,1,0,1,6e-06,31
en.wikipedia.org/w/index.php?title=Moti_Jheel&action=edit&section=5,,1,0,1,6e-06,31
en.wikipedia.org/wiki/Special:BookSources/81-7099-241-9,,1,0,1,6e-06,31
books.google.com/books?id=gL7pGaL3vooC&q=moti+jheel+kanpur&pg=PT151,,1,0,1,6e-06,31
en.wikipedia.org/wiki/Special:BookSources/81-207-2939-0,,1,0,1,6e-06,31
en.wikipedia.org/w/index.php?title=Moti_Jheel&action=edit&section=6,,1,0,1,6e-06,31
wikimapia.org/246240/Moti-Jheel-and-Park,,1,0,1,6e-06,31
en.wikipedia.org/wiki/Wikimapia,,1,0,1,6e-06,31
en.wikipedia.org/wiki/File:Uttar_Pradesh_vector.svg,,18,0,18,7e-06,31
en.wikipedia.org/wiki/Template:Kanpur-geo-stub,,9,0,9,7e-06,31
en.wikipedia.org/wiki/Template_talk:Kanpur-geo-stub,,9,0,9,7e-06,31
en.wikipedia.org/wiki/Special:EditPage/Template:Kanpur-geo-stub,,9,0,9,7e-06,31
en.wikipedia.org/wiki/Category:Lakes_of_Uttar_Pradesh,,2,0,2,6e-06,31
en.wikipedia.org/wiki/Category:Kanpur_division_geography_stubs,,15,0,15,7e-06,31
en.wikipedia.org/wiki/Category:Articles_using_infobox_body_of_water_without_image,,1,0,1,6e-06,31
en.wikipedia.org/wiki/Category:Articles_using_infobox_body_of_water_without_image_bathymetry,,1,0,1,6e-06,31
en.m.wikipedia.org/w/index.php?title=Moti_Jheel&mobileaction=toggle_view_mobile,,1,0,1,6e-06,31
en.wikipedia.org/wiki/Category:Use_Indian_English_from_January_2016,,11,0,11,7e-06,31
en.wikipedia.org/w/index.php?title=Special:CreateAccount&returnto=Materials+Science+and+Engineering,,1,0,1,7e-06,31
en.wikipedia.org/w/index.php?title=Special:UserLogin&returnto=Materials+Science+and+Engineering,,1,0,1,7e-06,31
wikidata.org/wiki/Special:EntityPage/Q16873518,,1,0,1,7e-06,31
en.wikipedia.org/wiki/Talk:Materials_Science_and_Engineering,,1,0,1,7e-06,31
en.wikipedia.org/w/index.php?title=Materials_Science_and_Engineering&action=edit,,1,0,1,7e-06,31
en.wikipedia.org/w/index.php?title=Materials_Science_and_Engineering&action=history,,1,0,1,7e-06,31
en.wikipedia.org/wiki/Special:WhatLinksHere/Materials_Science_and_Engineering,,1,0,1,7e-06,31
en.wikipedia.org/wiki/Special:RecentChangesLinked/Materials_Science_and_Engineering,,1,0,1,7e-06,31
en.wikipedia.org/w/index.php?title=Materials_Science_and_Engineering&oldid=868974206,,1,0,1,7e-06,31
en.wikipedia.org/w/index.php?title=Materials_Science_and_Engineering&action=info,,1,0,1,7e-06,31
en.wikipedia.org/w/index.php?title=Materials_Science_and_Engineering&printable=yes,,1,0,1,7e-06,31
en.wikipedia.org/wiki/Materials_Science_and_Engineering_A,,1,0,1,7e-06,31
en.wikipedia.org/wiki/Materials_Science_and_Engineering_B,,1,0,1,7e-06,31
en.wikipedia.org/wiki/Materials_Science_and_Engineering_C,,1,0,1,7e-06,31
en.wikipedia.org/wiki/Materials_Science_and_Engineering_R,,1,0,1,7e-06,31
en.wikipedia.org/wiki/File:DAB_list_gray.svg,,1,0,1,7e-06,31
en.wikipedia.org/wiki/Wikipedia:Set_index_articles,,1,0,1,7e-06,31
en.wikipedia.org/wiki/Category:Set_index_articles,,1,0,1,7e-06,31
en.wikipedia.org/wiki/Category:Materials_science_journals,,1,0,1,7e-06,31
en.wikipedia.org/wiki/Category:Elsevier_academic_journals,,1,0,1,7e-06,31
en.wikipedia.org/wiki/Category:All_set_index_articles,,1,0,1,7e-06,31
upload.wikimedia.org/wikipedia/commons/thumb/8/8c/DAB_list_gray.svg/40px-DAB_list_gray.svg.png,,1,0,1,7e-06,31
en.wikipedia.org/w/index.php?title=Special:CreateAccount&returnto=Massacre+Ghat,,1,0,1,6e-06,31
en.wikipedia.org/w/index.php?title=Special:UserLogin&returnto=Massacre+Ghat,,1,0,1,6e-06,31
wikidata.org/wiki/Special:EntityPage/Q15250609,,1,0,1,6e-06,31
en.wikipedia.org/wiki/Talk:Massacre_Ghat,,1,0,1,6e-06,31
en.wikipedia.org/w/index.php?title=Massacre_Ghat&action=edit,,1,0,1,6e-06,31
en.wikipedia.org/w/index.php?title=Massacre_Ghat&action=history,,1,0,1,6e-06,31
en.wikipedia.org/wiki/Special:WhatLinksHere/Massacre_Ghat,,1,0,1,6e-06,31
en.wikipedia.org/wiki/Special:RecentChangesLinked/Massacre_Ghat,,1,0,1,6e-06,31
en.wikipedia.org/w/index.php?title=Massacre_Ghat&oldid=1307801385,,1,0,1,6e-06,31
en.wikipedia.org/w/index.php?title=Massacre_Ghat&action=info,,1,0,1,6e-06,31
en.wikipedia.org/w/index.php?title=Massacre_Ghat&printable=yes,,1,0,1,6e-06,31
commons.wikimedia.org/wiki/Category:Massacre_Ghat,,1,0,1,6e-06,31
en.wikipedia.org/wiki/Special:EditPage/Massacre_Ghat,,1,0,1,6e-06,31
"google.com/search?as_eq=wikipedia&q=""Massacre+Ghat""",,1,0,1,6e-06,31
"google.com/search?tbm=nws&q=""Massacre+Ghat""+-wikipedia&tbs=ar:1",,1,0,1,6e-06,31
"google.com/search?&q=""Massacre+Ghat""&tbs=bkt:s&tbm=bks",,1,0,1,6e-06,31
"google.com/search?tbs=bks:1&q=""Massacre+Ghat""+-wikipedia",,1,0,1,6e-06,31
"scholar.google.com/scholar?q=""Massacre+Ghat""",,1,0,1,6e-06,31
"jstor.org/action/doBasicSearch?Query=""Massacre+Ghat""&acc=on&wc=on",,1,0,1,6e-06,31
en.wikipedia.org/wiki/File:Oskanpur-6.jpg,,1,0,1,6e-06,31
en.wikipedia.org/w/index.php?title=Massacre_Ghat&action=edit&section=1,,1,0,1,6e-06,31
en.wikipedia.org/wiki/River_Ganges,,1,0,1,6e-06,31
en.wikipedia.org/wiki/Deities,,1,0,1,6e-06,31
en.wikipedia.org/wiki/Pantheon_(gods),,1,0,1,6e-06,31
en.wikipedia.org/wiki/Sea,,1,0,1,6e-06,31
en.wikipedia.org/w/index.php?title=Massacre_Ghat&action=edit&section=2,,1,0,1,6e-06,31
en.wikipedia.org/w/index.php?title=Massacre_Ghat&action=edit&section=3,,1,0,1,6e-06,31
en.wikipedia.org/wiki/Bibighar_Massacre,,2,0,2,7e-06,31
"en.wikipedia.org/wiki/File:Massacre_Ghat_(Satichaura),_Kanpur.jpg",,1,0,1,6e-06,31
en.wikipedia.org/w/index.php?title=Massacre_Ghat&action=edit&section=4,,1,0,1,6e-06,31
en.wikipedia.org/wiki/File:Oskanpur-9.jpg,,1,0,1,6e-06,31
en.wikipedia.org/wiki/Wrestlers,,1,0,1,6e-06,31
en.wikipedia.org/w/index.php?title=Massacre_Ghat&action=edit&section=5,,1,0,1,6e-06,31
timesofindia.indiatimes.com/city/kanpur/even-ganga-shuns-massacre-ghat/articleshow/47860896.cms,,1,0,1,6e-06,31
en.wikipedia.org/wiki/Category:Use_dmy_dates_from_May_2018,,12,0,12,7e-06,31
en.wikipedia.org/wiki/Category:Use_Indian_English_from_May_2018,,13,0,13,7e-06,31
en.wikipedia.org/wiki/Category:Articles_with_unsourced_statements_from_September_2014,,1,0,1,6e-06,31
en.m.wikipedia.org/w/index.php?title=Massacre_Ghat&mobileaction=toggle_view_mobile,,1,0,1,6e-06,31
upload.wikimedia.org/wikipedia/commons/thumb/8/8b/Oskanpur-6.jpg/250px-Oskanpur-6.jpg,,1,0,1,6e-06,31
upload.wikimedia.org/wikipedia/commons/thumb/7/70/Oskanpur-9.jpg/330px-Oskanpur-9.jpg,,1,0,1,6e-06,31
wikimediafoundation.org/our-work/wikimedia-projects/,,2,0,2,7e-06,31
en.wikipedia.org/wiki/Lucknow_City_Transport_Services,,6,0,6,7e-06,31
en.wikipedia.org/wiki/Template:Lucknow,,6,0,6,7e-06,31
en.wikipedia.org/wiki/Template_talk:Lucknow,,6,0,6,7e-06,31
en.wikipedia.org/wiki/Special:EditPage/Template:Lucknow,,6,0,6,7e-06,31
en.wikipedia.org/wiki/Badshah_Nagar,,6,0,6,7e-06,31
en.wikipedia.org/wiki/Dilkusha,,6,0,6,7e-06,31
en.wikipedia.org/wiki/Gomti_Nagar,,6,0,6,7e-06,31
"en.wikipedia.org/wiki/Gosainganj,_Lucknow",,6,0,6,7e-06,31
"en.wikipedia.org/wiki/Indira_Nagar,_Lucknow",,6,0,6,7e-06,31
en.wikipedia.org/wiki/Itaunja,,6,0,6,7e-06,31
en.wikipedia.org/wiki/Kakori,,6,0,6,7e-06,31
en.wikipedia.org/wiki/Malihabad,,6,0,6,7e-06,31
en.wikipedia.org/wiki/Mahatma_Gandhi_Road_(Lucknow),,6,0,6,7e-06,31
en.wikipedia.org/wiki/Mahona,,6,0,6,7e-06,31
en.wikipedia.org/wiki/Sarvodaya_Nagar,,6,0,6,7e-06,31
en.wikipedia.org/wiki/Trans-Gomti_area,,6,0,6,7e-06,31
"en.wikipedia.org/wiki/The_Residency,_Lucknow",,6,0,6,7e-06,31
en.wikipedia.org/wiki/Ambedkar_Memorial_Park,,6,0,6,7e-06,31
en.wikipedia.org/wiki/Dilkusha_Kothi,,6,0,6,7e-06,31
en.wikipedia.org/wiki/Husainabad_Clock_Tower,,6,0,6,7e-06,31
"en.wikipedia.org/wiki/Sankat_Mochan_Hanuman_Temple,_Lucknow",,6,0,6,7e-06,31
en.wikipedia.org/wiki/Janeshwar_Mishra_Park,,6,0,6,7e-06,31
en.wikipedia.org/wiki/Safed_Baradari,,6,0,6,7e-06,31
"en.wikipedia.org/wiki/La_Martinière_College,_Lucknow",,6,0,6,7e-06,31
en.wikipedia.org/wiki/National_Botanical_Research_Institute,,7,0,7,7e-06,31
"en.wikipedia.org/wiki/Raj_Bhavan,_Lucknow",,6,0,6,7e-06,31
en.wikipedia.org/wiki/Rumi_Darwaza,,6,0,6,7e-06,31
en.wikipedia.org/wiki/Imambara_Shah_Najaf,,6,0,6,7e-06,31
"en.wikipedia.org/wiki/Sri_Ramakrishna_Math,_Lucknow",,6,0,6,7e-06,31
"en.wikipedia.org/wiki/State_Museum,_Lucknow",,6,0,6,7e-06,31
en.wikipedia.org/wiki/Transport_Nagar_railway_station,,6,0,6,7e-06,31
en.wikipedia.org/wiki/Shaheed_Path,,6,0,6,7e-06,31
en.wikipedia.org/wiki/Lohia_path,,6,0,6,7e-06,31
en.wikipedia.org/wiki/Kalidas_Marg,,6,0,6,7e-06,31
en.wikipedia.org/wiki/Gwynne_Road,,6,0,6,7e-06,31
en.wikipedia.org/wiki/List_of_mayors_of_Lucknow,,6,0,6,7e-06,31
en.wikipedia.org/wiki/Lucknow_Police,,6,0,6,7e-06,31
en.wikipedia.org/wiki/Lucknow_Municipal_Corporation,,6,0,6,7e-06,31
en.wikipedia.org/wiki/St._Francis%27_College,,6,0,6,7e-06,31
en.wikipedia.org/wiki/Ekana_Cricket_Stadium,,7,0,7,7e-06,31
"en.wikipedia.org/wiki/K._D._Singh_Babu_Stadium,_Lucknow",,7,0,7,7e-06,31
en.wikipedia.org/wiki/Lucknow_University_Ground,,7,0,7,7e-06,31
en.wikipedia.org/wiki/Category:Lucknow,,6,0,6,7e-06,31
en.wikipedia.org/wiki/Category:Transport_in_Lucknow,,4,0,4,7e-06,31
en.wikipedia.org/w/index.php?title=Special:CreateAccount&returnto=Lohia+Machinery+Limited,,2,0,2,6e-06,31
en.wikipedia.org/w/index.php?title=Special:UserLogin&returnto=Lohia+Machinery+Limited,,2,0,2,6e-06,31
de.wikipedia.org/wiki/Lohia_Machinery_Limited,,2,0,2,6e-06,31
fa.wikipedia.org/wiki/لوهیا_مشینری,,2,0,2,6e-06,31
fr.wikipedia.org/wiki/Lohia_Machinery_Limited,,2,0,2,6e-06,31
it.wikipedia.org/wiki/LML_(azienda),,2,0,2,6e-06,31
arz.wikipedia.org/wiki/لوهيا_مشينرى_ليمتد,,2,0,2,6e-06,31
nl.wikipedia.org/wiki/LML,,2,0,2,6e-06,31
ja.wikipedia.org/wiki/LML,,2,0,2,6e-06,31
wikidata.org/wiki/Special:EntityPage/Q3820394,,2,0,2,6e-06,31
en.wikipedia.org/wiki/Talk:Lohia_Machinery_Limited,,2,0,2,6e-06,31
en.wikipedia.org/w/index.php?title=Lohia_Machinery_Limited&action=edit,,2,0,2,6e-06,31
en.wikipedia.org/w/index.php?title=Lohia_Machinery_Limited&action=history,,2,0,2,6e-06,31
en.wikipedia.org/wiki/Special:WhatLinksHere/Lohia_Machinery_Limited,,2,0,2,6e-06,31
en.wikipedia.org/wiki/Special:RecentChangesLinked/Lohia_Machinery_Limited,,2,0,2,6e-06,31
en.wikipedia.org/w/index.php?title=Lohia_Machinery_Limited&oldid=1277689031,,2,0,2,6e-06,31
en.wikipedia.org/w/index.php?title=Lohia_Machinery_Limited&action=info,,2,0,2,6e-06,31
en.wikipedia.org/w/index.php?title=Lohia_Machinery_Limited&printable=yes,,2,0,2,6e-06,31
commons.wikimedia.org/wiki/Category:LML,,2,0,2,6e-06,31
en.wikipedia.org/wiki/LML_(disambiguation),,2,0,2,6e-06,31
en.wikipedia.org/wiki/Special:EditPage/Lohia_Machinery_Limited,,2,0,2,6e-06,31
"google.com/search?as_eq=wikipedia&q=""Lohia+Machinery+Limited""",,2,0,2,6e-06,31
"google.com/search?tbm=nws&q=""Lohia+Machinery+Limited""+-wikipedia&tbs=ar:1",,2,0,2,6e-06,31
"google.com/search?&q=""Lohia+Machinery+Limited""&tbs=bkt:s&tbm=bks",,2,0,2,6e-06,31
"google.com/search?tbs=bks:1&q=""Lohia+Machinery+Limited""+-wikipedia",,2,0,2,6e-06,31
"scholar.google.com/scholar?q=""Lohia+Machinery+Limited""",,2,0,2,6e-06,31
"jstor.org/action/doBasicSearch?Query=""Lohia+Machinery+Limited""&acc=on&wc=on",,2,0,2,6e-06,31
en.wikipedia.org/wiki/File:LML_Logo.svg,,2,0,2,6e-06,31
en.wikipedia.org/wiki/Motorcycle,,2,0,2,6e-06,31
en.wikipedia.org/wiki/Managing_Director,,3,0,3,6e-06,31
en.wikipedia.org/wiki/Director_(business),,3,0,3,7e-06,31
en.wikipedia.org/wiki/Scooter_(motorcycle),,2,0,2,6e-06,31
en.wikipedia.org/w/index.php?title=Lohia_Machinery_Limited&action=edit&section=1,,2,0,2,6e-06,31
en.wikipedia.org/wiki/Private_limited_company,,2,0,2,6e-06,31
en.wikipedia.org/wiki/Piaggio,,3,0,3,6e-06,31
en.wikipedia.org/wiki/Stella_(scooter),,2,0,2,6e-06,31
en.wikipedia.org/wiki/Euro_3,,2,0,2,6e-06,31
en.wikipedia.org/wiki/Daelim_Motor_Company,,2,0,2,6e-06,31
en.wikipedia.org/wiki/Four-stroke-engine,,2,0,2,6e-06,31
en.wikipedia.org/wiki/Multi-valve,,2,0,2,6e-06,31
en.wikipedia.org/wiki/TVS_Motor_Company,,3,0,3,6e-06,31
en.wikipedia.org/wiki/Bajaj_Auto,,4,0,4,7e-06,31
en.wikipedia.org/wiki/Suzuki,,2,0,2,6e-06,31
en.wikipedia.org/wiki/Credit_Suisse,,3,0,3,6e-06,31
en.wikipedia.org/wiki/Vespa,,3,0,3,6e-06,31
en.wikipedia.org/w/index.php?title=Lohia_Machinery_Limited&action=edit&section=2,,2,0,2,6e-06,31
en.wikipedia.org/wiki/List_of_motor_scooter_manufacturers_and_brands,,2,0,2,6e-06,31
en.wikipedia.org/w/index.php?title=Lohia_Machinery_Limited&action=edit&section=3,,2,0,2,6e-06,31
indianauto.com/bikes1/lml/index.htm,,2,0,2,6e-06,31
economictimes.indiatimes.com/lml-ltd/infocompanyhistory/companyid-13452.cms,,2,0,2,6e-06,31
scooterlab.uk/lml-scooter-factory-insolvency-notice-news/,,2,0,2,6e-06,31
en.wikipedia.org/w/index.php?title=Lohia_Machinery_Limited&action=edit&section=4,,2,0,2,6e-06,31
commons.wikimedia.org/wiki/Category:Lohia_Machinery_Limited,,2,0,2,6e-06,31
web.archive.org/web/20131029192037/http://lmlglobal.in/Home,,2,0,2,6e-06,31
en.wikipedia.org/wiki/Template:Automotive_industry_in_India,,2,0,2,6e-06,31
en.wikipedia.org/wiki/Template_talk:Automotive_industry_in_India,,2,0,2,6e-06,31
en.wikipedia.org/wiki/Special:EditPage/Template:Automotive_industry_in_India,,2,0,2,6e-06,31
en.wikipedia.org/wiki/Ajanta_Group,,2,0,2,6e-06,31
en.wikipedia.org/wiki/Ather_Energy,,3,0,3,6e-06,31
en.wikipedia.org/wiki/Atul_Auto,,3,0,3,6e-06,31
en.wikipedia.org/wiki/KTM,,2,0,2,6e-06,31
en.wikipedia.org/wiki/Husqvarna_Motorcycles,,2,0,2,6e-06,31
en.wikipedia.org/wiki/Triumph_Motorcycles_Ltd,,3,0,3,6e-06,31
en.wikipedia.org/wiki/Eicher_Motors,,3,0,3,6e-06,31
en.wikipedia.org/wiki/Royal_Enfield,,5,0,5,7e-06,31
en.wikipedia.org/wiki/Escorts_Limited,,2,0,2,6e-06,31
en.wikipedia.org/wiki/Force_Motors,,3,0,3,6e-06,31
en.wikipedia.org/wiki/Hradyesh,,2,0,2,6e-06,31
en.wikipedia.org/wiki/ICML_Motors,,2,0,2,6e-06,31
en.wikipedia.org/wiki/Kerala_Automobiles_Limited,,3,0,3,6e-06,31
en.wikipedia.org/wiki/Mahindra_Group,,2,0,2,6e-06,31
en.wikipedia.org/wiki/Mahindra_Electric,,2,0,2,6e-06,31
en.wikipedia.org/wiki/Mahindra_Two_Wheelers,,2,0,2,6e-06,31
en.wikipedia.org/wiki/Jawa_Moto,,2,0,2,6e-06,31
en.wikipedia.org/wiki/Mahindra_Tractors,,2,0,2,6e-06,31
en.wikipedia.org/wiki/Mahindra_Truck_and_Bus_Division,,2,0,2,6e-06,31
en.wikipedia.org/wiki/Okinawa_Autotech,,2,0,2,6e-06,31
en.wikipedia.org/wiki/Ola_Electric,,3,0,3,6e-06,31
en.wikipedia.org/wiki/Omega_Seiki_Mobility,,2,0,2,6e-06,31
en.wikipedia.org/wiki/Tractors_and_Farm_Equipment_Limited,,2,0,2,6e-06,31
en.wikipedia.org/wiki/Tara_International,,2,0,2,6e-06,31
en.wikipedia.org/wiki/Tata_Motors_Cars,,4,0,4,6e-06,31
en.wikipedia.org/wiki/Norton_Motorcycles,,2,0,2,6e-06,31
en.wikipedia.org/wiki/BMW_Motorrad,,2,0,2,6e-06,31
en.wikipedia.org/wiki/Ultraviolette_Automotive,,2,0,2,6e-06,31
en.wikipedia.org/wiki/Asia_Motor_Works,,2,0,2,6e-06,31
en.wikipedia.org/wiki/Chinkara_Motors,,2,0,2,6e-06,31
en.wikipedia.org/wiki/Hero_Motors,,2,0,2,6e-06,31
en.wikipedia.org/wiki/Hindustan_Motors,,2,0,2,6e-06,31
en.wikipedia.org/wiki/Premier_Automobiles_Limited,,2,0,2,6e-06,31
en.wikipedia.org/wiki/Rajah_Motors,,2,0,2,6e-06,31
en.wikipedia.org/wiki/San_Storm,,2,0,2,6e-06,31
en.wikipedia.org/wiki/Sipani,,2,0,2,6e-06,31
en.wikipedia.org/wiki/Standard_(Indian_automobile),,2,0,2,6e-06,31
en.wikipedia.org/wiki/Swaraj_Mazda,,2,0,2,6e-06,31
en.wikipedia.org/wiki/JSW_MG_Motor_India,,2,0,2,6e-06,31
en.wikipedia.org/wiki/SML_Isuzu,,2,0,2,6e-06,31
en.wikipedia.org/wiki/Tata_Daewoo,,4,0,4,6e-06,31
en.wikipedia.org/wiki/Tata_Hitachi_Construction_Machinery,,4,0,4,6e-06,31
en.wikipedia.org/wiki/Tata_Marcopolo,,2,0,2,6e-06,31
en.wikipedia.org/wiki/Ford_India,,2,0,2,6e-06,31
en.wikipedia.org/wiki/General_Motors_India,,2,0,2,6e-06,31
en.wikipedia.org/wiki/Mahindra_Renault_Limited,,2,0,2,6e-06,31
en.wikipedia.org/wiki/Anand_Group,,2,0,2,6e-06,31
mahindraaccelo.com/mobility,,2,0,2,6e-06,31
en.wikipedia.org/wiki/Apollo_Tyres,,3,0,3,6e-06,31
en.wikipedia.org/wiki/CEAT_Limited,,2,0,2,6e-06,31
en.wikipedia.org/wiki/JK_Tyre,,2,0,2,6e-06,31
en.wikipedia.org/wiki/Motherson_Sumi_Systems,,2,0,2,6e-06,31
en.wikipedia.org/wiki/MRF_(company),,4,0,4,6e-06,31
en.wikipedia.org/wiki/Pricol,,2,0,2,6e-06,31
en.wikipedia.org/wiki/Rane_(Madras),,2,0,2,6e-06,31
en.wikipedia.org/wiki/Rane_Engine_Valve_Limited,,2,0,2,6e-06,31
en.wikipedia.org/wiki/BMW_India,,2,0,2,6e-06,31
en.wikipedia.org/wiki/Daimler_India_Commercial_Vehicles,,3,0,3,6e-06,31
en.wikipedia.org/wiki/Mercedes-Benz_India,,2,0,2,6e-06,31
en.wikipedia.org/wiki/Citroën_India,,2,0,2,6e-06,31
en.wikipedia.org/wiki/FCA_India_Automobiles,,2,0,2,6e-06,31
en.wikipedia.org/wiki/Honda_India,,2,0,2,6e-06,31
en.wikipedia.org/wiki/Honda_Motorcycle_and_Scooter_India,,2,0,2,6e-06,31
en.wikipedia.org/wiki/Hyundai_Motor_India,,3,0,3,6e-06,31
en.wikipedia.org/wiki/Kia_India,,2,0,2,6e-06,31
en.wikipedia.org/wiki/Yamaha_Motor_Company,,2,0,2,6e-06,31
en.wikipedia.org/wiki/Isuzu_Motors_India,,2,0,2,6e-06,31
en.wikipedia.org/wiki/Škoda_Auto_Volkswagen_India,,2,0,2,6e-06,31
en.wikipedia.org/wiki/Audi_India,,2,0,2,6e-06,31
en.wikipedia.org/wiki/Porsche_India,,2,0,2,6e-06,31
en.wikipedia.org/wiki/Škoda_Auto_India_Private_Limited,,2,0,2,6e-06,31
en.wikipedia.org/wiki/Volkswagen_India,,2,0,2,6e-06,31
en.wikipedia.org/wiki/Renault_Nissan_Automotive_India_Private_Limited,,2,0,2,6e-06,31
en.wikipedia.org/wiki/Nissan_Motor_India_Private_Limited,,2,0,2,6e-06,31
en.wikipedia.org/wiki/Renault_India_Private_Limited,,2,0,2,6e-06,31
en.wikipedia.org/wiki/Suzuki_Motorcycle_India_Limited,,2,0,2,6e-06,31
en.wikipedia.org/wiki/Toyota_Kirloskar_Motor,,2,0,2,6e-06,31
en.wikipedia.org/wiki/TACO_Faurecia_Design_Center,,2,0,2,6e-06,31
en.wikipedia.org/wiki/Automotive_Component_Manufacturers_Association_of_India,,2,0,2,6e-06,31
en.wikipedia.org/wiki/Auto_Expo,,4,0,4,7e-06,31
en.wikipedia.org/wiki/Automechanika,,2,0,2,6e-06,31
en.wikipedia.org/wiki/Global_NCAP,,2,0,2,6e-06,31
en.wikipedia.org/wiki/SUN_Mobility,,2,0,2,6e-06,31
en.wikipedia.org/wiki/Category:Automotive_industry_in_India,,2,0,2,6e-06,31
en.wikipedia.org/wiki/Category:Vehicle_manufacturing_companies_established_in_1972,,2,0,2,6e-06,31
en.wikipedia.org/wiki/Category:Scooter_manufacturers,,2,0,2,6e-06,31
en.wikipedia.org/wiki/Category:Motorcycle_manufacturers_of_India,,2,0,2,6e-06,31
en.wikipedia.org/wiki/Category:Indian_brands,,2,0,2,6e-06,31
en.wikipedia.org/wiki/Category:Vehicle_manufacturing_companies_disestablished_in_2017,,2,0,2,6e-06,31
en.wikipedia.org/wiki/Category:Indian_companies_disestablished_in_2017,,2,0,2,6e-06,31
en.wikipedia.org/wiki/Category:Indian_companies_established_in_1972,,2,0,2,6e-06,31
en.wikipedia.org/wiki/Category:Economic_history_of_Uttar_Pradesh,,2,0,2,6e-06,31
en.wikipedia.org/wiki/Category:1972_establishments_in_Uttar_Pradesh,,2,0,2,6e-06,31
en.wikipedia.org/wiki/Category:Companies_formerly_listed_on_the_National_Stock_Exchange_of_India,,2,0,2,6e-06,31
en.wikipedia.org/wiki/Category:Companies_formerly_listed_on_the_Bombay_Stock_Exchange,,2,0,2,6e-06,31
en.wikipedia.org/wiki/Category:Wikipedia_articles_needing_clarification_from_July_2010,,3,0,3,6e-06,31
en.wikipedia.org/wiki/Category:Articles_with_unsourced_statements_from_August_2012,,2,0,2,6e-06,31
en.wikipedia.org/wiki/Category:Commons_category_link_is_defined_as_the_pagename,,2,0,2,6e-06,31
en.m.wikipedia.org/w/index.php?title=Lohia_Machinery_Limited&mobileaction=toggle_view_mobile,,2,0,2,6e-06,31
upload.wikimedia.org/wikipedia/commons/thumb/6/6d/LML_Logo.svg/250px-LML_Logo.svg.png,,2,0,2,6e-06,31
gnu.org/licenses/gpl-3.0.html,,2,0,2,7e-06,31
en.wikipedia.org/w/index.php?title=Special:CreateAccount&returnto=Kanpur+Sangrahalaya,,1,0,1,6e-06,31
en.wikipedia.org/w/index.php?title=Special:UserLogin&returnto=Kanpur+Sangrahalaya,,1,0,1,6e-06,31
as.wikipedia.org/wiki/কানপুৰ_সংগ্ৰহালয়,,1,0,1,6e-06,31
bn.wikipedia.org/wiki/কানপুর_সংগ্রহালয়,,1,0,1,6e-06,31
no.wikipedia.org/wiki/Kanpur_Sangrahalaya,,1,0,1,6e-06,31
ta.wikipedia.org/wiki/கான்பூர்_அருங்காட்சியகம்,,1,0,1,6e-06,31
wikidata.org/wiki/Special:EntityPage/Q6364385,,1,0,1,6e-06,31
en.wikipedia.org/wiki/Talk:Kanpur_Sangrahalaya,,1,0,1,6e-06,31
en.wikipedia.org/w/index.php?title=Kanpur_Sangrahalaya&action=edit,,1,0,1,6e-06,31
en.wikipedia.org/w/index.php?title=Kanpur_Sangrahalaya&action=history,,1,0,1,6e-06,31
en.wikipedia.org/wiki/Special:WhatLinksHere/Kanpur_Sangrahalaya,,1,0,1,6e-06,31
en.wikipedia.org/wiki/Special:RecentChangesLinked/Kanpur_Sangrahalaya,,1,0,1,6e-06,31
en.wikipedia.org/w/index.php?title=Kanpur_Sangrahalaya&oldid=1170728982,,1,0,1,6e-06,31
en.wikipedia.org/w/index.php?title=Kanpur_Sangrahalaya&action=info,,1,0,1,6e-06,31
en.wikipedia.org/w/index.php?title=Kanpur_Sangrahalaya&printable=yes,,1,0,1,6e-06,31
en.wikipedia.org/wiki/Museum,,1,0,1,6e-06,31
en.wikipedia.org/w/index.php?title=King_Edward_Memorial_Hall&action=edit&redlink=1,,1,0,1,6e-06,31
en.wikipedia.org/wiki/Edward_VII,,1,0,1,6e-06,31
en.wikipedia.org/w/index.php?title=Kanpur_Sangrahalaya&action=edit&section=1,,1,0,1,6e-06,31
en.wikipedia.org/w/index.php?title=Kanpur_Sangrahalaya&action=edit&section=2,,1,0,1,6e-06,31
mapsofindia.com/kanpur/places-of-interest/phool-bagh.html,,1,0,1,6e-06,31
en.wikipedia.org/wiki/Category:Museums_in_Uttar_Pradesh,,1,0,1,6e-06,31
en.wikipedia.org/wiki/Category:Local_museums_in_India,,1,0,1,6e-06,31
en.m.wikipedia.org/w/index.php?title=Kanpur_Sangrahalaya&mobileaction=toggle_view_mobile,,1,0,1,6e-06,31
en.wikipedia.org/wiki/Aam_Aadmi_Party,,7,0,7,7e-06,31
en.wikipedia.org/w/index.php?title=Special:CreateAccount&returnto=Kanpur+Memorial+Church,,1,0,1,6e-06,31
en.wikipedia.org/w/index.php?title=Special:UserLogin&returnto=Kanpur+Memorial+Church,,1,0,1,6e-06,31
hi.wikipedia.org/wiki/कानपुर_मैमोरियल_चर्च,,1,0,1,6e-06,31
wikidata.org/wiki/Special:EntityPage/Q12419141,,1,0,1,6e-06,31
en.wikipedia.org/wiki/Talk:Kanpur_Memorial_Church,,1,0,1,6e-06,31
en.wikipedia.org/w/index.php?title=Kanpur_Memorial_Church&action=edit,,1,0,1,6e-06,31
en.wikipedia.org/w/index.php?title=Kanpur_Memorial_Church&action=history,,1,0,1,6e-06,31
en.wikipedia.org/wiki/Special:WhatLinksHere/Kanpur_Memorial_Church,,1,0,1,6e-06,31
en.wikipedia.org/wiki/Special:RecentChangesLinked/Kanpur_Memorial_Church,,1,0,1,6e-06,31
en.wikipedia.org/w/index.php?title=Kanpur_Memorial_Church&oldid=1296659198,,1,0,1,6e-06,31
en.wikipedia.org/w/index.php?title=Kanpur_Memorial_Church&action=info,,1,0,1,6e-06,31
en.wikipedia.org/w/index.php?title=Kanpur_Memorial_Church&printable=yes,,1,0,1,6e-06,31
commons.wikimedia.org/wiki/Category:Kanpur_Memorial_Church,,1,0,1,6e-06,31
en.wikipedia.org/wiki/Special:EditPage/Kanpur_Memorial_Church,,1,0,1,6e-06,31
"google.com/search?as_eq=wikipedia&q=""Kanpur+Memorial+Church""",,1,0,1,6e-06,31
"google.com/search?tbm=nws&q=""Kanpur+Memorial+Church""+-wikipedia&tbs=ar:1",,1,0,1,6e-06,31
"google.com/search?&q=""Kanpur+Memorial+Church""&tbs=bkt:s&tbm=bks",,1,0,1,6e-06,31
"google.com/search?tbs=bks:1&q=""Kanpur+Memorial+Church""+-wikipedia",,1,0,1,6e-06,31
"scholar.google.com/scholar?q=""Kanpur+Memorial+Church""",,1,0,1,6e-06,31
"jstor.org/action/doBasicSearch?Query=""Kanpur+Memorial+Church""&acc=on&wc=on",,1,0,1,6e-06,31
en.wikipedia.org/wiki/Church_(building),,1,0,1,6e-06,31
en.wikipedia.org/wiki/Church_of_North_India,,1,0,1,6e-06,31
en.wikipedia.org/wiki/United_Protestant,,1,0,1,6e-06,31
en.wikipedia.org/w/index.php?title=Kanpur_Memorial_Church&action=edit&section=1,,1,0,1,6e-06,31
en.wikipedia.org/w/index.php?title=Kanpur_Memorial_Church&action=edit&section=2,,1,0,1,6e-06,31
en.wikipedia.org/wiki/East_Bengal_Railway,,1,0,1,6e-06,31
en.wikipedia.org/w/index.php?title=Kanpur_Memorial_Church&action=edit&section=3,,1,0,1,6e-06,31
en.wikipedia.org/wiki/Special:BookSources/978-1-904777-00-7,,1,0,1,6e-06,31
en.wikipedia.org/w/index.php?title=Kanpur_Memorial_Church&action=edit&section=4,,1,0,1,6e-06,31
commons.wikimedia.org/wiki/Category:Cawnpore_Memorial,,1,0,1,6e-06,31
en.wikipedia.org/wiki/Template:India-church-stub,,1,0,1,6e-06,31
en.wikipedia.org/wiki/Template_talk:India-church-stub,,1,0,1,6e-06,31
en.wikipedia.org/wiki/Special:EditPage/Template:India-church-stub,,1,0,1,6e-06,31
en.wikipedia.org/wiki/Category:Churches_in_Uttar_Pradesh,,1,0,1,6e-06,31
en.wikipedia.org/wiki/Category:19th-century_Anglican_church_buildings_in_India,,1,0,1,6e-06,31
en.wikipedia.org/wiki/Category:Churches_completed_in_1875,,1,0,1,6e-06,31
en.wikipedia.org/wiki/Category:1875_establishments_in_India,,1,0,1,6e-06,31
en.wikipedia.org/wiki/Category:Indian_church_stubs,,1,0,1,6e-06,31
en.wikipedia.org/wiki/Category:Articles_needing_additional_references_from_June_2018,,1,0,1,6e-06,31
en.m.wikipedia.org/w/index.php?title=Kanpur_Memorial_Church&mobileaction=toggle_view_mobile,,1,0,1,6e-06,31
upload.wikimedia.org/wikipedia/commons/thumb/2/21/Church.svg/20px-Church.svg.png,,1,0,1,6e-06,31
en.wikipedia.org/w/index.php?title=Special:CreateAccount&returnto=Kanpur+Metro,,1,0,1,6e-06,31
en.wikipedia.org/w/index.php?title=Special:UserLogin&returnto=Kanpur+Metro,,1,0,1,6e-06,31
bn.wikipedia.org/wiki/কানপুর_মেট্রো,,1,0,1,6e-06,31
de.wikipedia.org/wiki/Metro_Kanpur,,1,0,1,6e-06,31
eo.wikipedia.org/wiki/Metroo_de_Kanpur,,1,0,1,6e-06,31
fr.wikipedia.org/wiki/Métro_de_Kanpur,,1,0,1,6e-06,31
hi.wikipedia.org/wiki/कानपुर_मेट्रो,,1,0,1,6e-06,31
id.wikipedia.org/wiki/Kanpur_Metro,,1,0,1,6e-06,31
mai.wikipedia.org/wiki/कानपुर_मेट्रो,,1,0,1,6e-06,31
mr.wikipedia.org/wiki/कानपूर_मेट्रो,,1,0,1,6e-06,31
ru.wikipedia.org/wiki/Канпурский_метрополитен,,1,0,1,6e-06,31
zh.wikipedia.org/wiki/坎普爾地鐵,,1,0,1,6e-06,31
wikidata.org/wiki/Special:EntityPage/Q17063873,,1,0,1,6e-06,31
en.wikipedia.org/wiki/Talk:Kanpur_Metro,,1,0,1,6e-06,31
en.wikipedia.org/w/index.php?title=Kanpur_Metro&action=edit,,1,0,1,6e-06,31
en.wikipedia.org/w/index.php?title=Kanpur_Metro&action=history,,1,0,1,6e-06,31
en.wikipedia.org/wiki/Special:WhatLinksHere/Kanpur_Metro,,1,0,1,6e-06,31
en.wikipedia.org/wiki/Special:RecentChangesLinked/Kanpur_Metro,,1,0,1,6e-06,31
en.wikipedia.org/w/index.php?title=Kanpur_Metro&oldid=1308976334,,1,0,1,6e-06,31
en.wikipedia.org/w/index.php?title=Kanpur_Metro&action=info,,1,0,1,6e-06,31
en.wikipedia.org/w/index.php?title=Kanpur_Metro&printable=yes,,1,0,1,6e-06,31
commons.wikimedia.org/wiki/Category:Kanpur_Metro,,1,0,1,6e-06,31
en.wikipedia.org/wiki/Blue_Line_(Kanpur_Metro),,2,0,2,6e-06,31
kanpur.upmetrorail.com/,,1,0,1,6e-06,31
en.wikipedia.org/wiki/Headway,,2,0,2,6e-06,31
en.wikipedia.org/wiki/Track_gauge,,4,0,4,6e-06,31
en.wikipedia.org/wiki/Standard_gauge,,1,0,1,6e-06,31
en.wikipedia.org/wiki/Railway_electrification,,5,0,5,7e-06,31
en.wikipedia.org/w/index.php?title=Kanpur_Metro&action=edit&section=1,,1,0,1,6e-06,31
en.wikipedia.org/wiki/RITES,,1,0,1,6e-06,31
en.wikipedia.org/wiki/Detailed_Project_Report,,1,0,1,6e-06,31
en.wikipedia.org/wiki/Afcons_Infrastructure,,1,0,1,6e-06,31
en.wikipedia.org/w/index.php?title=Kanpur_Metro&action=edit&section=2,,1,0,1,6e-06,31
en.wikipedia.org/w/index.php?title=Kanpur_Metro&action=edit&section=3,,1,0,1,6e-06,31
en.wikipedia.org/w/index.php?title=Kanpur_Metro&action=edit&section=4,,1,0,1,6e-06,31
en.wikipedia.org/wiki/Alstom,,1,0,1,6e-06,31
en.wikipedia.org/wiki/Bombardier_Movia,,1,0,1,6e-06,31
en.wikipedia.org/w/index.php?title=Kanpur_Metro&action=edit&section=5,,1,0,1,6e-06,31
en.wikipedia.org/w/index.php?title=Kanpur_Metro&action=edit&section=6,,1,0,1,6e-06,31
en.wikipedia.org/w/index.php?title=Kanpur_Metro&action=edit&section=7,,1,0,1,6e-06,31
en.wikipedia.org/w/index.php?title=Kanpur_Metro&action=edit&section=8,,1,0,1,6e-06,31
en.wikipedia.org/w/index.php?title=Kanpur_Metro&action=edit&section=9,,1,0,1,6e-06,31
en.wikipedia.org/w/index.php?title=Kanpur_Metro&action=edit&section=10,,1,0,1,6e-06,31
en.wikipedia.org/wiki/File:Kanpur_MetroTrain_at_a_station.jpg,,1,0,1,6e-06,31
en.wikipedia.org/wiki/Bombardier_Transportation,,1,0,1,6e-06,31
en.wikipedia.org/wiki/Alstom_Movia,,1,0,1,6e-06,31
en.wikipedia.org/w/index.php?title=Kanpur_Metro&action=edit&section=11,,1,0,1,6e-06,31
en.wikipedia.org/w/index.php?title=Kanpur_Metro&action=edit&section=12,,1,0,1,6e-06,31
en.wikipedia.org/w/index.php?title=Kanpur_Metro&action=edit&section=13,,1,0,1,6e-06,31
en.wikipedia.org/wiki/Special:Map/12/26.4799476/80.3081642/en,,1,0,1,6e-06,31
en.wikipedia.org/w/index.php?title=Kanpur_Metro&action=edit&section=14,,1,0,1,6e-06,31
en.wikipedia.org/w/index.php?title=Kanpur_Metro&action=edit&section=15,,1,0,1,6e-06,31
themetrorailguy.com/2020/09/02/sterling-wilson-wins-kanpur-metros-third-rail-electrification-bid/,,1,0,1,6e-06,31
outlookindia.com/newsscroll/adityanath-thanks-modi-for-clearing-agra-kanpur-metro-projects/1488020,,1,0,1,6e-06,31
themetrorailguy.com/kanpur-metro-information-map-updates/,,1,0,1,6e-06,31
alstom.com/press-releases-news/2021/9/alstom-delivers-first-trainset-kanpur-metro,,1,0,1,6e-06,31
ibda.design-india.com/kanpur-agra-metro/,,1,0,1,6e-06,31
knocksense.com/kanpur/kanpur-metro-2654810484,,1,0,1,6e-06,31
knocksense.com/kanpur/kanpur-metro-green-certificate,,1,0,1,6e-06,31
indiatoday.in/india/video/pm-narendra-modi-launches-section-kanpur-metro-1893311-2021-12-28,,1,0,1,6e-06,31
en.wikipedia.org/wiki/Template:Rapid_transit_in_Asia,,1,0,1,6e-06,31
en.wikipedia.org/wiki/Template_talk:Rapid_transit_in_Asia,,1,0,1,6e-06,31
en.wikipedia.org/wiki/Special:EditPage/Template:Rapid_transit_in_Asia,,1,0,1,6e-06,31
en.wikipedia.org/wiki/Yerevan_Metro,,1,0,1,6e-06,31
en.wikipedia.org/wiki/Baku_Metro,,1,0,1,6e-06,31
en.wikipedia.org/wiki/Dhaka_Metro_Rail,,1,0,1,6e-06,31
en.wikipedia.org/wiki/Beijing_Subway,,2,0,2,6e-06,31
en.wikipedia.org/wiki/Changchun_Rail_Transit,,1,0,1,6e-06,31
en.wikipedia.org/wiki/Changsha_Metro,,1,0,1,6e-06,31
en.wikipedia.org/wiki/Changzhou_Metro,,2,0,2,6e-06,31
en.wikipedia.org/wiki/Chengdu_Metro,,2,0,2,6e-06,31
en.wikipedia.org/wiki/Chongqing_Rail_Transit,,2,0,2,6e-06,31
en.wikipedia.org/wiki/Dalian_Metro,,1,0,1,6e-06,31
en.wikipedia.org/wiki/Dongguan_Rail_Transit,,1,0,1,6e-06,31
en.wikipedia.org/wiki/Foshan_Metro,,1,0,1,6e-06,31
en.wikipedia.org/wiki/Fuzhou_Metro,,1,0,1,6e-06,31
en.wikipedia.org/wiki/Guangzhou_Metro,,1,0,1,6e-06,31
en.wikipedia.org/wiki/Guiyang_Metro,,1,0,1,6e-06,31
en.wikipedia.org/wiki/Hangzhou_Metro,,2,0,2,6e-06,31
en.wikipedia.org/wiki/Harbin_Metro,,1,0,1,6e-06,31
en.wikipedia.org/wiki/Hefei_Metro,,1,0,1,6e-06,31
en.wikipedia.org/wiki/Hohhot_Metro,,1,0,1,6e-06,31
en.wikipedia.org/wiki/Jinan_Metro,,1,0,1,6e-06,31
en.wikipedia.org/wiki/Jinhua_Rail_Transit,,1,0,1,6e-06,31
en.wikipedia.org/wiki/Kunming_Metro,,1,0,1,6e-06,31
en.wikipedia.org/wiki/Lanzhou_Metro,,1,0,1,6e-06,31
en.wikipedia.org/wiki/Luoyang_Subway,,1,0,1,6e-06,31
en.wikipedia.org/wiki/Nanchang_Metro,,1,0,1,6e-06,31
en.wikipedia.org/wiki/Nanjing_Metro,,2,0,2,6e-06,31
en.wikipedia.org/wiki/Nanning_Metro,,1,0,1,6e-06,31
en.wikipedia.org/wiki/Nantong_Rail_Transit,,1,0,1,6e-06,31
en.wikipedia.org/wiki/Ningbo_Rail_Transit,,2,0,2,6e-06,31
en.wikipedia.org/wiki/Qingdao_Metro,,1,0,1,6e-06,31
en.wikipedia.org/wiki/Shanghai_Metro,,2,0,2,6e-06,31
en.wikipedia.org/wiki/Shenyang_Metro,,1,0,1,6e-06,31
en.wikipedia.org/wiki/Shenzhen_Metro,,1,0,1,6e-06,31
en.wikipedia.org/wiki/Shijiazhuang_Metro,,1,0,1,6e-06,31
en.wikipedia.org/wiki/Suzhou_Metro,,1,0,1,6e-06,31
en.wikipedia.org/wiki/Taiyuan_Metro,,1,0,1,6e-06,31
en.wikipedia.org/wiki/Tianjin_Metro,,1,0,1,6e-06,31
en.wikipedia.org/wiki/Ürümqi_Metro,,1,0,1,6e-06,31
en.wikipedia.org/wiki/Wenzhou_Rail_Transit,,1,0,1,6e-06,31
en.wikipedia.org/wiki/Wuhan_Metro,,1,0,1,6e-06,31
en.wikipedia.org/wiki/Wuxi_Metro,,1,0,1,6e-06,31
en.wikipedia.org/wiki/Xi%27an_Metro,,1,0,1,6e-06,31
en.wikipedia.org/wiki/Xiamen_Metro,,1,0,1,6e-06,31
en.wikipedia.org/wiki/Xuzhou_Metro,,1,0,1,6e-06,31
en.wikipedia.org/wiki/Zhengzhou_Metro,,1,0,1,6e-06,31
en.wikipedia.org/wiki/Tbilisi_Metro,,1,0,1,6e-06,31
en.wikipedia.org/wiki/Bengaluru_Metro,,1,0,1,6e-06,31
en.wikipedia.org/wiki/Chennai_MRTS,,2,0,2,6e-06,31
en.wikipedia.org/wiki/Greater_Jakarta_Integrated_Mass_Transit_System,,1,0,1,6e-06,31
en.wikipedia.org/wiki/Jakarta_MRT,,1,0,1,6e-06,31
en.wikipedia.org/wiki/Jakarta_LRT,,1,0,1,6e-06,31
en.wikipedia.org/wiki/Jabodebek_LRT,,1,0,1,6e-06,31
en.wikipedia.org/wiki/Palembang_LRT,,1,0,1,6e-06,31
en.wikipedia.org/wiki/Bali_Urban_Subway,,1,0,1,6e-06,31
en.wikipedia.org/wiki/Ahvaz_Metro,,1,0,1,6e-06,31
en.wikipedia.org/wiki/Isfahan_Metro,,1,0,1,6e-06,31
en.wikipedia.org/wiki/Karaj_Metro,,1,0,1,6e-06,31
en.wikipedia.org/wiki/Mashhad_Urban_Railway,,1,0,1,6e-06,31
en.wikipedia.org/wiki/Qom_Urban_Railway,,1,0,1,6e-06,31
en.wikipedia.org/wiki/Shiraz_Metro,,1,0,1,6e-06,31
en.wikipedia.org/wiki/Tabriz_Metro,,1,0,1,6e-06,31
en.wikipedia.org/wiki/Tehran_Metro,,1,0,1,6e-06,31
en.wikipedia.org/wiki/Fukuoka_City_Subway,,1,0,1,6e-06,31
en.wikipedia.org/wiki/Kōbe_Rapid_Transit_Railway,,1,0,1,6e-06,31
en.wikipedia.org/wiki/Kobe_Municipal_Subway,,1,0,1,6e-06,31
en.wikipedia.org/wiki/Kyoto_Municipal_Subway,,1,0,1,6e-06,31
en.wikipedia.org/wiki/Nagoya_Municipal_Subway,,1,0,1,6e-06,31
en.wikipedia.org/wiki/Osaka_Metro,,1,0,1,6e-06,31
en.wikipedia.org/wiki/Sendai_Subway,,1,0,1,6e-06,31
en.wikipedia.org/wiki/Tokyo_Metro,,1,0,1,6e-06,31
en.wikipedia.org/wiki/Rinkai_Line,,1,0,1,6e-06,31
en.wikipedia.org/wiki/Toei_Subway,,1,0,1,6e-06,31
en.wikipedia.org/wiki/Yokohama_Municipal_Subway,,1,0,1,6e-06,31
en.wikipedia.org/wiki/Minatomirai_Line,,1,0,1,6e-06,31
en.wikipedia.org/wiki/Almaty_Metro,,1,0,1,6e-06,31
en.wikipedia.org/wiki/Astana_Light_Metro,,1,0,1,6e-06,31
en.wikipedia.org/wiki/Pyongyang_Metro,,1,0,1,6e-06,31
en.wikipedia.org/wiki/Klang_Valley_Integrated_Transit_System,,1,0,1,6e-06,31
en.wikipedia.org/wiki/Johor_Bahru–Singapore_Rapid_Transit_System,,1,0,1,6e-06,31
en.wikipedia.org/wiki/Mutiara_line,,1,0,1,6e-06,31
en.wikipedia.org/wiki/Lahore_Metro,,1,0,1,6e-06,31
en.wikipedia.org/wiki/Rail_transportation_in_the_Greater_Manila_Area,,1,0,1,6e-06,31
en.wikipedia.org/wiki/Manila_Light_Rail_Transit_System,,1,0,1,6e-06,31
en.wikipedia.org/wiki/Manila_Metro_Rail_Transit_System,,1,0,1,6e-06,31
en.wikipedia.org/wiki/Doha_Metro,,1,0,1,6e-06,31
en.wikipedia.org/wiki/Chelyabinsk_Metro,,1,0,1,6e-06,31
en.wikipedia.org/wiki/Kazan_Metro,,1,0,1,6e-06,31
en.wikipedia.org/wiki/Krasnoyarsk_Metro,,1,0,1,6e-06,31
en.wikipedia.org/wiki/Moscow_Metro,,1,0,1,6e-06,31
en.wikipedia.org/wiki/Novosibirsk_Metro,,1,0,1,6e-06,31
en.wikipedia.org/wiki/Nizhny_Novgorod_Metro,,1,0,1,6e-06,31
en.wikipedia.org/wiki/Saint_Petersburg_Metro,,2,0,2,6e-06,31
en.wikipedia.org/wiki/Samara_Metro,,1,0,1,6e-06,31
en.wikipedia.org/wiki/Yekaterinburg_Metro,,1,0,1,6e-06,31
en.wikipedia.org/wiki/Al_Mashaaer_Al_Mugaddassah_Metro_line,,1,0,1,6e-06,31
en.wikipedia.org/wiki/Mecca_Metro,,1,0,1,6e-06,31
en.wikipedia.org/wiki/Riyadh_Metro,,1,0,1,6e-06,31
en.wikipedia.org/wiki/Mass_Rapid_Transit_(Singapore),,1,0,1,6e-06,31
en.wikipedia.org/wiki/Busan_Metro,,1,0,1,6e-06,31
en.wikipedia.org/wiki/Daegu_Metro,,1,0,1,6e-06,31
en.wikipedia.org/wiki/Daejeon_Metro,,1,0,1,6e-06,31
en.wikipedia.org/wiki/Gwangju_Metro,,1,0,1,6e-06,31
en.wikipedia.org/wiki/Incheon_Metro,,1,0,1,6e-06,31
en.wikipedia.org/wiki/Seoul_Metropolitan_Subway,,1,0,1,6e-06,31
en.wikipedia.org/wiki/Taipei_Metro,,1,0,1,6e-06,31
en.wikipedia.org/wiki/New_Taipei_Metro,,1,0,1,6e-06,31
en.wikipedia.org/wiki/Taoyuan_Metro,,1,0,1,6e-06,31
en.wikipedia.org/wiki/Taichung_MRT,,1,0,1,6e-06,31
en.wikipedia.org/wiki/Kaohsiung_Metro,,1,0,1,6e-06,31
en.wikipedia.org/wiki/Mass_Rapid_Transit_Master_Plan_in_Bangkok_Metropolitan_Region,,1,0,1,6e-06,31
en.wikipedia.org/wiki/MRT_(Bangkok),,1,0,1,6e-06,31
en.wikipedia.org/wiki/BTS_Skytrain,,1,0,1,6e-06,31
en.wikipedia.org/wiki/Adana_Metro,,1,0,1,6e-06,31
en.wikipedia.org/wiki/Ankara_Metro,,1,0,1,6e-06,31
en.wikipedia.org/wiki/Bursaray,,1,0,1,6e-06,31
en.wikipedia.org/wiki/Gebze_Metro,,1,0,1,6e-06,31
en.wikipedia.org/wiki/Istanbul_Metro,,1,0,1,6e-06,31
en.wikipedia.org/wiki/İzmir_Metro,,1,0,1,6e-06,31
en.wikipedia.org/wiki/Konya_Metro,,1,0,1,6e-06,31
en.wikipedia.org/wiki/Mersin_Metro,,1,0,1,6e-06,31
en.wikipedia.org/wiki/Dubai_Metro,,1,0,1,6e-06,31
en.wikipedia.org/wiki/Tashkent_Metro,,1,0,1,6e-06,31
en.wikipedia.org/wiki/Hanoi_Metro,,1,0,1,6e-06,31
en.wikipedia.org/wiki/Ho_Chi_Minh_City_Metro,,1,0,1,6e-06,31
en.wikipedia.org/wiki/Category:Underground_rapid_transit_in_India,,1,0,1,6e-06,31
en.wikipedia.org/wiki/Category:Standard-gauge_railways_in_India,,1,0,1,6e-06,31
en.wikipedia.org/wiki/Category:Railway_lines_opened_in_2021,,1,0,1,6e-06,31
en.wikipedia.org/wiki/Category:Kanpur_Metro,,1,0,1,6e-06,31
en.wikipedia.org/wiki/Category:Uttar_Pradesh_articles_missing_geocoordinate_data,,7,0,7,7e-06,31
en.wikipedia.org/wiki/Category:All_articles_needing_coordinates,,9,0,9,7e-06,31
en.m.wikipedia.org/w/index.php?title=Kanpur_Metro&mobileaction=toggle_view_mobile,,1,0,1,6e-06,31
upload.wikimedia.org/wikipedia/commons/thumb/6/6c/UPMRC.svg/120px-UPMRC.svg.png,,1,0,1,6e-06,31
upload.wikimedia.org/wikipedia/commons/thumb/2/21/Flag_of_Vietnam.svg/40px-Flag_of_Vietnam.svg.png,,1,0,1,6e-06,31
developer.wikimedia.org/de/,,1,0,1,7e-06,31
developer.wikimedia.org/en-gb/,,1,0,1,7e-06,31
developer.wikimedia.org/es/,,1,0,1,7e-06,31
developer.wikimedia.org/fr/,,1,0,1,7e-06,31
developer.wikimedia.org/lb/,,1,0,1,7e-06,31
developer.wikimedia.org/nl/,,1,0,1,7e-06,31
developer.wikimedia.org/pl/,,1,0,1,7e-06,31
developer.wikimedia.org/pt-br/,,1,0,1,7e-06,31
developer.wikimedia.org/sl/,,1,0,1,7e-06,31
developer.wikimedia.org/sh-latn/,,1,0,1,7e-06,31
developer.wikimedia.org/fi/,,1,0,1,7e-06,31
developer.wikimedia.org/tr/,,1,0,1,7e-06,31
developer.wikimedia.org/mk/,,1,0,1,7e-06,31
developer.wikimedia.org/ru/,,1,0,1,7e-06,31
developer.wikimedia.org/he/,,1,0,1,7e-06,31
developer.wikimedia.org/ar/,,1,0,1,7e-06,31
developer.wikimedia.org/bn/,,1,0,1,7e-06,31
developer.wikimedia.org/zh-hans/,,1,0,1,7e-06,31
developer.wikimedia.org/zh-hant/,,1,0,1,7e-06,31
developer.wikimedia.org/ja/,,1,0,1,7e-06,31
developer.wikimedia.org/ko/,,1,0,1,7e-06,31
developer.wikimedia.org/get-started/,,1,0,1,7e-06,31
developer.wikimedia.org/use-content/,,1,0,1,7e-06,31
developer.wikimedia.org/build-tools/,,1,0,1,7e-06,31
developer.wikimedia.org/contribute/,,1,0,1,7e-06,31
developer.wikimedia.org/community/,,1,0,1,7e-06,31
developer.wikimedia.org/get-help/,,1,0,1,7e-06,31
developer.wikimedia.org/get-started/wikimedia-tech/,,1,0,1,7e-06,31
developer.wikimedia.org/get-started/new-dev/,,1,0,1,7e-06,31
developer.wikimedia.org/get-started/tutorials/,,1,0,1,7e-06,31
developer.wikimedia.org/get-started/browse-languages/,,1,0,1,7e-06,31
developer.wikimedia.org/use-content/tutorials/,,1,0,1,7e-06,31
developer.wikimedia.org/use-content/content/,,1,0,1,7e-06,31
developer.wikimedia.org/use-content/data/,,1,0,1,7e-06,31
developer.wikimedia.org/use-content/bot-traffic/,,1,0,1,7e-06,31
developer.wikimedia.org/build-tools/search/,,1,0,1,7e-06,31
developer.wikimedia.org/build-tools/get-started/,,1,0,1,7e-06,31
developer.wikimedia.org/build-tools/tutorials/,,1,0,1,7e-06,31
developer.wikimedia.org/build-tools/apis/,,1,0,1,7e-06,31
developer.wikimedia.org/build-tools/host-tools/,,1,0,1,7e-06,31
developer.wikimedia.org/contribute/overview/,,1,0,1,7e-06,31
developer.wikimedia.org/contribute/by-topic/,,1,0,1,7e-06,31
developer.wikimedia.org/contribute/by-language/,,1,0,1,7e-06,31
developer.wikimedia.org/contribute/search/,,1,0,1,7e-06,31
developer.wikimedia.org/community/events/,,1,0,1,7e-06,31
developer.wikimedia.org/community/communicate/,,1,0,1,7e-06,31
developer.wikimedia.org/community/grow/,,1,0,1,7e-06,31
developer.wikimedia.org/community/updates/,,1,0,1,7e-06,31
developer.wikimedia.org/community/tech-ops/,,1,0,1,7e-06,31
wikipedia.org/,,2,0,2,7e-06,31
foundation.wikimedia.org/wiki/Special:MyLanguage/Privacy_policy,,1,0,1,7e-06,31
foundation.wikimedia.org/wiki/Special:MyLanguage/Terms_of_Use,,1,0,1,7e-06,31
mediawiki.org/wiki/Special:MyLanguage/Developer_Portal,,1,0,1,7e-06,31
mediawiki.org/wiki/Special:MyLanguage/Developer_Portal/Contribute,,1,0,1,7e-06,31
developer.wikimedia.org/assets/javascripts/bundle.525ec568.min.js,,1,0,1,7e-06,31
developer.wikimedia.org/assets/js/matomo.js,,1,0,1,7e-06,31
developer.wikimedia.org/assets/wikimedia.svg,,1,0,1,7e-06,31
developer.wikimedia.org/assets/book.svg,,1,0,1,7e-06,31
developer.wikimedia.org/assets/book-dark.svg,,1,0,1,7e-06,31
developer.wikimedia.org/assets/chemistry.svg,,1,0,1,7e-06,31
developer.wikimedia.org/assets/chemistry-dark.svg,,1,0,1,7e-06,31
developer.wikimedia.org/assets/computer.svg,,1,0,1,7e-06,31
developer.wikimedia.org/assets/computer-dark.svg,,1,0,1,7e-06,31
developer.wikimedia.org/assets/world.svg,,1,0,1,7e-06,31
developer.wikimedia.org/assets/world-dark.svg,,1,0,1,7e-06,31
developer.wikimedia.org/assets/PenAndPaper.svg,,1,0,1,7e-06,31
developer.wikimedia.org/assets/PenAndPaper-dark.svg,,1,0,1,7e-06,31
developer.wikimedia.org/assets/stylesheets/main.8c3ca2c6.min.css,,1,0,1,7e-06,31
developer.wikimedia.org/assets/stylesheets/palette.06af60db.min.css,,1,0,1,7e-06,31
developer.wikimedia.org/assets/stylesheets/theme.css,,1,0,1,7e-06,31
d-nb.info/gnd/1020910-4/about/html,,1,0,1,1.2e-05,31
en.wikipedia.org/w/index.php?title=Special:CreateAccount&returnto=Akbarpur%2C+Kanpur+Dehat,,1,0,1,6e-06,31
en.wikipedia.org/w/index.php?title=Special:UserLogin&returnto=Akbarpur%2C+Kanpur+Dehat,,1,0,1,6e-06,31
awa.wikipedia.org/wiki/अकबरपुर_(कानपुर_देहात),,1,0,1,6e-06,31
zh-min-nan.wikipedia.org/wiki/Akbarpur_(Kanpur_Dehat),,1,0,1,6e-06,31
"bh.wikipedia.org/wiki/अकबरपुर,_कानपुर_देहात",,1,0,1,6e-06,31
"ceb.wikipedia.org/wiki/Akbarpur_(lungsod_sa_Indiya,_Kanpur_Dehat)",,1,0,1,6e-06,31
da.wikipedia.org/wiki/Akbarpur_(Kanpur_Dehat),,1,0,1,6e-06,31
de.wikipedia.org/wiki/Akbarpur_(Kanpur_Dehat),,1,0,1,6e-06,31
es.wikipedia.org/wiki/Akbarpur_(Kanpur_Dehat),,1,0,1,6e-06,31
fa.wikipedia.org/wiki/اکبرپور،_کانپور_دیهات,,1,0,1,6e-06,31
fr.wikipedia.org/wiki/Akbarpur_(Kanpur_Dehat),,1,0,1,6e-06,31
gu.wikipedia.org/wiki/અકબરપુર,,1,0,1,6e-06,31
"hi.wikipedia.org/wiki/अकबरपुर,_कानपुर_देहात",,1,0,1,6e-06,31
bpy.wikipedia.org/wiki/আকবরপুর,,1,0,1,6e-06,31
it.wikipedia.org/wiki/Akbarpur_(Kanpur_Dehat),,1,0,1,6e-06,31
mr.wikipedia.org/wiki/अकबरपूर,,1,0,1,6e-06,31
"ms.wikipedia.org/wiki/Akbarpur,_Kanpur_Dehat",,1,0,1,6e-06,31
"min.wikipedia.org/wiki/Akbarpur,_Kanpur_Dehat",,1,0,1,6e-06,31
nl.wikipedia.org/wiki/Akbarpur_(Kanpur_Dehat),,1,0,1,6e-06,31
pl.wikipedia.org/wiki/Akbarpur_(Ramabai_Nagar),,1,0,1,6e-06,31
pt.wikipedia.org/wiki/Akbarpur_(Kanpur_Dehat),,1,0,1,6e-06,31
ru.wikipedia.org/wiki/Акбарпур_(Рамабайнагар),,1,0,1,6e-06,31
"sa.wikipedia.org/wiki/अक्बरपुरम्,_कानपुरदेहातम्",,1,0,1,6e-06,31
"sv.wikipedia.org/wiki/Akbarpur,_Kanpur_Dehat",,1,0,1,6e-06,31
ta.wikipedia.org/wiki/அக்பர்பூர்,,1,0,1,6e-06,31
te.wikipedia.org/wiki/అక్బర్‌పూర్_(కాన్పూర్_దేహత్),,1,0,1,6e-06,31
ur.wikipedia.org/wiki/اکبرپور،_کانپور_دیہات,,1,0,1,6e-06,31
"vi.wikipedia.org/wiki/Akbarpur,_Kanpur_Dehat",,1,0,1,6e-06,31
zh.wikipedia.org/wiki/阿克巴尔普尔,,1,0,1,6e-06,31
wikidata.org/wiki/Special:EntityPage/Q583899,,1,0,1,6e-06,31
"en.wikipedia.org/wiki/Talk:Akbarpur,_Kanpur_Dehat",,1,0,1,6e-06,31
"en.wikipedia.org/w/index.php?title=Akbarpur,_Kanpur_Dehat&action=edit",,1,0,1,6e-06,31
"en.wikipedia.org/w/index.php?title=Akbarpur,_Kanpur_Dehat&action=history",,1,0,1,6e-06,31
"en.wikipedia.org/wiki/Special:WhatLinksHere/Akbarpur,_Kanpur_Dehat",,1,0,1,6e-06,31
"en.wikipedia.org/wiki/Special:RecentChangesLinked/Akbarpur,_Kanpur_Dehat",,1,0,1,6e-06,31
"en.wikipedia.org/w/index.php?title=Akbarpur,_Kanpur_Dehat&oldid=1296005091",,1,0,1,6e-06,31
"en.wikipedia.org/w/index.php?title=Akbarpur,_Kanpur_Dehat&action=info",,1,0,1,6e-06,31
"en.wikipedia.org/w/index.php?title=Akbarpur,_Kanpur_Dehat&printable=yes",,1,0,1,6e-06,31
"commons.wikimedia.org/wiki/Category:Akbarpur,_Kanpur_Dehat",,1,0,1,6e-06,31
en.wikipedia.org/wiki/Akbarpur_(disambiguation),,1,0,1,6e-06,31
"en.wikipedia.org/wiki/Special:EditPage/Akbarpur,_Kanpur_Dehat",,1,0,1,6e-06,31
"google.com/search?as_eq=wikipedia&q=""Akbarpur%2C+Kanpur+Dehat""",,1,0,1,6e-06,31
"google.com/search?tbm=nws&q=""Akbarpur%2C+Kanpur+Dehat""+-wikipedia&tbs=ar:1",,1,0,1,6e-06,31
"google.com/search?&q=""Akbarpur%2C+Kanpur+Dehat""&tbs=bkt:s&tbm=bks",,1,0,1,6e-06,31
"google.com/search?tbs=bks:1&q=""Akbarpur%2C+Kanpur+Dehat""+-wikipedia",,1,0,1,6e-06,31
"scholar.google.com/scholar?q=""Akbarpur%2C+Kanpur+Dehat""",,1,0,1,6e-06,31
"jstor.org/action/doBasicSearch?Query=""Akbarpur%2C+Kanpur+Dehat""&acc=on&wc=on",,1,0,1,6e-06,31
"en.wikipedia.org/w/index.php?title=Akbarpur,_Kanpur_Dehat&action=edit&section=1",,1,0,1,6e-06,31
"en.wikipedia.org/w/index.php?title=Akbarpur,_Kanpur_Dehat&action=edit&section=2",,1,0,1,6e-06,31
"en.wikipedia.org/w/index.php?title=Akbarpur,_Kanpur_Dehat&action=edit&section=3",,1,0,1,6e-06,31
en.wikipedia.org/wiki/File:Rura_Railway_Station.jpg,,2,0,2,7e-06,31
"en.wikipedia.org/w/index.php?title=Akbarpur,_Kanpur_Dehat&action=edit&section=4",,1,0,1,6e-06,31
"en.wikipedia.org/w/index.php?title=Akbarpur,_Kanpur_Dehat&action=edit&section=5",,1,0,1,6e-06,31
"en.wikipedia.org/w/index.php?title=Akbarpur,_Kanpur_Dehat&action=edit&section=6",,1,0,1,6e-06,31
en.wikipedia.org/wiki/Akbarpur_Inter_College,,2,0,2,6e-06,31
"en.wikipedia.org/wiki/File:Akbarpur_Inter_College_Akbarpur,Kanpur_Dehat.jpg",,1,0,1,6e-06,31
en.wikipedia.org/wiki/Akbarpur_Degree_College,,2,0,2,6e-06,31
en.wikipedia.org/wiki/File:Akbarpur_Degree_College.jpg,,2,0,2,6e-06,31
"en.wikipedia.org/wiki/Government_Degree_College,_Akbarpur",,2,0,2,6e-06,31
"en.wikipedia.org/w/index.php?title=Akbarpur,_Kanpur_Dehat&action=edit&section=7",,1,0,1,6e-06,31
en.wikipedia.org/wiki/Circumambulation,,1,0,1,6e-06,31
en.wikipedia.org/wiki/File:Holi_-Holi.jpg,,1,0,1,6e-06,31
"en.wikipedia.org/w/index.php?title=Akbarpur,_Kanpur_Dehat&action=edit&section=8",,1,0,1,6e-06,31
en.wikipedia.org/wiki/File:Shukla_Talab_(dry_view).JPG,,1,0,1,6e-06,31
"en.wikipedia.org/w/index.php?title=Akbarpur,_Kanpur_Dehat&action=edit&section=9",,1,0,1,6e-06,31
"en.wikipedia.org/w/index.php?title=Akbarpur,_Kanpur_Dehat&action=edit&section=10",,1,0,1,6e-06,31
en.wikipedia.org/wiki/File:Hindi_Bhawan.JPG,,1,0,1,6e-06,31
"en.wikipedia.org/w/index.php?title=Akbarpur,_Kanpur_Dehat&action=edit&section=11",,1,0,1,6e-06,31
"en.wikipedia.org/w/index.php?title=Akbarpur,_Kanpur_Dehat&action=edit&section=12",,1,0,1,6e-06,31
en.wikipedia.org/wiki/Jainpur,,1,0,1,6e-06,31
en.wikipedia.org/wiki/Sarwan_Khera,,1,0,1,6e-06,31
en.wikipedia.org/wiki/Amraudha,,6,0,6,7e-06,31
"en.wikipedia.org/w/index.php?title=Akbarpur,_Kanpur_Dehat&action=edit&section=13",,1,0,1,6e-06,31
"en.wikipedia.org/w/index.php?title=Akbarpur,_Kanpur_Dehat&action=edit&section=14",,1,0,1,6e-06,31
en.wikipedia.org/wiki/File:Bara_Toll_Plaza.JPG,,1,0,1,6e-06,31
en.wikipedia.org/wiki/File:Lucknow_-Jhansi_Road.JPG,,1,0,1,6e-06,31
en.wikipedia.org/wiki/File:Akbarpur_Degree_College_(internal_side_view).jpg,,1,0,1,6e-06,31
en.wikipedia.org/wiki/File:Akbarpur_Inter_College_Akbarpur_Kanpur_-Dehat.jpg,,1,0,1,6e-06,31
en.wikipedia.org/wiki/File:Kalika_Devi_Mandir.jpg,,1,0,1,6e-06,31
en.wikipedia.org/wiki/File:Water_Colors_Design.jpg,,1,0,1,6e-06,31
en.wikipedia.org/wiki/File:Shukla_Talab_(West_view).JPG,,1,0,1,6e-06,31
en.wikipedia.org/wiki/File:Shri_Ram_Janki_Temple.JPG,,1,0,1,6e-06,31
en.wikipedia.org/wiki/File:Shukla_Talab-2.JPG,,1,0,1,6e-06,31
en.wikipedia.org/wiki/File:Shukla_Talab-3.JPG,,1,0,1,6e-06,31
"en.wikipedia.org/w/index.php?title=Akbarpur,_Kanpur_Dehat&action=edit&section=15",,1,0,1,6e-06,31
censusindia.gov.in/2011census/censusinfodashboard/index.html,,1,0,1,6e-06,31
readerblogs.navbharattimes.indiatimes.com/एक-नजर-इधर-भी/kavy-sangrah/,,1,0,1,6e-06,31
commons.wikimedia.org/wiki/File:Akbarpur_Inter_College_Akbarpur,,1,0,1,6e-06,31
web.archive.org/web/20150507200535/http://www.kanpurdehat.nic.in/f_profile.html,,3,0,3,7e-06,31
kanpurdehat.nic.in/f_profile.html,,3,0,3,7e-06,31
panoramio.com/photo/58683398?source=wapi&referrer=kh.google.com,,1,0,1,6e-06,31
"en.wikipedia.org/w/index.php?title=Akbarpur,_Kanpur_Dehat&action=edit&section=16",,1,0,1,6e-06,31
kanpurdehat.nic.in/,,2,0,2,6e-06,31
web.archive.org/web/20150811052935/http://kanpurdehat.nic.in/,,1,0,1,6e-06,31
en.wikipedia.org/wiki/Template_talk:Kanpur_Dehat_district,,5,0,5,7e-06,31
en.wikipedia.org/wiki/Special:EditPage/Template:Kanpur_Dehat_district,,5,0,5,7e-06,31
en.wikipedia.org/wiki/Jhinjhak,,5,0,5,7e-06,31
en.wikipedia.org/wiki/Pukhrayan,,7,0,7,7e-06,31
en.wikipedia.org/wiki/Rura,,6,0,6,7e-06,31
en.wikipedia.org/wiki/Shivli,,7,0,7,7e-06,31
en.wikipedia.org/wiki/Category:Cities_and_towns_in_Kanpur_Dehat_district,,5,0,5,7e-06,31
en.wikipedia.org/wiki/Category:Articles_needing_additional_references_from_July_2024,,1,0,1,6e-06,31
"en.m.wikipedia.org/w/index.php?title=Akbarpur,_Kanpur_Dehat&mobileaction=toggle_view_mobile",,1,0,1,6e-06,31
upload.wikimedia.org/wikipedia/commons/thumb/5/53/Holi_-Holi.jpg/250px-Holi_-Holi.jpg,,1,0,1,6e-06,31
upload.wikimedia.org/wikipedia/commons/thumb/c/ca/Hindi_Bhawan.JPG/250px-Hindi_Bhawan.JPG,,1,0,1,6e-06,31
upload.wikimedia.org/wikipedia/commons/thumb/4/4e/Bara_Toll_Plaza.JPG/120px-Bara_Toll_Plaza.JPG,,1,0,1,6e-06,31
upload.wikimedia.org/wikipedia/commons/thumb/c/c4/District_Hospital.jpg/120px-District_Hospital.jpg,,1,0,1,6e-06,31
upload.wikimedia.org/wikipedia/commons/thumb/3/3c/Shukla_Talab-2.JPG/120px-Shukla_Talab-2.JPG,,1,0,1,6e-06,31
upload.wikimedia.org/wikipedia/commons/thumb/4/46/Shukla_Talab-3.JPG/120px-Shukla_Talab-3.JPG,,1,0,1,6e-06,31
en.wikipedia.org/w/index.php?title=Special:CreateAccount&returnto=Akbarpur+Lok+Sabha+constituency,,1,0,1,6e-06,31
en.wikipedia.org/w/index.php?title=Special:UserLogin&returnto=Akbarpur+Lok+Sabha+constituency,,1,0,1,6e-06,31
bn.wikipedia.org/wiki/আকবরপুর_লোকসভা_কেন্দ্র,,1,0,1,6e-06,31
hi.wikipedia.org/wiki/अकबरपुर_लोक_सभा_निर्वाचन_क्षेत्र,,1,0,1,6e-06,31
mr.wikipedia.org/wiki/अकबरपूर_लोकसभा_मतदारसंघ,,1,0,1,6e-06,31
pa.wikipedia.org/wiki/ਅਕਬਰਪੁਰ_ਲੋਕ_ਸਭਾ_ਹਲਕਾ,,1,0,1,6e-06,31
ta.wikipedia.org/wiki/அக்பர்பூர்_மக்களவைத்_தொகுதி,,1,0,1,6e-06,31
te.wikipedia.org/wiki/అక్బర్‌పూర్_లోక్‌సభ_నియోజకవర్గం,,1,0,1,6e-06,31
wikidata.org/wiki/Special:EntityPage/Q3633316,,1,0,1,6e-06,31
en.wikipedia.org/wiki/Talk:Akbarpur_Lok_Sabha_constituency,,1,0,1,6e-06,31
en.wikipedia.org/w/index.php?title=Akbarpur_Lok_Sabha_constituency&action=edit,,1,0,1,6e-06,31
en.wikipedia.org/w/index.php?title=Akbarpur_Lok_Sabha_constituency&action=history,,1,0,1,6e-06,31
en.wikipedia.org/wiki/Special:WhatLinksHere/Akbarpur_Lok_Sabha_constituency,,1,0,1,6e-06,31
en.wikipedia.org/wiki/Special:RecentChangesLinked/Akbarpur_Lok_Sabha_constituency,,1,0,1,6e-06,31
en.wikipedia.org/w/index.php?title=Akbarpur_Lok_Sabha_constituency&oldid=1303076909,,1,0,1,6e-06,31
en.wikipedia.org/w/index.php?title=Akbarpur_Lok_Sabha_constituency&action=info,,1,0,1,6e-06,31
en.wikipedia.org/w/index.php?title=Akbarpur_Lok_Sabha_constituency&printable=yes,,1,0,1,6e-06,31
geohack.toolforge.org/geohack.php?pagename=Akbarpur_Lok_Sabha_constituency&params=26.43_N_82.54_E_,,1,0,1,6e-06,31
en.wikipedia.org/wiki/Ghatampur_Assembly_constituency,,12,0,12,7e-06,31
en.wikipedia.org/wiki/18th_Lok_Sabha,,6,0,6,7e-06,31
en.wikipedia.org/wiki/Devendra_Singh_Bhole,,2,0,2,6e-06,31
en.wikipedia.org/wiki/2024_Indian_general_elections,,4,0,4,7e-06,31
en.wikipedia.org/wiki/Electoral_boundary_delimitation,,1,0,1,6e-06,31
en.wikipedia.org/w/index.php?title=Akbarpur_Lok_Sabha_constituency&action=edit&section=1,,1,0,1,6e-06,31
en.wikipedia.org/wiki/Kanpur_Dehat,,8,0,8,7e-06,31
en.wikipedia.org/wiki/Pratibha_Shukla,,2,0,2,6e-06,31
en.wikipedia.org/wiki/Bilhaur_Lok_Sabha_constituency,,8,0,8,7e-06,31
en.wikipedia.org/wiki/Ghatampur_Lok_Sabha_constituency,,8,0,8,7e-06,31
en.wikipedia.org/w/index.php?title=Akbarpur_Lok_Sabha_constituency&action=edit&section=2,,1,0,1,6e-06,31
"en.wikipedia.org/wiki/Indian_general_election,_2009",,3,0,3,6e-06,31
en.wikipedia.org/wiki/Raja_Ram_Pal,,4,0,4,7e-06,31
"en.wikipedia.org/wiki/Indian_general_election,_2014",,3,0,3,6e-06,31
"en.wikipedia.org/wiki/Indian_general_election,_2019",,3,0,3,6e-06,31
"en.wikipedia.org/wiki/Indian_general_election,_2024",,2,0,2,6e-06,31
en.wikipedia.org/w/index.php?title=Akbarpur_Lok_Sabha_constituency&action=edit&section=3,,1,0,1,6e-06,31
en.wikipedia.org/w/index.php?title=Akbarpur_Lok_Sabha_constituency&action=edit&section=4,,1,0,1,6e-06,31
en.wikipedia.org/wiki/None_of_the_above,,13,0,13,7e-06,31
en.wikipedia.org/wiki/Voter_turnout,,17,0,17,7e-06,31
en.wikipedia.org/wiki/Swing_(politics),,17,0,17,7e-06,31
en.wikipedia.org/w/index.php?title=Akbarpur_Lok_Sabha_constituency&action=edit&section=5,,1,0,1,6e-06,31
en.wikipedia.org/wiki/2019_Indian_general_elections,,5,0,5,7e-06,31
en.wikipedia.org/w/index.php?title=Akbarpur_Lok_Sabha_constituency&action=edit&section=6,,1,0,1,6e-06,31
en.wikipedia.org/wiki/2014_Indian_general_elections,,5,0,5,7e-06,31
en.wikipedia.org/wiki/Anil_Shukla_Warsi,,2,0,2,6e-06,31
en.wikipedia.org/w/index.php?title=Akbarpur_Lok_Sabha_constituency&action=edit&section=7,,1,0,1,6e-06,31
en.wikipedia.org/wiki/2009_Indian_general_elections,,4,0,4,7e-06,31
en.wikipedia.org/wiki/Kamlesh_Pathak,,1,0,1,6e-06,31
en.wikipedia.org/wiki/Independent_(politician),,14,0,14,7e-06,31
en.wikipedia.org/wiki/Rashtriya_Samanta_Dal,,2,0,2,6e-06,31
en.wikipedia.org/wiki/Bharat_Punarnirman_Dal,,4,0,4,6e-06,31
en.wikipedia.org/w/index.php?title=Akbarpur_Lok_Sabha_constituency&action=edit&section=8,,1,0,1,6e-06,31
en.wikipedia.org/wiki/Kanpur_Lok_Sabha_constituency,,13,0,13,7e-06,31
en.wikipedia.org/wiki/Kanpur_(Mayoral_Constituency),,2,0,2,6e-06,31
en.wikipedia.org/wiki/Kanpur_(Division_Graduates_Constituency),,3,0,3,6e-06,31
en.wikipedia.org/w/index.php?title=Akbarpur_Lok_Sabha_constituency&action=edit&section=9,,1,0,1,6e-06,31
indiatoday.in/elections/lok-sabha-2019/uttar-pradesh/akbarpur,,1,0,1,6e-06,31
mapsofindia.com/parliamentaryconstituencies/uttarpradesh/akbarpur.html,,1,0,1,6e-06,31
results.eci.gov.in/PcResultGenJune2024/candidateswise-S2444.htm,,1,0,1,6e-06,31
timesofindia.indiatimes.com/elections/lok-sabha-constituencies/uttar-pradesh/akbarpur,,1,0,1,6e-06,31
en.wikipedia.org/wiki/Template:Lok_Sabha_constituencies_of_Uttar_Pradesh,,8,0,8,7e-06,31
en.wikipedia.org/wiki/Template_talk:Lok_Sabha_constituencies_of_Uttar_Pradesh,,8,0,8,7e-06,31
en.wikipedia.org/wiki/Special:EditPage/Template:Lok_Sabha_constituencies_of_Uttar_Pradesh,,8,0,8,7e-06,31
en.wikipedia.org/wiki/Agra_Lok_Sabha_constituency,,8,0,8,7e-06,31
en.wikipedia.org/wiki/Aligarh_Lok_Sabha_constituency,,8,0,8,7e-06,31
en.wikipedia.org/wiki/Faizabad_Lok_Sabha_constituency,,9,0,9,7e-06,31
en.wikipedia.org/wiki/Ambedkar_Nagar_Lok_Sabha_constituency,,9,0,9,7e-06,31
en.wikipedia.org/wiki/Amethi_Lok_Sabha_constituency,,9,0,9,7e-06,31
en.wikipedia.org/wiki/Amroha_Lok_Sabha_constituency,,8,0,8,7e-06,31
en.wikipedia.org/wiki/Aonla_Lok_Sabha_constituency,,8,0,8,7e-06,31
en.wikipedia.org/wiki/Azamgarh_Lok_Sabha_constituency,,8,0,8,7e-06,31
en.wikipedia.org/wiki/Badaun_Lok_Sabha_constituency,,8,0,8,7e-06,31
en.wikipedia.org/wiki/Baghpat_Lok_Sabha_constituency,,8,0,8,7e-06,31
en.wikipedia.org/wiki/Bahraich_Lok_Sabha_constituency,,8,0,8,7e-06,31
en.wikipedia.org/wiki/Ballia_Lok_Sabha_constituency,,8,0,8,7e-06,31
en.wikipedia.org/wiki/Banda_Lok_Sabha_constituency,,8,0,8,7e-06,31
en.wikipedia.org/wiki/Bansgaon_Lok_Sabha_constituency,,8,0,8,7e-06,31
en.wikipedia.org/wiki/Barabanki_Lok_Sabha_constituency,,9,0,9,7e-06,31
en.wikipedia.org/wiki/Bareilly_Lok_Sabha_constituency,,8,0,8,7e-06,31
en.wikipedia.org/wiki/Basti_Lok_Sabha_constituency,,8,0,8,7e-06,31
en.wikipedia.org/wiki/Bhadohi_Lok_Sabha_constituency,,8,0,8,7e-06,31
en.wikipedia.org/wiki/Bijnor_Lok_Sabha_constituency,,8,0,8,7e-06,31
en.wikipedia.org/wiki/Bulandshahr_Lok_Sabha_constituency,,8,0,8,7e-06,31
en.wikipedia.org/wiki/Chandauli_Lok_Sabha_constituency,,8,0,8,7e-06,31
en.wikipedia.org/wiki/Deoria_Lok_Sabha_constituency,,8,0,8,7e-06,31
en.wikipedia.org/wiki/Dhaurahra_Lok_Sabha_constituency,,8,0,8,7e-06,31
en.wikipedia.org/wiki/Domariyaganj_Lok_Sabha_constituency,,8,0,8,7e-06,31
en.wikipedia.org/wiki/Etah_Lok_Sabha_constituency,,8,0,8,7e-06,31
en.wikipedia.org/wiki/Etawah_Lok_Sabha_constituency,,8,0,8,7e-06,31
en.wikipedia.org/wiki/Farrukhabad_Lok_Sabha_constituency,,8,0,8,7e-06,31
en.wikipedia.org/wiki/Fatehpur_Lok_Sabha_constituency,,9,0,9,7e-06,31
en.wikipedia.org/wiki/Fatehpur_Sikri_Lok_Sabha_constituency,,8,0,8,7e-06,31
en.wikipedia.org/wiki/Firozabad_Lok_Sabha_constituency,,8,0,8,7e-06,31
en.wikipedia.org/wiki/Ghaziabad_Lok_Sabha_constituency,,8,0,8,7e-06,31
en.wikipedia.org/wiki/Ghazipur_Lok_Sabha_constituency,,8,0,8,7e-06,31
en.wikipedia.org/wiki/Ghosi_Lok_Sabha_constituency,,8,0,8,7e-06,31
en.wikipedia.org/wiki/Gonda_Lok_Sabha_constituency,,8,0,8,7e-06,31
en.wikipedia.org/wiki/Gorakhpur_Lok_Sabha_constituency,,8,0,8,7e-06,31
"en.wikipedia.org/wiki/Hamirpur,_Uttar_Pradesh_Lok_Sabha_constituency",,8,0,8,7e-06,31
en.wikipedia.org/wiki/Hardoi_Lok_Sabha_constituency,,8,0,8,7e-06,31
en.wikipedia.org/wiki/Hathras_Lok_Sabha_constituency,,8,0,8,7e-06,31
en.wikipedia.org/wiki/Jalaun_Lok_Sabha_constituency,,8,0,8,7e-06,31
en.wikipedia.org/wiki/Jaunpur_Lok_Sabha_constituency,,8,0,8,7e-06,31
en.wikipedia.org/wiki/Jhansi_Lok_Sabha_constituency,,8,0,8,7e-06,31
en.wikipedia.org/wiki/Kairana_Lok_Sabha_constituency,,9,0,9,7e-06,31
en.wikipedia.org/wiki/Kaiserganj_Lok_Sabha_constituency,,8,0,8,7e-06,31
en.wikipedia.org/wiki/Kannauj_Lok_Sabha_constituency,,8,0,8,7e-06,31
en.wikipedia.org/wiki/Kaushambi_Lok_Sabha_constituency,,8,0,8,7e-06,31
en.wikipedia.org/wiki/Kheri_Lok_Sabha_constituency,,8,0,8,7e-06,31
en.wikipedia.org/wiki/Kushi_Nagar_Lok_Sabha_constituency,,8,0,8,7e-06,31
en.wikipedia.org/wiki/Lalganj_Lok_Sabha_constituency,,8,0,8,7e-06,31
en.wikipedia.org/wiki/Lucknow_Lok_Sabha_constituency,,8,0,8,7e-06,31
en.wikipedia.org/wiki/Machhlishahr_Lok_Sabha_constituency,,8,0,8,7e-06,31
en.wikipedia.org/wiki/Maharajganj_(Uttar_Pradesh_Lok_Sabha_constituency),,9,0,9,7e-06,31
en.wikipedia.org/wiki/Mainpuri_Lok_Sabha_constituency,,8,0,8,7e-06,31
en.wikipedia.org/wiki/Mathura_Lok_Sabha_constituency,,8,0,8,7e-06,31
en.wikipedia.org/wiki/Meerut_Lok_Sabha_constituency,,8,0,8,7e-06,31
en.wikipedia.org/wiki/Mirzapur_Lok_Sabha_constituency,,8,0,8,7e-06,31
en.wikipedia.org/wiki/Misrikh_Lok_Sabha_constituency,,8,0,8,7e-06,31
en.wikipedia.org/wiki/Mohanlalganj_Lok_Sabha_constituency,,8,0,8,7e-06,31
en.wikipedia.org/wiki/Moradabad_Lok_Sabha_constituency,,8,0,8,7e-06,31
en.wikipedia.org/wiki/Muzaffarnagar_Lok_Sabha_constituency,,9,0,9,7e-06,31
en.wikipedia.org/wiki/Nagina_Lok_Sabha_constituency,,8,0,8,7e-06,31
en.wikipedia.org/wiki/Phulpur_Lok_Sabha_constituency,,9,0,9,7e-06,31
en.wikipedia.org/wiki/Pilibhit_Lok_Sabha_constituency,,8,0,8,7e-06,31
en.wikipedia.org/wiki/Pratapgarh_Lok_Sabha_constituency,,9,0,9,7e-06,31
en.wikipedia.org/wiki/Allahabad_Lok_Sabha_constituency,,8,0,8,7e-06,31
en.wikipedia.org/wiki/Raebareli_Lok_Sabha_constituency,,8,0,8,7e-06,31
en.wikipedia.org/wiki/Rampur_Lok_Sabha_constituency,,8,0,8,7e-06,31
en.wikipedia.org/wiki/Robertsganj_Lok_Sabha_constituency,,8,0,8,7e-06,31
en.wikipedia.org/wiki/Saharanpur_Lok_Sabha_constituency,,9,0,9,7e-06,31
en.wikipedia.org/wiki/Salempur_Lok_Sabha_constituency,,8,0,8,7e-06,31
en.wikipedia.org/wiki/Sambhal_Lok_Sabha_constituency,,8,0,8,7e-06,31
en.wikipedia.org/wiki/Sant_Kabir_Nagar_Lok_Sabha_constituency,,9,0,9,7e-06,31
en.wikipedia.org/wiki/Shahjahanpur_Lok_Sabha_constituency,,8,0,8,7e-06,31
en.wikipedia.org/wiki/Shravasti_Lok_Sabha_constituency,,8,0,8,7e-06,31
en.wikipedia.org/wiki/Sitapur_Lok_Sabha_constituency,,8,0,8,7e-06,31
en.wikipedia.org/wiki/Sultanpur_Lok_Sabha_constituency,,9,0,9,7e-06,31
en.wikipedia.org/wiki/Unnao_Lok_Sabha_constituency,,8,0,8,7e-06,31
en.wikipedia.org/wiki/Varanasi_Lok_Sabha_constituency,,8,0,8,7e-06,31
en.wikipedia.org/wiki/File:Uttar_Pradesh_Wahlkreise_Lok_Sabha.svg,,8,0,8,7e-06,31
en.wikipedia.org/wiki/Balrampur_Lok_Sabha_constituency,,8,0,8,7e-06,31
en.wikipedia.org/wiki/Chail_Lok_Sabha_constituency,,8,0,8,7e-06,31
en.wikipedia.org/wiki/Dehradun_Lok_Sabha_constituency,,8,0,8,7e-06,31
en.wikipedia.org/wiki/Jalesar_Lok_Sabha_constituency,,8,0,8,7e-06,31
en.wikipedia.org/wiki/Hapur_Lok_Sabha_constituency,,8,0,8,7e-06,31
en.wikipedia.org/wiki/Khurja_Lok_Sabha_constituency,,8,0,8,7e-06,31
en.wikipedia.org/wiki/Padrauna_Lok_Sabha_constituency,,8,0,8,7e-06,31
en.wikipedia.org/wiki/Saidpur_Lok_Sabha_constituency,,8,0,8,7e-06,31
"en.wikipedia.org/wiki/Shahabad,_Uttar_Pradesh_Lok_Sabha_constituency",,8,0,8,7e-06,31
en.wikipedia.org/w/index.php?title=Akbarpur_Lok_Sabha_constituency&action=edit&section=10,,1,0,1,6e-06,31
resultuniversity.com/election/akbarpur-lok-sabha,,1,0,1,6e-06,31
en.wikipedia.org/wiki/Category:Lok_Sabha_constituencies_in_Uttar_Pradesh,,6,0,6,7e-06,31
en.m.wikipedia.org/w/index.php?title=Akbarpur_Lok_Sabha_constituency&mobileaction=toggle_view_mobile,,1,0,1,6e-06,31
en.wikipedia.org/w/index.php?title=Special:CreateAccount&returnto=Amritpur%2C+Uttar+Pradesh,,1,0,1,7e-06,31
en.wikipedia.org/w/index.php?title=Special:UserLogin&returnto=Amritpur%2C+Uttar+Pradesh,,1,0,1,7e-06,31
fa.wikipedia.org/wiki/امریت‌پور،_اتار_پردیش,,1,0,1,7e-06,31
"hi.wikipedia.org/wiki/अमृतपुर,_फ़र्रूख़ाबाद_ज़िला",,1,0,1,7e-06,31
new.wikipedia.org/wiki/अमृतपुर_तहसील,,1,0,1,7e-06,31
ur.wikipedia.org/wiki/امرت_پور،_اترپردیش,,1,0,1,7e-06,31
wikidata.org/wiki/Special:EntityPage/Q4748700,,1,0,1,7e-06,31
"en.wikipedia.org/wiki/Talk:Amritpur,_Uttar_Pradesh",,1,0,1,7e-06,31
"en.wikipedia.org/w/index.php?title=Amritpur,_Uttar_Pradesh&action=edit",,1,0,1,7e-06,31
"en.wikipedia.org/w/index.php?title=Amritpur,_Uttar_Pradesh&action=history",,1,0,1,7e-06,31
"en.wikipedia.org/wiki/Special:WhatLinksHere/Amritpur,_Uttar_Pradesh",,1,0,1,7e-06,31
"en.wikipedia.org/wiki/Special:RecentChangesLinked/Amritpur,_Uttar_Pradesh",,1,0,1,7e-06,31
"en.wikipedia.org/w/index.php?title=Amritpur,_Uttar_Pradesh&oldid=1213132902",,1,0,1,7e-06,31
"en.wikipedia.org/w/index.php?title=Amritpur,_Uttar_Pradesh&action=info",,1,0,1,7e-06,31
"en.wikipedia.org/w/index.php?title=Amritpur,_Uttar_Pradesh&printable=yes",,1,0,1,7e-06,31
"en.wikipedia.org/wiki/Amritpur,_Nepal",,1,0,1,7e-06,31
en.wikipedia.org/wiki/Farrukhabad_District,,3,0,3,7e-06,31
farrukhabad.nic.in/,,3,0,3,7e-06,31
en.wikipedia.org/wiki/Tehsils,,1,0,1,7e-06,31
"en.wikipedia.org/w/index.php?title=Amritpur,_Uttar_Pradesh&action=edit&section=1",,1,0,1,7e-06,31
en.wikipedia.org/wiki/Amausi_Airport,,1,0,1,7e-06,31
"en.wikipedia.org/w/index.php?title=Amritpur,_Uttar_Pradesh&action=edit&section=2",,1,0,1,7e-06,31
"geohack.toolforge.org/geohack.php?pagename=Amritpur,_Uttar_Pradesh&params=27.33_N_79.35_E_",,1,0,1,7e-06,31
"en.wikipedia.org/w/index.php?title=Amritpur,_Uttar_Pradesh&action=edit&section=3",,1,0,1,7e-06,31
india9.com/i9show/72113.htm,,1,0,1,7e-06,31
sacredsites.com/asia/india/amritsar.html,,1,0,1,7e-06,31
en.wikipedia.org/wiki/Template:Farrukhabad-geo-stub,,1,0,1,7e-06,31
en.wikipedia.org/wiki/Template_talk:Farrukhabad-geo-stub,,1,0,1,7e-06,31
en.wikipedia.org/wiki/Special:EditPage/Template:Farrukhabad-geo-stub,,1,0,1,7e-06,31
en.wikipedia.org/wiki/Category:Cities_and_towns_in_Farrukhabad_district,,3,0,3,7e-06,31
"en.m.wikipedia.org/w/index.php?title=Amritpur,_Uttar_Pradesh&mobileaction=toggle_view_mobile",,1,0,1,7e-06,31
en.wikipedia.org/w/index.php?title=Special:CreateAccount&returnto=Auraiya,,1,0,1,6e-06,31
en.wikipedia.org/w/index.php?title=Special:UserLogin&returnto=Auraiya,,1,0,1,6e-06,31
zh-min-nan.wikipedia.org/wiki/Auraiya_(Ìn-tō͘),,1,0,1,6e-06,31
bh.wikipedia.org/wiki/औरैया,,1,0,1,6e-06,31
ceb.wikipedia.org/wiki/Auraiya_(lungsod),,1,0,1,6e-06,31
de.wikipedia.org/wiki/Auraiya,,1,0,1,6e-06,31
es.wikipedia.org/wiki/Auraiya,,1,0,1,6e-06,31
gu.wikipedia.org/wiki/ઔરૈયા,,1,0,1,6e-06,31
hi.wikipedia.org/wiki/औरैया,,1,0,1,6e-06,31
bpy.wikipedia.org/wiki/আউরাইয়া,,1,0,1,6e-06,31
it.wikipedia.org/wiki/Auraiya,,1,0,1,6e-06,31
mg.wikipedia.org/wiki/Auraiya,,1,0,1,6e-06,31
mr.wikipedia.org/wiki/औरैया,,1,0,1,6e-06,31
ms.wikipedia.org/wiki/Auraiya,,1,0,1,6e-06,31
nl.wikipedia.org/wiki/Auraiya_(India),,1,0,1,6e-06,31
new.wikipedia.org/wiki/औराइया,,1,0,1,6e-06,31
pa.wikipedia.org/wiki/ਔਰਿਆ,,1,0,1,6e-06,31
pnb.wikipedia.org/wiki/اورایا,,1,0,1,6e-06,31
pl.wikipedia.org/wiki/Auraiya_(Indie),,1,0,1,6e-06,31
pt.wikipedia.org/wiki/Auraiya,,1,0,1,6e-06,31
ru.wikipedia.org/wiki/Аурайя,,1,0,1,6e-06,31
sa.wikipedia.org/wiki/औरैया,,1,0,1,6e-06,31
sv.wikipedia.org/wiki/Auraiya,,1,0,1,6e-06,31
ta.wikipedia.org/wiki/ஔரையா,,1,0,1,6e-06,31
te.wikipedia.org/wiki/ఔరైయా,,1,0,1,6e-06,31
uk.wikipedia.org/wiki/Аурайя,,1,0,1,6e-06,31
ur.wikipedia.org/wiki/اوریا_(شہر),,1,0,1,6e-06,31
vi.wikipedia.org/wiki/Auraiya,,1,0,1,6e-06,31
zh.wikipedia.org/wiki/奥赖耶,,1,0,1,6e-06,31
wikidata.org/wiki/Special:EntityPage/Q582908,,1,0,1,6e-06,31
en.wikipedia.org/wiki/Talk:Auraiya,,1,0,1,6e-06,31
en.wikipedia.org/w/index.php?title=Auraiya&action=edit,,1,0,1,6e-06,31
en.wikipedia.org/w/index.php?title=Auraiya&action=history,,1,0,1,6e-06,31
en.wikipedia.org/wiki/Special:WhatLinksHere/Auraiya,,1,0,1,6e-06,31
en.wikipedia.org/wiki/Special:RecentChangesLinked/Auraiya,,1,0,1,6e-06,31
en.wikipedia.org/w/index.php?title=Auraiya&oldid=1290233822,,1,0,1,6e-06,31
en.wikipedia.org/w/index.php?title=Auraiya&action=info,,1,0,1,6e-06,31
en.wikipedia.org/w/index.php?title=Special:DownloadAsPdf&page=Auraiya&action=show-download-screen,,1,0,1,6e-06,31
en.wikipedia.org/w/index.php?title=Auraiya&printable=yes,,1,0,1,6e-06,31
commons.wikimedia.org/wiki/Category:Auraiya,,1,0,1,6e-06,31
en.wikipedia.org/wiki/Auraiya_(disambiguation),,1,0,1,6e-06,31
en.wikipedia.org/wiki/Special:EditPage/Auraiya,,1,0,1,6e-06,31
"google.com/search?as_eq=wikipedia&q=""Auraiya""",,1,0,1,6e-06,31
"google.com/search?tbm=nws&q=""Auraiya""+-wikipedia&tbs=ar:1",,1,0,1,6e-06,31
"google.com/search?&q=""Auraiya""&tbs=bkt:s&tbm=bks",,1,0,1,6e-06,31
"google.com/search?tbs=bks:1&q=""Auraiya""+-wikipedia",,1,0,1,6e-06,31
"scholar.google.com/scholar?q=""Auraiya""",,1,0,1,6e-06,31
"jstor.org/action/doBasicSearch?Query=""Auraiya""&acc=on&wc=on",,1,0,1,6e-06,31
auraiya.nic.in/,,3,0,3,7e-06,31
en.wikipedia.org/wiki/Municipal_board,,6,0,6,7e-06,31
en.wikipedia.org/w/index.php?title=Auraiya&action=edit&section=1,,1,0,1,6e-06,31
en.wikipedia.org/w/index.php?title=Auraiya&action=edit&section=2,,1,0,1,6e-06,31
en.wikipedia.org/wiki/Sengar_River,,2,0,2,7e-06,31
en.wikipedia.org/w/index.php?title=Auraiya&action=edit&section=3,,1,0,1,6e-06,31
en.wikipedia.org/w/index.php?title=Auraiya&action=edit&section=4,,1,0,1,6e-06,31
web.archive.org/web/20120208072152/http://auraya.nic.in/html/geography.htm,,1,0,1,6e-06,31
auraya.nic.in/html/geography.htm,,1,0,1,6e-06,31
auraiya.nic.in/document-category/census/,,1,0,1,6e-06,31
web.archive.org/web/20200407115633/https://auraiya.nic.in/document-category/census/,,1,0,1,6e-06,31
en.wikipedia.org/w/index.php?title=Auraiya&action=edit&section=5,,1,0,1,6e-06,31
en.wikivoyage.org/wiki/Dibiyapur,,4,0,4,7e-06,31
en.wikipedia.org/wiki/Category:Auraiya,,1,0,1,6e-06,31
en.wikipedia.org/wiki/Category:Cities_and_towns_in_Auraiya_district,,3,0,3,7e-06,31
en.wikipedia.org/wiki/Category:Articles_needing_additional_references_from_January_2023,,2,0,2,7e-06,31
en.wikipedia.org/wiki/Category:Wikipedia_articles_with_style_issues_from_January_2024,,1,0,1,6e-06,31
en.wikipedia.org/wiki/Category:Use_dmy_dates_from_March_2015,,5,0,5,7e-06,31
en.wikipedia.org/wiki/Category:Pages_using_infobox_settlement_with_bad_settlement_type,,7,0,7,7e-06,31
en.m.wikipedia.org/w/index.php?title=Auraiya&mobileaction=toggle_view_mobile,,1,0,1,6e-06,31
en.wikipedia.org/w/index.php?title=Special:CreateAccount&returnto=Armapur+Estate,,1,0,1,6e-06,31
en.wikipedia.org/w/index.php?title=Special:UserLogin&returnto=Armapur+Estate,,1,0,1,6e-06,31
zh-min-nan.wikipedia.org/wiki/Armapur_Estate,,1,0,1,6e-06,31
es.wikipedia.org/wiki/Armapur_Estate,,1,0,1,6e-06,31
hi.wikipedia.org/wiki/आर्मापुर_इस्टेट,,1,0,1,6e-06,31
bpy.wikipedia.org/wiki/আরমাপুর_এস্টেইট,,1,0,1,6e-06,31
it.wikipedia.org/wiki/Armapur_Estate,,1,0,1,6e-06,31
ms.wikipedia.org/wiki/Armapur_Estate,,1,0,1,6e-06,31
nl.wikipedia.org/wiki/Armapur_Estate,,1,0,1,6e-06,31
new.wikipedia.org/wiki/आरामपुर_इस्टेट,,1,0,1,6e-06,31
pl.wikipedia.org/wiki/Armapur_Estate,,1,0,1,6e-06,31
pt.wikipedia.org/wiki/Armapur_Estate,,1,0,1,6e-06,31
ur.wikipedia.org/wiki/ارماپور_سٹیٹ,,1,0,1,6e-06,31
vi.wikipedia.org/wiki/Armapur_Estate,,1,0,1,6e-06,31
zh.wikipedia.org/wiki/阿尔马普尔埃斯塔泰,,1,0,1,6e-06,31
wikidata.org/wiki/Special:EntityPage/Q582895,,1,0,1,6e-06,31
en.wikipedia.org/wiki/Talk:Armapur_Estate,,1,0,1,6e-06,31
en.wikipedia.org/w/index.php?title=Armapur_Estate&action=edit,,1,0,1,6e-06,31
en.wikipedia.org/w/index.php?title=Armapur_Estate&action=history,,1,0,1,6e-06,31
en.wikipedia.org/wiki/Special:WhatLinksHere/Armapur_Estate,,1,0,1,6e-06,31
en.wikipedia.org/wiki/Special:RecentChangesLinked/Armapur_Estate,,1,0,1,6e-06,31
en.wikipedia.org/w/index.php?title=Armapur_Estate&oldid=1277652996,,1,0,1,6e-06,31
en.wikipedia.org/w/index.php?title=Armapur_Estate&action=info,,1,0,1,6e-06,31
en.wikipedia.org/w/index.php?title=Armapur_Estate&printable=yes,,1,0,1,6e-06,31
en.wikipedia.org/wiki/Special:EditPage/Armapur_Estate,,1,0,1,6e-06,31
"google.com/search?as_eq=wikipedia&q=""Armapur+Estate""",,1,0,1,6e-06,31
"google.com/search?tbm=nws&q=""Armapur+Estate""+-wikipedia&tbs=ar:1",,1,0,1,6e-06,31
"google.com/search?&q=""Armapur+Estate""&tbs=bkt:s&tbm=bks",,1,0,1,6e-06,31
"google.com/search?tbs=bks:1&q=""Armapur+Estate""+-wikipedia",,1,0,1,6e-06,31
"scholar.google.com/scholar?q=""Armapur+Estate""",,1,0,1,6e-06,31
"jstor.org/action/doBasicSearch?Query=""Armapur+Estate""&acc=on&wc=on",,1,0,1,6e-06,31
en.wikipedia.org/w/index.php?title=Armapur_Estate&action=edit&section=1,,1,0,1,6e-06,31
en.wikipedia.org/w/index.php?title=Armapur_Estate&action=edit&section=2,,1,0,1,6e-06,31
en.m.wikipedia.org/w/index.php?title=Armapur_Estate&mobileaction=toggle_view_mobile,,1,0,1,6e-06,31
en.wikipedia.org/wiki/Govind_Nagar_Assembly_constituency,,12,0,12,7e-06,31
en.wikipedia.org/wiki/Unnao_Assembly_constituency,,11,0,11,7e-06,31
en.wikipedia.org/w/index.php?title=Special:CreateAccount&returnto=Auraiya+district,,1,0,1,6e-06,31
en.wikipedia.org/w/index.php?title=Special:UserLogin&returnto=Auraiya+district,,1,0,1,6e-06,31
ar.wikipedia.org/wiki/منطقة_اورايا,,1,0,1,6e-06,31
bn.wikipedia.org/wiki/ঔরিয়া_জেলা,,1,0,1,6e-06,31
zh-min-nan.wikipedia.org/wiki/Auraiya_(koān),,1,0,1,6e-06,31
bh.wikipedia.org/wiki/औरैया_जिला,,1,0,1,6e-06,31
ceb.wikipedia.org/wiki/Auraiya_(distrito),,1,0,1,6e-06,31
da.wikipedia.org/wiki/Auraiya_(distrikt),,1,0,1,6e-06,31
de.wikipedia.org/wiki/Auraiya_(Distrikt),,1,0,1,6e-06,31
es.wikipedia.org/wiki/Distrito_de_Auraiya,,1,0,1,6e-06,31
eu.wikipedia.org/wiki/Auraiya_barrutia,,1,0,1,6e-06,31
fa.wikipedia.org/wiki/بخش_اورایا,,1,0,1,6e-06,31
fr.wikipedia.org/wiki/District_d%27Auraiya,,1,0,1,6e-06,31
gu.wikipedia.org/wiki/ઔરૈયા_જિલ્લો,,1,0,1,6e-06,31
hi.wikipedia.org/wiki/औरैया_जिला,,1,0,1,6e-06,31
it.wikipedia.org/wiki/Distretto_di_Auraiya,,1,0,1,6e-06,31
mr.wikipedia.org/wiki/औरैया_जिल्हा,,1,0,1,6e-06,31
arz.wikipedia.org/wiki/اورايا,,1,0,1,6e-06,31
nl.wikipedia.org/wiki/Auraiya_(district),,1,0,1,6e-06,31
ne.wikipedia.org/wiki/औरैया_जिल्ला,,1,0,1,6e-06,31
new.wikipedia.org/wiki/औरैया_जिल्ला,,1,0,1,6e-06,31
no.wikipedia.org/wiki/Auraiya_(distrikt),,1,0,1,6e-06,31
pnb.wikipedia.org/wiki/ضلع_اورایا,,1,0,1,6e-06,31
pl.wikipedia.org/wiki/Auraiya_(dystrykt),,1,0,1,6e-06,31
ru.wikipedia.org/wiki/Аурайя_(округ),,1,0,1,6e-06,31
sa.wikipedia.org/wiki/औरैयामण्डलम्,,1,0,1,6e-06,31
sat.wikipedia.org/wiki/ᱚᱣᱨᱟᱭᱭᱟ_ᱦᱚᱱᱚᱛ,,1,0,1,6e-06,31
sv.wikipedia.org/wiki/Auraiya_(distrikt),,1,0,1,6e-06,31
ta.wikipedia.org/wiki/ஔரையா_மாவட்டம்,,1,0,1,6e-06,31
te.wikipedia.org/wiki/ఔరైయా_జిల్లా,,1,0,1,6e-06,31
uk.wikipedia.org/wiki/Аурайя_(округ),,1,0,1,6e-06,31
ur.wikipedia.org/wiki/ضلع_اوریا,,1,0,1,6e-06,31
vi.wikipedia.org/wiki/Auraiya_(huyện),,1,0,1,6e-06,31
zh.wikipedia.org/wiki/奧萊亞縣,,1,0,1,6e-06,31
wikidata.org/wiki/Special:EntityPage/Q1812533,,1,0,1,6e-06,31
en.wikipedia.org/wiki/Talk:Auraiya_district,,1,0,1,6e-06,31
en.wikipedia.org/w/index.php?title=Auraiya_district&action=edit,,1,0,1,6e-06,31
en.wikipedia.org/w/index.php?title=Auraiya_district&action=history,,1,0,1,6e-06,31
en.wikipedia.org/wiki/Special:WhatLinksHere/Auraiya_district,,1,0,1,6e-06,31
en.wikipedia.org/wiki/Special:RecentChangesLinked/Auraiya_district,,1,0,1,6e-06,31
en.wikipedia.org/w/index.php?title=Auraiya_district&oldid=1290712661,,1,0,1,6e-06,31
en.wikipedia.org/w/index.php?title=Auraiya_district&action=info,,1,0,1,6e-06,31
en.wikipedia.org/w/index.php?title=Auraiya_district&printable=yes,,1,0,1,6e-06,31
commons.wikimedia.org/wiki/Category:Auraiya_district,,1,0,1,6e-06,31
en.wikipedia.org/wiki/File:Pata_near_Pata_and_Phaphund_(5).jpg,,1,0,1,6e-06,31
en.wikipedia.org/wiki/Phaphund,,4,0,4,7e-06,31
en.wikipedia.org/wiki/File:India_Uttar_Pradesh_districts_2012_Auraiya.svg,,1,0,1,6e-06,31
en.wikipedia.org/wiki/Tehsils_of_India,,5,0,5,7e-06,31
en.wikipedia.org/wiki/Kannauj_(Lok_Sabha_constituency),,3,0,3,6e-06,31
en.wikipedia.org/wiki/Districts_of_Uttar_Pradesh,,7,0,7,7e-06,31
en.wikipedia.org/w/index.php?title=Auraiya_district&action=edit&section=1,,1,0,1,6e-06,31
en.wikipedia.org/wiki/File:Auraiyadistrict.jpg,,1,0,1,6e-06,31
en.wikipedia.org/wiki/National_Highway_19,,1,0,1,6e-06,31
en.wikipedia.org/w/index.php?title=Auraiya_district&action=edit&section=2,,1,0,1,6e-06,31
en.wikipedia.org/wiki/Rohillas,,2,0,2,6e-06,31
en.wikipedia.org/wiki/AD,,1,0,1,6e-06,31
en.wikipedia.org/wiki/Ahmad_Shah_Durrani,,3,0,3,6e-06,31
en.wikipedia.org/wiki/Marathas,,1,0,1,6e-06,31
en.wikipedia.org/w/index.php?title=Govind_Rao_Pandit&action=edit&redlink=1,,1,0,1,6e-06,31
en.wikipedia.org/wiki/Hafiz_Rahmat_Khan,,2,0,2,6e-06,31
en.wikipedia.org/wiki/Shuja-ud-daula,,1,0,1,6e-06,31
en.wikipedia.org/wiki/Safdar_Jang,,2,0,2,6e-06,31
en.wikipedia.org/wiki/Afghans,,1,0,1,6e-06,31
en.wikipedia.org/w/index.php?title=Rohillakhand&action=edit&redlink=1,,1,0,1,6e-06,31
en.wikipedia.org/wiki/Shikohabad,,1,0,1,6e-06,31
"en.wikipedia.org/wiki/File:Shuja-ud-daula,_Nawab_of_Oudh.tif",,1,0,1,6e-06,31
en.wikipedia.org/wiki/British_Commonwealth,,1,0,1,6e-06,31
en.wikipedia.org/wiki/Kudarkot,,1,0,1,6e-06,31
en.wikipedia.org/w/index.php?title=Auraiya_district&action=edit&section=3,,1,0,1,6e-06,31
en.wikipedia.org/wiki/Ramabai_Nagar_district,,1,0,1,6e-06,31
en.wikipedia.org/w/index.php?title=Auraiya_district&action=edit&section=4,,1,0,1,6e-06,31
en.wikipedia.org/wiki/Humid_subtropical,,1,0,1,6e-06,31
en.wikipedia.org/w/index.php?title=Auraiya_district&action=edit&section=5,,1,0,1,6e-06,31
en.wikipedia.org/w/index.php?title=Auraiya_district&action=edit&section=6,,1,0,1,6e-06,31
en.wikipedia.org/wiki/Nagar_Palika,,2,0,2,6e-06,31
en.wikipedia.org/wiki/Ajitmal,,1,0,1,6e-06,31
en.wikipedia.org/w/index.php?title=Auraiya_district&action=edit&section=7,,1,0,1,6e-06,31
en.wikipedia.org/wiki/Dalelnagar,,1,0,1,6e-06,31
"en.wikipedia.org/wiki/Niranjanapur,_Uttar_Pradesh",,2,0,2,7e-06,31
en.wikipedia.org/wiki/Umrain,,1,0,1,6e-06,31
en.wikipedia.org/w/index.php?title=Auraiya_district&action=edit&section=8,,1,0,1,6e-06,31
en.wikipedia.org/w/index.php?title=Ramshanker_katheriya&action=edit&redlink=1,,1,0,1,6e-06,31
en.wikipedia.org/wiki/Subrat_Pathak,,1,0,1,6e-06,31
en.wikipedia.org/w/index.php?title=Bhartiya_Janta_party&action=edit&redlink=1,,1,0,1,6e-06,31
en.wikipedia.org/wiki/2012_Uttar_Pradesh_legislative_assembly_election,,1,0,1,6e-06,31
en.wikipedia.org/w/index.php?title=Auraiya_district&action=edit&section=9,,1,0,1,6e-06,31
en.wikipedia.org/wiki/Industrial_sector,,1,0,1,6e-06,31
en.wikipedia.org/w/index.php?title=Auraiya_district&action=edit&section=10,,1,0,1,6e-06,31
en.wikipedia.org/w/index.php?title=Small_scale_industries&action=edit&redlink=1,,1,0,1,6e-06,31
en.wikipedia.org/w/index.php?title=Uttar_Pradesh_Petrochemical_Complex&action=edit&redlink=1,,1,0,1,6e-06,31
en.wikipedia.org/wiki/Natural_Gas,,1,0,1,6e-06,31
en.wikipedia.org/w/index.php?title=Auraiya_district&action=edit&section=11,,1,0,1,6e-06,31
en.wikipedia.org/wiki/File:Phaphund(Dibiyapur)Station.jpg,,1,0,1,6e-06,31
en.wikipedia.org/w/index.php?title=Auraiya_district&action=edit&section=12,,1,0,1,6e-06,31
en.wikipedia.org/w/index.php?title=Auraiya_district&action=edit&section=13,,1,0,1,6e-06,31
en.wikipedia.org/wiki/Faizabad,,1,0,1,6e-06,31
en.wikipedia.org/w/index.php?title=Auraiya_district&action=edit&section=14,,1,0,1,6e-06,31
en.wikipedia.org/wiki/2011_census_of_India,,7,0,7,7e-06,31
en.wikipedia.org/wiki/Family_planning_in_India,,6,0,6,7e-06,31
en.wikipedia.org/w/index.php?title=Auraiya_district&action=edit&section=15,,1,0,1,6e-06,31
en.wikipedia.org/w/index.php?title=Auraiya_district&action=edit&section=16,,1,0,1,6e-06,31
en.wikipedia.org/wiki/Indian_folk_music,,1,0,1,6e-06,31
en.wikipedia.org/wiki/Bhajans,,1,0,1,6e-06,31
en.wikipedia.org/w/index.php?title=Auraiya_district&action=edit&section=17,,1,0,1,6e-06,31
en.wikipedia.org/w/index.php?title=Auraiya_district&action=edit&section=18,,1,0,1,6e-06,31
en.wikipedia.org/wiki/Curry,,1,0,1,6e-06,31
en.wikipedia.org/wiki/Papad,,1,0,1,6e-06,31
en.wikipedia.org/wiki/Tava,,1,0,1,6e-06,31
en.wikipedia.org/wiki/Salad,,1,0,1,6e-06,31
en.wikipedia.org/wiki/Desserts,,1,0,1,6e-06,31
en.wikipedia.org/wiki/Wheat,,1,0,1,6e-06,31
en.wikipedia.org/wiki/Maize,,1,0,1,6e-06,31
en.wikipedia.org/wiki/Jowar,,1,0,1,6e-06,31
en.wikipedia.org/wiki/Urd_(bean),,1,0,1,6e-06,31
en.wikipedia.org/wiki/Arhar,,1,0,1,6e-06,31
en.wikipedia.org/wiki/Moong,,1,0,1,6e-06,31
en.wikipedia.org/wiki/Chickpea,,1,0,1,6e-06,31
en.wikipedia.org/wiki/Masur_(lentil),,1,0,1,6e-06,31
en.wikipedia.org/wiki/Peda,,1,0,1,6e-06,31
en.wikipedia.org/wiki/Gulabjamun,,1,0,1,6e-06,31
en.wikipedia.org/wiki/Petha,,1,0,1,6e-06,31
en.wikipedia.org/wiki/Imarti,,1,0,1,6e-06,31
en.wikipedia.org/wiki/Cham_cham,,1,0,1,6e-06,31
en.wikipedia.org/wiki/Samosa,,1,0,1,6e-06,31
en.wikipedia.org/wiki/Chaat,,1,0,1,6e-06,31
en.wikipedia.org/wiki/Paan,,1,0,1,6e-06,31
en.wikipedia.org/wiki/File:Indiandishes.jpg,,1,0,1,6e-06,31
en.wikipedia.org/wiki/File:Dal_Makhani.jpg,,1,0,1,6e-06,31
en.wikipedia.org/wiki/Dal_makhani,,1,0,1,6e-06,31
en.wikipedia.org/wiki/North_Indian,,1,0,1,6e-06,31
en.wikipedia.org/wiki/File:A_scene_of_Puri.JPG,,1,0,1,6e-06,31
en.wikipedia.org/wiki/File:Indian_cuisine-Panipuri-03.jpg,,1,0,1,6e-06,31
en.wikipedia.org/wiki/File:Samosachutney.jpg,,1,0,1,6e-06,31
en.wikipedia.org/wiki/File:Delhi_Chaat_with_saunth_chutney.jpg,,1,0,1,6e-06,31
en.wikipedia.org/wiki/File:JalebiIndia.jpg,,1,0,1,6e-06,31
en.wikipedia.org/w/index.php?title=Auraiya_district&action=edit&section=19,,1,0,1,6e-06,31
en.wikipedia.org/wiki/Lungi,,1,0,1,6e-06,31
en.wikipedia.org/wiki/Burqa,,1,0,1,6e-06,31
en.wikipedia.org/w/index.php?title=Auraiya_district&action=edit&section=20,,1,0,1,6e-06,31
en.wikipedia.org/wiki/Uninor,,1,0,1,6e-06,31
en.wikipedia.org/wiki/Tata_Indicom,,1,0,1,6e-06,31
en.wikipedia.org/wiki/Idea_Cellular,,1,0,1,6e-06,31
en.wikipedia.org/wiki/Tata_DoCoMo,,1,0,1,6e-06,31
en.wikipedia.org/w/index.php?title=Auraiya_district&action=edit&section=21,,1,0,1,6e-06,31
en.wikipedia.org/w/index.php?title=Auraiya_district&action=edit&section=22,,1,0,1,6e-06,31
censusindia.gov.in/nada/index.php/catalog/1168/download/3686/DH_2011_0931_PART_A_DCHB_AURAIYA.pdf,,1,0,1,6e-06,31
web.archive.org/web/20070906234458/http://auraiya.nic.in/,,1,0,1,6e-06,31
web.archive.org/web/20090715061426/http://www.geocities.com/anjan_kumar_pal/NTPC_Auraiya.html,,1,0,1,6e-06,31
web.archive.org/web/20090719030048/http://www.geocities.com/anjan_kumar_pal/GAIL_Auraiya.html,,1,0,1,6e-06,31
censusindia.gov.in/2011census/PCA/A2_Data_Table.html,,6,0,6,7e-06,31
cia.gov/library/publications/the-world-factbook/rankorder/2119rank.html,,5,0,5,7e-06,31
censusindia.gov.in/nada/index.php/catalog/10224/download/13336/DDW-C16-STMT-MDDS-0900.XLSX,,6,0,6,7e-06,31
en.wikipedia.org/w/index.php?title=Auraiya_district&action=edit&section=23,,1,0,1,6e-06,31
en.wikipedia.org/wiki/Template_talk:Auraiya_district,,4,0,4,7e-06,31
en.wikipedia.org/wiki/Special:EditPage/Template:Auraiya_district,,4,0,4,7e-06,31
en.wikipedia.org/wiki/Achhalda,,4,0,4,7e-06,31
"en.wikipedia.org/wiki/Atasu,_Uttar_Pradesh",,4,0,4,7e-06,31
en.wikipedia.org/wiki/Babarpur_Ajitmal,,4,0,4,7e-06,31
en.wikipedia.org/wiki/Template:Districts_of_Uttar_Pradesh,,6,0,6,7e-06,31
en.wikipedia.org/wiki/Template_talk:Districts_of_Uttar_Pradesh,,6,0,6,7e-06,31
en.wikipedia.org/wiki/Special:EditPage/Template:Districts_of_Uttar_Pradesh,,6,0,6,7e-06,31
"en.wikipedia.org/wiki/Ghaziabad_district,_India",,10,0,10,7e-06,31
en.wikipedia.org/wiki/Sant_Ravidas_Nagar_district,,6,0,6,7e-06,31
wikidata.org/wiki/Q1812533,,1,0,1,6e-06,31
viaf.org/viaf/254928929,,1,0,1,6e-06,31
id.loc.gov/authorities/n2012202979,,1,0,1,6e-06,31
en.wikipedia.org/wiki/Category:Auraiya_district,,2,0,2,7e-06,31
en.wikipedia.org/wiki/Category:Districts_of_Uttar_Pradesh,,6,0,6,7e-06,31
en.wikipedia.org/wiki/Category:Pages_using_infobox_settlement_with_no_coordinates,,11,0,11,7e-06,31
en.m.wikipedia.org/w/index.php?title=Auraiya_district&mobileaction=toggle_view_mobile,,1,0,1,6e-06,31
upload.wikimedia.org/wikipedia/commons/c/cd/Auraiyadistrict.jpg,,1,0,1,6e-06,31
upload.wikimedia.org/wikipedia/commons/thumb/1/1e/Indiandishes.jpg/120px-Indiandishes.jpg,,1,0,1,6e-06,31
upload.wikimedia.org/wikipedia/commons/thumb/f/f8/Dal_Makhani.jpg/120px-Dal_Makhani.jpg,,1,0,1,6e-06,31
upload.wikimedia.org/wikipedia/commons/thumb/4/49/Vegetarian_Curry.jpeg/120px-Vegetarian_Curry.jpeg,,1,0,1,6e-06,31
upload.wikimedia.org/wikipedia/commons/thumb/e/e9/A_scene_of_Puri.JPG/120px-A_scene_of_Puri.JPG,,1,0,1,6e-06,31
upload.wikimedia.org/wikipedia/commons/thumb/c/cb/Samosachutney.jpg/120px-Samosachutney.jpg,,1,0,1,6e-06,31
upload.wikimedia.org/wikipedia/commons/thumb/e/e6/JalebiIndia.jpg/120px-JalebiIndia.jpg,,1,0,1,6e-06,31
en.wikipedia.org/wiki/Banke_District,,2,0,2,7e-06,31
en.wikipedia.org/w/index.php?title=Special:CreateAccount&returnto=Barra%2C+Kanpur,,1,0,1,7e-06,31
en.wikipedia.org/w/index.php?title=Special:UserLogin&returnto=Barra%2C+Kanpur,,1,0,1,7e-06,31
wikidata.org/wiki/Special:EntityPage/Q16838195,,1,0,1,7e-06,31
"en.wikipedia.org/wiki/Talk:Barra,_Kanpur",,1,0,1,7e-06,31
"en.wikipedia.org/w/index.php?title=Barra,_Kanpur&action=edit",,1,0,1,7e-06,31
"en.wikipedia.org/w/index.php?title=Barra,_Kanpur&action=history",,1,0,1,7e-06,31
"en.wikipedia.org/wiki/Special:WhatLinksHere/Barra,_Kanpur",,1,0,1,7e-06,31
"en.wikipedia.org/wiki/Special:RecentChangesLinked/Barra,_Kanpur",,1,0,1,7e-06,31
"en.wikipedia.org/w/index.php?title=Barra,_Kanpur&oldid=1286515867",,1,0,1,7e-06,31
"en.wikipedia.org/w/index.php?title=Barra,_Kanpur&action=info",,1,0,1,7e-06,31
"en.wikipedia.org/w/index.php?title=Barra,_Kanpur&printable=yes",,1,0,1,7e-06,31
"en.wikipedia.org/wiki/Special:EditPage/Barra,_Kanpur",,1,0,1,7e-06,31
"google.com/search?as_eq=wikipedia&q=""Barra%2C+Kanpur""",,1,0,1,7e-06,31
"google.com/search?tbm=nws&q=""Barra%2C+Kanpur""+-wikipedia&tbs=ar:1",,1,0,1,7e-06,31
"google.com/search?&q=""Barra%2C+Kanpur""&tbs=bkt:s&tbm=bks",,1,0,1,7e-06,31
"google.com/search?tbs=bks:1&q=""Barra%2C+Kanpur""+-wikipedia",,1,0,1,7e-06,31
"scholar.google.com/scholar?q=""Barra%2C+Kanpur""",,1,0,1,7e-06,31
"jstor.org/action/doBasicSearch?Query=""Barra%2C+Kanpur""&acc=on&wc=on",,1,0,1,7e-06,31
kdaindia.co.in/en/index.php,,1,0,1,7e-06,31
en.wikipedia.org/wiki/State_Bank_Of_India,,1,0,1,7e-06,31
en.wikipedia.org/wiki/Allahabad_Bank,,3,0,3,7e-06,31
en.wikipedia.org/wiki/Category:Articles_lacking_sources_from_December_2013,,1,0,1,7e-06,31
en.wikipedia.org/wiki/Category:Pages_using_infobox_settlement_with_no_map,,5,0,5,7e-06,31
"en.m.wikipedia.org/w/index.php?title=Barra,_Kanpur&mobileaction=toggle_view_mobile",,1,0,1,7e-06,31
en.wikipedia.org/wiki/Sam_Higginbottom,,3,0,3,7e-06,31
en.wikipedia.org/wiki/Trauma_center,,4,0,4,7e-06,31
en.wikipedia.org/wiki/Alok_Kumar_Rai,,4,0,4,7e-06,31
en.wikipedia.org/w/index.php?title=Special:CreateAccount&returnto=Bhognipur,,1,0,1,7e-06,31
en.wikipedia.org/w/index.php?title=Special:UserLogin&returnto=Bhognipur,,1,0,1,7e-06,31
hi.wikipedia.org/wiki/भोगनीपुर,,1,0,1,7e-06,31
wikidata.org/wiki/Special:EntityPage/Q4901882,,1,0,1,7e-06,31
en.wikipedia.org/wiki/Talk:Bhognipur,,1,0,1,7e-06,31
en.wikipedia.org/w/index.php?title=Bhognipur&action=edit,,1,0,1,7e-06,31
en.wikipedia.org/w/index.php?title=Bhognipur&action=history,,1,0,1,7e-06,31
en.wikipedia.org/wiki/Special:WhatLinksHere/Bhognipur,,1,0,1,7e-06,31
en.wikipedia.org/wiki/Special:RecentChangesLinked/Bhognipur,,1,0,1,7e-06,31
en.wikipedia.org/w/index.php?title=Bhognipur&oldid=1029397034,,1,0,1,7e-06,31
en.wikipedia.org/w/index.php?title=Bhognipur&action=info,,1,0,1,7e-06,31
en.wikipedia.org/w/index.php?title=Special:DownloadAsPdf&page=Bhognipur&action=show-download-screen,,1,0,1,7e-06,31
en.wikipedia.org/w/index.php?title=Bhognipur&printable=yes,,1,0,1,7e-06,31
geohack.toolforge.org/geohack.php?pagename=Bhognipur&params=26.24_N_79.80_E_type:city_region:IN-UP,,1,0,1,7e-06,31
en.wikipedia.org/wiki/Malasa,,3,0,3,7e-06,31
en.wikipedia.org/wiki/Mawar,,1,0,1,7e-06,31
en.wikipedia.org/wiki/Gausganj,,1,0,1,7e-06,31
en.wikipedia.org/wiki/Chaudagra,,1,0,1,7e-06,31
"en.wikipedia.org/wiki/Barauli,_Kanpur_Dehat",,2,0,2,7e-06,31
en.wikipedia.org/w/index.php?title=Bhognipur&action=edit&section=1,,1,0,1,7e-06,31
web.archive.org/web/20090114045657/http://in.maps.yahoo.com/,,1,0,1,7e-06,31
in.maps.yahoo.com/,,1,0,1,7e-06,31
en.wikipedia.org/w/index.php?title=Bhognipur&action=edit&section=2,,1,0,1,7e-06,31
india9.com/i9show/Bhognipur-73607.htm,,1,0,1,7e-06,31
maplandia.com/india/uttar-pradesh/kanpur-dehat/bhognipur/,,1,0,1,7e-06,31
en.wikipedia.org/wiki/Template:RamabaiNagar-geo-stub,,3,0,3,7e-06,31
en.wikipedia.org/wiki/Template_talk:RamabaiNagar-geo-stub,,3,0,3,7e-06,31
en.wikipedia.org/wiki/Special:EditPage/Template:RamabaiNagar-geo-stub,,3,0,3,7e-06,31
en.m.wikipedia.org/w/index.php?title=Bhognipur&mobileaction=toggle_view_mobile,,1,0,1,7e-06,31
en.wikipedia.org/w/index.php?title=Special:CreateAccount&returnto=Bilhaur+Lok+Sabha+constituency,,1,0,1,6e-06,31
en.wikipedia.org/w/index.php?title=Special:UserLogin&returnto=Bilhaur+Lok+Sabha+constituency,,1,0,1,6e-06,31
mr.wikipedia.org/wiki/बिल्हौर_लोकसभा_मतदारसंघ_(१९५७-२००८),,1,0,1,6e-06,31
te.wikipedia.org/wiki/బిల్హౌర్_లోక్‌సభ_నియోజకవర్గం,,1,0,1,6e-06,31
wikidata.org/wiki/Special:EntityPage/Q4907728,,1,0,1,6e-06,31
en.wikipedia.org/wiki/Talk:Bilhaur_Lok_Sabha_constituency,,1,0,1,6e-06,31
en.wikipedia.org/w/index.php?title=Bilhaur_Lok_Sabha_constituency&action=edit,,1,0,1,6e-06,31
en.wikipedia.org/w/index.php?title=Bilhaur_Lok_Sabha_constituency&action=history,,1,0,1,6e-06,31
en.wikipedia.org/wiki/Special:WhatLinksHere/Bilhaur_Lok_Sabha_constituency,,1,0,1,6e-06,31
en.wikipedia.org/wiki/Special:RecentChangesLinked/Bilhaur_Lok_Sabha_constituency,,1,0,1,6e-06,31
en.wikipedia.org/w/index.php?title=Bilhaur_Lok_Sabha_constituency&oldid=1295436520,,1,0,1,6e-06,31
en.wikipedia.org/w/index.php?title=Bilhaur_Lok_Sabha_constituency&action=info,,1,0,1,6e-06,31
en.wikipedia.org/w/index.php?title=Bilhaur_Lok_Sabha_constituency&printable=yes,,1,0,1,6e-06,31
geohack.toolforge.org/geohack.php?pagename=Bilhaur_Lok_Sabha_constituency&params=26.8_N_80.1_E_,,1,0,1,6e-06,31
en.wikipedia.org/w/index.php?title=Bilhaur_Lok_Sabha_constituency&action=edit&section=1,,1,0,1,6e-06,31
en.wikipedia.org/w/index.php?title=Bilhaur_Lok_Sabha_constituency&action=edit&section=2,,1,0,1,6e-06,31
en.wikipedia.org/wiki/Jagdish_Awasthi,,1,0,1,6e-06,31
en.wikipedia.org/wiki/Sushila_Rohatgi,,1,0,1,6e-06,31
en.wikipedia.org/wiki/1980_Indian_general_election,,6,0,6,7e-06,31
en.wikipedia.org/wiki/Indian_National_Congress_(I),,10,0,10,7e-06,31
en.wikipedia.org/wiki/Arun_Nehru,,2,0,2,7e-06,31
en.wikipedia.org/wiki/Shyam_Bihari_Misra,,1,0,1,6e-06,31
en.wikipedia.org/wiki/1999_Indian_general_election,,6,0,6,7e-06,31
en.wikipedia.org/w/index.php?title=Bilhaur_Lok_Sabha_constituency&action=edit&section=3,,1,0,1,6e-06,31
en.wikipedia.org/w/index.php?title=Bilhaur_Lok_Sabha_constituency&action=edit&section=4,,1,0,1,6e-06,31
en.wikipedia.org/w/index.php?title=Lok_Dal_(Bahuguna)&action=edit&redlink=1,,1,0,1,6e-06,31
en.wikipedia.org/w/index.php?title=Bilhaur_Lok_Sabha_constituency&action=edit&section=5,,1,0,1,6e-06,31
en.wikipedia.org/wiki/Lok_Dal,,4,0,4,7e-06,31
en.wikipedia.org/w/index.php?title=Bilhaur_Lok_Sabha_constituency&action=edit&section=6,,1,0,1,6e-06,31
en.wikipedia.org/wiki/Sukhram_Singh_Yadav,,1,0,1,6e-06,31
en.wikipedia.org/w/index.php?title=Bilhaur_Lok_Sabha_constituency&action=edit&section=7,,1,0,1,6e-06,31
en.wikipedia.org/w/index.php?title=Bilhaur_Lok_Sabha_constituency&action=edit&section=8,,1,0,1,6e-06,31
en.wikipedia.org/w/index.php?title=Bilhaur_Lok_Sabha_constituency&action=edit&section=9,,1,0,1,6e-06,31
en.wikipedia.org/w/index.php?title=Bilhaur_Lok_Sabha_constituency&action=edit&section=10,,1,0,1,6e-06,31
en.wikipedia.org/w/index.php?title=Bilhaur_Lok_Sabha_constituency&action=edit&section=11,,1,0,1,6e-06,31
en.wikipedia.org/wiki/Category:Former_Lok_Sabha_constituencies_of_Uttar_Pradesh,,2,0,2,7e-06,31
en.wikipedia.org/wiki/Category:2008_disestablishments_in_India,,2,0,2,7e-06,31
en.wikipedia.org/wiki/Category:Constituencies_disestablished_in_2008,,2,0,2,7e-06,31
en.wikipedia.org/wiki/Category:Former_constituencies_of_the_Lok_Sabha,,2,0,2,7e-06,31
en.wikipedia.org/wiki/Category:Use_dmy_dates_from_April_2019,,8,0,8,7e-06,31
en.wikipedia.org/wiki/Category:Use_Indian_English_from_April_2019,,8,0,8,7e-06,31
en.m.wikipedia.org/w/index.php?title=Bilhaur_Lok_Sabha_constituency&mobileaction=toggle_view_mobile,,1,0,1,6e-06,31
en.wikipedia.org/w/index.php?title=Special:CreateAccount&returnto=Bilhaur,,1,0,1,6e-06,31
en.wikipedia.org/w/index.php?title=Special:UserLogin&returnto=Bilhaur,,1,0,1,6e-06,31
zh-min-nan.wikipedia.org/wiki/Bilhaur,,1,0,1,6e-06,31
ceb.wikipedia.org/wiki/Bilhaur,,1,0,1,6e-06,31
es.wikipedia.org/wiki/Bilhaur,,1,0,1,6e-06,31
hi.wikipedia.org/wiki/बिल्हौर,,1,0,1,6e-06,31
bpy.wikipedia.org/wiki/বিলহৌর,,1,0,1,6e-06,31
it.wikipedia.org/wiki/Bilhaur,,1,0,1,6e-06,31
mg.wikipedia.org/wiki/Bilhaur,,1,0,1,6e-06,31
ms.wikipedia.org/wiki/Bilhaur,,1,0,1,6e-06,31
nl.wikipedia.org/wiki/Bilhaur,,1,0,1,6e-06,31
new.wikipedia.org/wiki/बिल्हौर,,1,0,1,6e-06,31
pl.wikipedia.org/wiki/Bilhaur,,1,0,1,6e-06,31
pt.wikipedia.org/wiki/Bilhaur,,1,0,1,6e-06,31
sv.wikipedia.org/wiki/Bilhaur,,1,0,1,6e-06,31
ur.wikipedia.org/wiki/بلہور,,1,0,1,6e-06,31
vi.wikipedia.org/wiki/Bilhaur,,1,0,1,6e-06,31
zh.wikipedia.org/wiki/比尔豪尔,,1,0,1,6e-06,31
wikidata.org/wiki/Special:EntityPage/Q858170,,1,0,1,6e-06,31
en.wikipedia.org/wiki/Talk:Bilhaur,,1,0,1,6e-06,31
en.wikipedia.org/w/index.php?title=Bilhaur&action=edit,,1,0,1,6e-06,31
en.wikipedia.org/w/index.php?title=Bilhaur&action=history,,1,0,1,6e-06,31
en.wikipedia.org/wiki/Special:WhatLinksHere/Bilhaur,,1,0,1,6e-06,31
en.wikipedia.org/wiki/Special:RecentChangesLinked/Bilhaur,,1,0,1,6e-06,31
en.wikipedia.org/w/index.php?title=Bilhaur&oldid=1293929401,,1,0,1,6e-06,31
en.wikipedia.org/w/index.php?title=Bilhaur&action=info,,1,0,1,6e-06,31
en.wikipedia.org/w/index.php?title=Special:DownloadAsPdf&page=Bilhaur&action=show-download-screen,,1,0,1,6e-06,31
en.wikipedia.org/w/index.php?title=Bilhaur&printable=yes,,1,0,1,6e-06,31
en.wikipedia.org/w/index.php?title=Bilhaur&action=edit&section=1,,1,0,1,6e-06,31
en.wikipedia.org/w/index.php?title=Bilhaur&action=edit&section=2,,1,0,1,6e-06,31
en.wikipedia.org/w/index.php?title=Bilhaur&action=edit&section=3,,1,0,1,6e-06,31
en.wikipedia.org/wiki/Dariyapur_Bilhaur,,2,0,2,7e-06,31
en.wikipedia.org/wiki/Gadanpur_Ahar,,2,0,2,7e-06,31
en.wikipedia.org/wiki/Gadanpur_Chorsa,,2,0,2,7e-06,31
en.wikipedia.org/w/index.php?title=Bilhaur&action=edit&section=4,,1,0,1,6e-06,31
"en.wikipedia.org/wiki/Raypur,_Kanpur_Nagar",,2,0,2,7e-06,31
en.wikipedia.org/w/index.php?title=Bilhaur&action=edit&section=5,,1,0,1,6e-06,31
wikidata.org/wiki/Q858170,,1,0,1,6e-06,31
viaf.org/viaf/143189039,,1,0,1,6e-06,31
id.loc.gov/authorities/n89203135,,1,0,1,6e-06,31
nli.org.il/en/authorities/987007565161505171,,1,0,1,6e-06,31
en.m.wikipedia.org/w/index.php?title=Bilhaur&mobileaction=toggle_view_mobile,,1,0,1,6e-06,31
en.wikipedia.org/w/index.php?title=Special:CreateAccount&returnto=Bidhuna,,1,0,1,6e-06,31
en.wikipedia.org/w/index.php?title=Special:UserLogin&returnto=Bidhuna,,1,0,1,6e-06,31
zh-min-nan.wikipedia.org/wiki/Bidhuna,,1,0,1,6e-06,31
ceb.wikipedia.org/wiki/Bidhūna,,1,0,1,6e-06,31
es.wikipedia.org/wiki/Bidhuna,,1,0,1,6e-06,31
hi.wikipedia.org/wiki/बिधूना,,1,0,1,6e-06,31
bpy.wikipedia.org/wiki/বিধুনা,,1,0,1,6e-06,31
it.wikipedia.org/wiki/Bidhuna,,1,0,1,6e-06,31
mg.wikipedia.org/wiki/Bidhuna,,1,0,1,6e-06,31
ms.wikipedia.org/wiki/Bidhuna,,1,0,1,6e-06,31
nl.wikipedia.org/wiki/Bidhuna,,1,0,1,6e-06,31
new.wikipedia.org/wiki/बिधुना,,1,0,1,6e-06,31
pl.wikipedia.org/wiki/Bidhuna,,1,0,1,6e-06,31
pt.wikipedia.org/wiki/Bidhuna,,1,0,1,6e-06,31
ru.wikipedia.org/wiki/Бидхуна,,1,0,1,6e-06,31
sv.wikipedia.org/wiki/Bidhūna,,1,0,1,6e-06,31
ur.wikipedia.org/wiki/بدھونا,,1,0,1,6e-06,31
vi.wikipedia.org/wiki/Bidhuna,,1,0,1,6e-06,31
zh.wikipedia.org/wiki/比杜纳,,1,0,1,6e-06,31
wikidata.org/wiki/Special:EntityPage/Q796775,,1,0,1,6e-06,31
en.wikipedia.org/wiki/Talk:Bidhuna,,1,0,1,6e-06,31
en.wikipedia.org/w/index.php?title=Bidhuna&action=edit,,1,0,1,6e-06,31
en.wikipedia.org/w/index.php?title=Bidhuna&action=history,,1,0,1,6e-06,31
en.wikipedia.org/wiki/Special:WhatLinksHere/Bidhuna,,1,0,1,6e-06,31
en.wikipedia.org/wiki/Special:RecentChangesLinked/Bidhuna,,1,0,1,6e-06,31
en.wikipedia.org/w/index.php?title=Bidhuna&oldid=1282249042,,1,0,1,6e-06,31
en.wikipedia.org/w/index.php?title=Bidhuna&action=info,,1,0,1,6e-06,31
en.wikipedia.org/w/index.php?title=Special:DownloadAsPdf&page=Bidhuna&action=show-download-screen,,1,0,1,6e-06,31
en.wikipedia.org/w/index.php?title=Bidhuna&printable=yes,,1,0,1,6e-06,31
en.wikipedia.org/wiki/Rekha_Verma_(born_1973),,1,0,1,6e-06,31
en.wikipedia.org/wiki/Socialist_Party,,1,0,1,6e-06,31
en.wikipedia.org/wiki/Nagar_panchayat,,4,0,4,7e-06,31
en.wikipedia.org/w/index.php?title=Bidhuna&action=edit&section=1,,1,0,1,6e-06,31
geohack.toolforge.org/geohack.php?pagename=Bidhuna&params=26.82_N_79.52_E_,,1,0,1,6e-06,31
en.wikipedia.org/w/index.php?title=Bidhuna&action=edit&section=2,,1,0,1,6e-06,31
en.wikipedia.org/w/index.php?title=Bidhuna&action=edit&section=3,,1,0,1,6e-06,31
fallingrain.com/world/IN/36/Bidhuna.html,,1,0,1,6e-06,31
en.wikipedia.org/wiki/Template:Auraiya-geo-stub,,1,0,1,6e-06,31
en.wikipedia.org/wiki/Template_talk:Auraiya-geo-stub,,1,0,1,6e-06,31
en.wikipedia.org/wiki/Special:EditPage/Template:Auraiya-geo-stub,,1,0,1,6e-06,31
en.m.wikipedia.org/w/index.php?title=Bidhuna&mobileaction=toggle_view_mobile,,1,0,1,6e-06,31
en.wikipedia.org/w/index.php?title=BRICS_Universities_League&action=edit,,2,0,2,7e-06,31
en.wikipedia.org/wiki/Etah,,3,0,3,7e-06,31
wikidata.org/wiki/Special:EntityPage/Q106239717,,1,0,1,7e-06,31
en.wikipedia.org/wiki/Category_talk:1959_establishments_in_Uttar_Pradesh,,1,0,1,7e-06,31
en.wikipedia.org/w/index.php?title=Category:1959_establishments_in_Uttar_Pradesh&action=edit,,1,0,1,7e-06,31
en.wikipedia.org/w/index.php?title=Category:1959_establishments_in_Uttar_Pradesh&action=history,,1,0,1,7e-06,31
en.wikipedia.org/wiki/Special:WhatLinksHere/Category:1959_establishments_in_Uttar_Pradesh,,1,0,1,7e-06,31
en.wikipedia.org/wiki/Special:RecentChangesLinked/Category:1959_establishments_in_Uttar_Pradesh,,1,0,1,7e-06,31
en.wikipedia.org/w/index.php?title=Category:1959_establishments_in_Uttar_Pradesh&oldid=1011893877,,1,0,1,7e-06,31
en.wikipedia.org/w/index.php?title=Category:1959_establishments_in_Uttar_Pradesh&action=info,,1,0,1,7e-06,31
en.wikipedia.org/w/index.php?title=Category:1959_establishments_in_Uttar_Pradesh&printable=yes,,1,0,1,7e-06,31
en.wikipedia.org/wiki/Portal:1950s,,2,0,2,7e-06,31
en.wikipedia.org/wiki/1959,,2,0,2,7e-06,31
en.wikipedia.org/wiki/Category:1954_establishments_in_Uttar_Pradesh,,1,0,1,7e-06,31
en.wikipedia.org/wiki/Category:1957_establishments_in_Uttar_Pradesh,,1,0,1,7e-06,31
en.wikipedia.org/wiki/Category:1958_establishments_in_Uttar_Pradesh,,1,0,1,7e-06,31
en.wikipedia.org/wiki/Category:1960_establishments_in_Uttar_Pradesh,,1,0,1,7e-06,31
en.wikipedia.org/wiki/Category:1961_establishments_in_Uttar_Pradesh,,1,0,1,7e-06,31
en.wikipedia.org/wiki/Category:1962_establishments_in_Uttar_Pradesh,,1,0,1,7e-06,31
en.wikipedia.org/wiki/Category:1963_establishments_in_Uttar_Pradesh,,1,0,1,7e-06,31
en.wikipedia.org/wiki/Category:1964_establishments_in_Uttar_Pradesh,,1,0,1,7e-06,31
en.wikipedia.org/wiki/Category:1950s_establishments_in_Uttar_Pradesh,,1,0,1,7e-06,31
en.wikipedia.org/wiki/Category:1960s_establishments_in_Uttar_Pradesh,,1,0,1,7e-06,31
en.wikipedia.org/wiki/Category:1970s_establishments_in_Uttar_Pradesh,,1,0,1,7e-06,31
en.wikipedia.org/wiki/Category:1980s_establishments_in_Uttar_Pradesh,,1,0,1,7e-06,31
en.wikipedia.org/wiki/Category:1990s_establishments_in_Uttar_Pradesh,,1,0,1,7e-06,31
en.wikipedia.org/wiki/Category:2000s_establishments_in_Uttar_Pradesh,,1,0,1,7e-06,31
en.wikipedia.org/wiki/Central_Institute_of_Medicinal_and_Aromatic_Plants,,2,0,2,7e-06,31
en.wikipedia.org/wiki/City_Montessori_School,,4,0,4,7e-06,31
"en.wikipedia.org/wiki/City_Montessori_School,_Aliganj_Branch",,4,0,4,7e-06,31
"en.wikipedia.org/wiki/City_Montessori_School,_Station_Road_Branch",,4,0,4,7e-06,31
en.wikipedia.org/wiki/Dayanand_Brajendra_Swarup_College,,2,0,2,7e-06,31
en.wikipedia.org/wiki/Halim_Muslim_PG_College,,3,0,3,7e-06,31
en.wikipedia.org/wiki/Janta_College,,1,0,1,7e-06,31
en.wikipedia.org/wiki/Karm_Kshetra_Post_Graduate_College,,4,0,4,7e-06,31
en.wikipedia.org/wiki/Montfort_Inter_College,,4,0,4,7e-06,31
en.wikipedia.org/wiki/Prayagraj_Municipal_Corporation,,1,0,1,7e-06,31
en.wikipedia.org/wiki/Varanasi_Municipal_Corporation,,1,0,1,7e-06,31
en.wikipedia.org/wiki/Category:Establishments_in_Uttar_Pradesh_by_year,,1,0,1,7e-06,31
en.wikipedia.org/wiki/Category:1959_establishments_in_India_by_state_or_union_territory,,1,0,1,7e-06,31
en.wikipedia.org/wiki/Category:Category_series_navigation_using_skip-gaps_parameter,,2,0,2,7e-06,31
en.wikipedia.org/wiki/Category:Category_series_navigation_year_and_decade,,2,0,2,7e-06,31
en.wikipedia.org/wiki/Category:Establishment_category_Indian_state_with_11–20_pages,,1,0,1,7e-06,31
en.wikipedia.org/wiki/Category:Automatic_category_TOC_generates_no_TOC,,2,0,2,7e-06,31
upload.wikimedia.org/wikipedia/commons/thumb/6/61/Fifties_jukebox.png/20px-Fifties_jukebox.png,,2,0,2,7e-06,31
"en.wikipedia.org/wiki/A._P._J._Abdul_Kalam_Technological_University,_Thiruvananthapuram",,4,0,4,7e-06,31
wikidata.org/wiki/Special:EntityPage/Q7010912,,1,0,1,7e-06,31
en.wikipedia.org/wiki/Category_talk:Engineering_colleges_in_Uttar_Pradesh,,1,0,1,7e-06,31
en.wikipedia.org/w/index.php?title=Category:Engineering_colleges_in_Uttar_Pradesh&action=edit,,1,0,1,7e-06,31
en.wikipedia.org/w/index.php?title=Category:Engineering_colleges_in_Uttar_Pradesh&action=history,,1,0,1,7e-06,31
en.wikipedia.org/wiki/Special:WhatLinksHere/Category:Engineering_colleges_in_Uttar_Pradesh,,1,0,1,7e-06,31
en.wikipedia.org/wiki/Special:RecentChangesLinked/Category:Engineering_colleges_in_Uttar_Pradesh,,1,0,1,7e-06,31
en.wikipedia.org/w/index.php?title=Category:Engineering_colleges_in_Uttar_Pradesh&oldid=1139739477,,1,0,1,7e-06,31
en.wikipedia.org/w/index.php?title=Category:Engineering_colleges_in_Uttar_Pradesh&action=info,,1,0,1,7e-06,31
en.wikipedia.org/w/index.php?title=Category:Engineering_colleges_in_Uttar_Pradesh&printable=yes,,1,0,1,7e-06,31
"en.wikipedia.org/wiki/Category:Engineering_colleges_in_Ghaziabad,_Uttar_Pradesh",,1,0,1,7e-06,31
en.wikipedia.org/wiki/Category:Engineering_colleges_in_Lucknow,,1,0,1,7e-06,31
en.wikipedia.org/wiki/Category:Engineering_colleges_in_Meerut,,1,0,1,7e-06,31
en.wikipedia.org/wiki/Category:Engineering_colleges_in_Noida,,1,0,1,7e-06,31
en.wikipedia.org/wiki/Category:Engineering_colleges_in_Prayagraj,,1,0,1,7e-06,31
en.wikipedia.org/wiki/Category:Private_engineering_colleges_in_Uttar_Pradesh,,1,0,1,7e-06,31
"en.wikipedia.org/wiki/Buddha_Institute_of_Technology,_Gorakhpur",,1,0,1,7e-06,31
"en.wikipedia.org/wiki/College_of_Dairy_Technology,_Etawah",,2,0,2,7e-06,31
en.wikipedia.org/wiki/Kali_Charan_Nigam_Institute_of_Technology,,1,0,1,7e-06,31
en.wikipedia.org/wiki/Kamla_Nehru_Institute_of_Technology,,1,0,1,7e-06,31
en.wikipedia.org/wiki/Raj_Kumar_Goel_Engineering_College,,1,0,1,7e-06,31
en.wikipedia.org/wiki/Raja_Balwant_Singh_College,,1,0,1,7e-06,31
en.wikipedia.org/wiki/Rakshpal_Bahadur_College_of_Engineering_and_Technology,,1,0,1,7e-06,31
en.wikipedia.org/wiki/Shri_Ram_Murti_Smarak_College_of_Engineering_and_Technology_Unnao,,1,0,1,7e-06,31
en.wikipedia.org/wiki/Category:Technical_universities_and_colleges_in_Uttar_Pradesh,,1,0,1,7e-06,31
en.wikipedia.org/wiki/Category:Engineering_colleges_in_India_by_state_or_union_territory,,1,0,1,7e-06,31
en.wikipedia.org/wiki/Category:Science_and_technology_in_Uttar_Pradesh,,1,0,1,7e-06,31
en.wikipedia.org/w/index.php?title=Special:CreateAccount&returnto=Category%3AIIT+Kanpur,,1,0,1,7e-06,31
en.wikipedia.org/w/index.php?title=Special:UserLogin&returnto=Category%3AIIT+Kanpur,,1,0,1,7e-06,31
hi.wikipedia.org/wiki/श्रेणी:भारतीय_प्रौद्योगिकी_संस्थान_कानपुर,,1,0,1,7e-06,31
en.wikipedia.org/wiki/Category_talk:IIT_Kanpur,,1,0,1,7e-06,31
en.wikipedia.org/w/index.php?title=Category:IIT_Kanpur&action=edit,,1,0,1,7e-06,31
en.wikipedia.org/w/index.php?title=Category:IIT_Kanpur&action=history,,1,0,1,7e-06,31
en.wikipedia.org/wiki/Special:WhatLinksHere/Category:IIT_Kanpur,,1,0,1,7e-06,31
en.wikipedia.org/wiki/Special:RecentChangesLinked/Category:IIT_Kanpur,,1,0,1,7e-06,31
en.wikipedia.org/w/index.php?title=Category:IIT_Kanpur&oldid=1069818345,,1,0,1,7e-06,31
en.wikipedia.org/w/index.php?title=Category:IIT_Kanpur&action=info,,1,0,1,7e-06,31
en.wikipedia.org/w/index.php?title=Category:IIT_Kanpur&printable=yes,,1,0,1,7e-06,31
en.wikipedia.org/wiki/Kendriya_Vidyalaya_IIT_Kanpur,,1,0,1,7e-06,31
en.m.wikipedia.org/w/index.php?title=Category:IIT_Kanpur&mobileaction=toggle_view_mobile,,1,0,1,7e-06,31
en.wikipedia.org/wiki/Category:Articles_missing_coordinates_without_coordinates_on_Wikidata,,8,0,8,7e-06,31
en.wikipedia.org/w/index.php?title=Special:CreateAccount&returnto=Category%3APeople+from+Farrukhabad,,1,0,1,7e-06,31
en.wikipedia.org/w/index.php?title=Special:UserLogin&returnto=Category%3APeople+from+Farrukhabad,,1,0,1,7e-06,31
ar.wikipedia.org/wiki/تصنيف:أشخاص_من_فرروخاباد,,1,0,1,7e-06,31
bn.wikipedia.org/wiki/বিষয়শ্রেণী:ফারুখাবাদের_ব্যক্তি,,1,0,1,7e-06,31
fa.wikipedia.org/wiki/رده:اهالی_فرخ‌آباد،_هند,,1,0,1,7e-06,31
ur.wikipedia.org/wiki/زمرہ:فرخ_آباد_کی_شخصیات,,1,0,1,7e-06,31
vi.wikipedia.org/wiki/Thể_loại:Người_từ_Farrukhabad-cum-Fatehgarh,,1,0,1,7e-06,31
wikidata.org/wiki/Special:EntityPage/Q8733724,,1,0,1,7e-06,31
en.wikipedia.org/wiki/Category_talk:People_from_Farrukhabad,,1,0,1,7e-06,31
en.wikipedia.org/w/index.php?title=Category:People_from_Farrukhabad&action=edit,,1,0,1,7e-06,31
en.wikipedia.org/w/index.php?title=Category:People_from_Farrukhabad&action=history,,1,0,1,7e-06,31
en.wikipedia.org/wiki/Special:WhatLinksHere/Category:People_from_Farrukhabad,,1,0,1,7e-06,31
en.wikipedia.org/wiki/Special:RecentChangesLinked/Category:People_from_Farrukhabad,,1,0,1,7e-06,31
en.wikipedia.org/w/index.php?title=Category:People_from_Farrukhabad&oldid=1309812781,,1,0,1,7e-06,31
en.wikipedia.org/w/index.php?title=Category:People_from_Farrukhabad&action=info,,1,0,1,7e-06,31
en.wikipedia.org/w/index.php?title=Category:People_from_Farrukhabad&printable=yes,,1,0,1,7e-06,31
en.wikipedia.org/wiki/Ahmad_Khan_Bangash,,1,0,1,7e-06,31
en.wikipedia.org/wiki/Ramesh_Chandra_(entrepreneur),,1,0,1,7e-06,31
en.wikipedia.org/wiki/Naresh_Chander_Chaturvedi,,2,0,2,7e-06,31
en.wikipedia.org/wiki/Diler_Himmat_Khan,,1,0,1,7e-06,31
en.wikipedia.org/wiki/Brahm_Dutt_Dwivedi,,1,0,1,7e-06,31
en.wikipedia.org/wiki/Pranshu_Dutt_Dwivedi,,1,0,1,7e-06,31
en.wikipedia.org/wiki/Sunil_Dutt_Dwivedi,,1,0,1,7e-06,31
en.wikipedia.org/wiki/Farrukhabadi,,2,0,2,7e-06,31
en.wikipedia.org/wiki/Rehmat_Farrukhabadi,,1,0,1,7e-06,31
en.wikipedia.org/wiki/Mahmud_Husain,,1,0,1,7e-06,31
en.wikipedia.org/wiki/Masud_Husain_Khan,,3,0,3,7e-06,31
en.wikipedia.org/wiki/Meraj_Muhammad_Khan,,1,0,1,7e-06,31
en.wikipedia.org/wiki/Muhammad_Khan_Bangash,,4,0,4,7e-06,31
en.wikipedia.org/wiki/Ahmaq_Phaphoondvi,,1,0,1,7e-06,31
en.wikipedia.org/wiki/Chandra_Bhushan_Singh,,1,0,1,7e-06,31
en.wikipedia.org/wiki/Category:People_from_Uttar_Pradesh_by_populated_place,,2,0,2,7e-06,31
en.wikipedia.org/wiki/Category:Indian_people_by_populated_place,,3,0,3,7e-06,31
en.wikipedia.org/wiki/Category:Farrukhabad,,2,0,2,7e-06,31
en.wikipedia.org/wiki/Category:People_from_Farrukhabad_district,,1,0,1,7e-06,31
en.wikipedia.org/w/index.php?title=Special:CreateAccount&returnto=Category%3APeople+from+Etawah,,1,0,1,7e-06,31
en.wikipedia.org/w/index.php?title=Special:UserLogin&returnto=Category%3APeople+from+Etawah,,1,0,1,7e-06,31
ar.wikipedia.org/wiki/تصنيف:أشخاص_من_ايتواه,,1,0,1,7e-06,31
fa.wikipedia.org/wiki/رده:اهالی_اتاوه,,1,0,1,7e-06,31
ur.wikipedia.org/wiki/زمرہ:اٹاوہ_کی_شخصیات,,1,0,1,7e-06,31
vi.wikipedia.org/wiki/Thể_loại:Người_từ_Etawah,,1,0,1,7e-06,31
wikidata.org/wiki/Special:EntityPage/Q8733510,,1,0,1,7e-06,31
en.wikipedia.org/wiki/Category_talk:People_from_Etawah,,1,0,1,7e-06,31
en.wikipedia.org/w/index.php?title=Category:People_from_Etawah&action=edit,,1,0,1,7e-06,31
en.wikipedia.org/w/index.php?title=Category:People_from_Etawah&action=history,,1,0,1,7e-06,31
en.wikipedia.org/wiki/Special:WhatLinksHere/Category:People_from_Etawah,,1,0,1,7e-06,31
en.wikipedia.org/wiki/Special:RecentChangesLinked/Category:People_from_Etawah,,1,0,1,7e-06,31
en.wikipedia.org/w/index.php?title=Category:People_from_Etawah&oldid=1275026808,,1,0,1,7e-06,31
en.wikipedia.org/w/index.php?title=Category:People_from_Etawah&action=info,,1,0,1,7e-06,31
en.wikipedia.org/w/index.php?title=Category:People_from_Etawah&printable=yes,,1,0,1,7e-06,31
en.wikipedia.org/wiki/George_Adamson,,2,0,2,7e-06,31
en.wikipedia.org/wiki/K._Asif,,2,0,2,7e-06,31
en.wikipedia.org/wiki/M._A._B._Beg,,1,0,1,7e-06,31
en.wikipedia.org/wiki/Sarika_Devendra_Singh_Baghel,,1,0,1,7e-06,31
en.wikipedia.org/wiki/S._P._Singh_Baghel,,1,0,1,7e-06,31
en.wikipedia.org/wiki/Pia_Bajpiee,,1,0,1,7e-06,31
en.wikipedia.org/wiki/Suraiya_Hasan_Bose,,1,0,1,7e-06,31
en.wikipedia.org/wiki/Allan_Brooks,,1,0,1,7e-06,31
en.wikipedia.org/wiki/Chaturvedi_Dwarka_Prasad_Sharma,,1,0,1,7e-06,31
en.wikipedia.org/wiki/Devesh_Chauhan,,1,0,1,7e-06,31
en.wikipedia.org/wiki/Pradeep_Kumar_Dubey,,1,0,1,7e-06,31
en.wikipedia.org/wiki/Gabbar_Singh_Gujjar,,1,0,1,7e-06,31
en.wikipedia.org/wiki/Babu_Gulabrai,,2,0,2,7e-06,31
en.wikipedia.org/wiki/Allan_Octavian_Hume,,2,0,2,7e-06,31
en.wikipedia.org/wiki/C._K._Jain,,2,0,2,7e-06,31
en.wikipedia.org/wiki/Nawab_Khair_Andesh_Khan,,1,0,1,7e-06,31
en.wikipedia.org/wiki/Imdad_Khan,,1,0,1,7e-06,31
en.wikipedia.org/wiki/S._R._Mehrotra,,1,0,1,7e-06,31
en.wikipedia.org/wiki/Raghuraj_Singh_Shakya,,3,0,3,7e-06,31
en.wikipedia.org/wiki/Ajeet_Singh_Yadav,,1,0,1,7e-06,31
en.wikipedia.org/wiki/Akshay_Yadav,,2,0,2,7e-06,31
en.wikipedia.org/wiki/Pradeep_Kumar_Yadav,,1,0,1,7e-06,31
en.wikipedia.org/wiki/Category:People_from_Etawah_district,,1,0,1,7e-06,31
en.wikipedia.org/wiki/Category:Etawah,,3,0,3,7e-06,31
en.m.wikipedia.org/w/index.php?title=Category:People_from_Etawah&mobileaction=toggle_view_mobile,,1,0,1,7e-06,31
en.wikipedia.org/w/index.php?title=Special:CreateAccount&returnto=Category%3APeople+from+Kanpur,,1,0,1,6e-06,31
en.wikipedia.org/w/index.php?title=Special:UserLogin&returnto=Category%3APeople+from+Kanpur,,1,0,1,6e-06,31
ar.wikipedia.org/wiki/تصنيف:أشخاص_من_كانبور,,1,0,1,6e-06,31
bn.wikipedia.org/wiki/বিষয়শ্রেণী:কানপুরের_ব্যক্তি,,1,0,1,6e-06,31
fa.wikipedia.org/wiki/رده:اهالی_کان‌پور,,1,0,1,6e-06,31
ko.wikipedia.org/wiki/분류:칸푸르_출신,,1,0,1,6e-06,31
hi.wikipedia.org/wiki/श्रेणी:कानपुर_के_लोग,,1,0,1,6e-06,31
it.wikipedia.org/wiki/Categoria:Persone_legate_a_Kanpur,,1,0,1,6e-06,31
ja.wikipedia.org/wiki/Category:カーンプル出身の人物,,1,0,1,6e-06,31
ru.wikipedia.org/wiki/Категория:Персоналии:Канпур,,1,0,1,6e-06,31
ur.wikipedia.org/wiki/زمرہ:کان_پور_کی_شخصیات,,1,0,1,6e-06,31
wikidata.org/wiki/Special:EntityPage/Q7915747,,1,0,1,6e-06,31
en.wikipedia.org/wiki/Category_talk:People_from_Kanpur,,1,0,1,6e-06,31
en.wikipedia.org/w/index.php?title=Category:People_from_Kanpur&action=edit,,1,0,1,6e-06,31
en.wikipedia.org/w/index.php?title=Category:People_from_Kanpur&action=history,,1,0,1,6e-06,31
en.wikipedia.org/wiki/Special:WhatLinksHere/Category:People_from_Kanpur,,1,0,1,6e-06,31
en.wikipedia.org/wiki/Special:RecentChangesLinked/Category:People_from_Kanpur,,1,0,1,6e-06,31
en.wikipedia.org/w/index.php?title=Category:People_from_Kanpur&oldid=1309812866,,1,0,1,6e-06,31
en.wikipedia.org/w/index.php?title=Category:People_from_Kanpur&action=info,,1,0,1,6e-06,31
en.wikipedia.org/w/index.php?title=Category:People_from_Kanpur&printable=yes,,1,0,1,6e-06,31
commons.wikimedia.org/wiki/Category:People_of_Kanpur,,1,0,1,6e-06,31
en.wikipedia.org/wiki/Category:Entertainers_from_Kanpur,,1,0,1,6e-06,31
en.wikipedia.org/wiki/Category:Politicians_from_Kanpur,,1,0,1,6e-06,31
en.wikipedia.org/wiki/Category:Sportspeople_from_Kanpur,,1,0,1,6e-06,31
en.wikipedia.org/wiki/Category:Writers_from_Kanpur,,1,0,1,6e-06,31
en.wikipedia.org/wiki/Vijay_Krishna_Acharya,,1,0,1,6e-06,31
en.wikipedia.org/wiki/Swami_Achootanand,,1,0,1,6e-06,31
en.wikipedia.org/wiki/Varinder_Aggarwal,,1,0,1,6e-06,31
en.wikipedia.org/wiki/Ashutosh_Agnihotri,,1,0,1,6e-06,31
en.wikipedia.org/wiki/Ambika_Prasad_Bajpai,,1,0,1,6e-06,31
en.wikipedia.org/wiki/Valentine_Bambrick,,1,0,1,6e-06,31
en.wikipedia.org/wiki/Frank_Bellew,,1,0,1,6e-06,31
en.wikipedia.org/wiki/Neelam_Chaturvedi,,1,0,1,6e-06,31
en.wikipedia.org/wiki/Sharvee_Chaturvedi,,1,0,1,6e-06,31
en.wikipedia.org/wiki/Ramon_Chibb,,1,0,1,6e-06,31
en.wikipedia.org/wiki/Cecil_Clementi,,1,0,1,6e-06,31
en.wikipedia.org/wiki/Sibyl_Colefax,,1,0,1,6e-06,31
en.wikipedia.org/wiki/David_Dhawan,,1,0,1,6e-06,31
en.wikipedia.org/wiki/Ashwni_Dhir,,1,0,1,6e-06,31
en.wikipedia.org/wiki/Edith_Mary_Douglas,,1,0,1,6e-06,31
en.wikipedia.org/wiki/Vikas_Dubey,,1,0,1,6e-06,31
en.wikipedia.org/wiki/Sheeba_Aslam_Fehmi,,1,0,1,6e-06,31
en.wikipedia.org/wiki/Anirvan_Ghosh,,1,0,1,6e-06,31
en.wikipedia.org/wiki/Anupriya_Goenka,,1,0,1,6e-06,31
en.wikipedia.org/wiki/Vishwa_Kumar_Gupta,,1,0,1,6e-06,31
"en.wikipedia.org/wiki/Sir_Henry_Havelock-Allan,_1st_Baronet",,1,0,1,6e-06,31
en.wikipedia.org/wiki/Ishwardatt_Medharthi,,1,0,1,6e-06,31
en.wikipedia.org/wiki/Shruti_Kapoor,,1,0,1,6e-06,31
en.wikipedia.org/wiki/Abul_Khair_Kashfi,,1,0,1,6e-06,31
en.wikipedia.org/wiki/Tashu_Kaushik,,1,0,1,6e-06,31
en.wikipedia.org/wiki/Diksha_Kumari,,1,0,1,6e-06,31
en.wikipedia.org/wiki/Mina_MacKenzie,,1,0,1,6e-06,31
en.wikipedia.org/wiki/Richa_Maheshwari,,1,0,1,6e-06,31
en.wikipedia.org/wiki/Ajai_Malhotra,,1,0,1,6e-06,31
en.wikipedia.org/wiki/Sakshi_Malik_(actress),,1,0,1,6e-06,31
en.wikipedia.org/wiki/Alice_Marval,,2,0,2,7e-06,31
en.wikipedia.org/wiki/Ashley_Mehrotra,,1,0,1,6e-06,31
en.wikipedia.org/wiki/Bal_Chandra_Misra,,2,0,2,6e-06,31
en.wikipedia.org/wiki/Gopal_Shankar_Misra,,1,0,1,6e-06,31
en.wikipedia.org/wiki/Henry_Montgomery_(bishop),,1,0,1,6e-06,31
en.wikipedia.org/wiki/Khan_Muttaqi_Nadeem,,1,0,1,6e-06,31
en.wikipedia.org/wiki/Peter_de_Noronha,,2,0,2,7e-06,31
en.wikipedia.org/wiki/Ashok_Pandey,,1,0,1,6e-06,31
en.wikipedia.org/wiki/William_Peel_(Royal_Navy_officer),,1,0,1,6e-06,31
en.wikipedia.org/wiki/Usha_Priyamvada,,1,0,1,6e-06,31
en.wikipedia.org/wiki/Ramesh_Kuntal_Megh,,1,0,1,6e-06,31
en.wikipedia.org/wiki/Clement_Daniel_Rockey,,1,0,1,6e-06,31
en.wikipedia.org/wiki/Pradeep_Rohatgi,,2,0,2,7e-06,31
en.wikipedia.org/wiki/John_Forbes_Royle,,1,0,1,6e-06,31
en.wikipedia.org/wiki/John_Ryan_(VC_1857),,1,0,1,6e-06,31
en.wikipedia.org/wiki/K._Rai_Sahi,,1,0,1,6e-06,31
en.wikipedia.org/wiki/Meenakshi_Sargogi,,1,0,1,6e-06,31
en.wikipedia.org/wiki/Jyoti_Shukla_(handballer),,1,0,1,6e-06,31
en.wikipedia.org/wiki/Yogesh_Shukla,,1,0,1,6e-06,31
en.wikipedia.org/wiki/Rahul_Bachha_Sonkar,,1,0,1,6e-06,31
en.wikipedia.org/wiki/Raju_Srivastav,,1,0,1,6e-06,31
en.wikipedia.org/wiki/Jagendra_Swarup,,1,0,1,6e-06,31
en.wikipedia.org/wiki/Rajesh_Tandon,,1,0,1,6e-06,31
en.wikipedia.org/wiki/Roshan_Taneja,,1,0,1,6e-06,31
en.wikipedia.org/wiki/Kenneth_Tempest,,1,0,1,6e-06,31
en.wikipedia.org/wiki/Aseem_Trivedi,,1,0,1,6e-06,31
en.wikipedia.org/wiki/Usha_Yadav,,1,0,1,6e-06,31
en.wikipedia.org/wiki/Category:People_from_Kanpur_Nagar_district,,1,0,1,6e-06,31
en.m.wikipedia.org/w/index.php?title=Category:People_from_Kanpur&mobileaction=toggle_view_mobile,,1,0,1,6e-06,31
ar.wikipedia.org/wiki/تصنيف:أشخاص_من_مقاطعة_راماباي_نجار,,1,0,1,7e-06,31
bn.wikipedia.org/wiki/বিষয়শ্রেণী:কানপুর_দেহাত_জেলার_ব্যক্তি,,1,0,1,7e-06,31
fa.wikipedia.org/wiki/رده:اهالی_شهرستان_کانپور_دیهات,,1,0,1,7e-06,31
hi.wikipedia.org/wiki/श्रेणी:कानपुर_देहात_जिले_के_लोग,,1,0,1,7e-06,31
no.wikipedia.org/wiki/Kategori:Personer_fra_Ramabai_Nagar_District_i_Uttar_Pradesh,,1,0,1,7e-06,31
ur.wikipedia.org/wiki/زمرہ:ضلع_کانپور_دیہی_کی_شخصیات,,1,0,1,7e-06,31
wikidata.org/wiki/Special:EntityPage/Q8746912,,1,0,1,7e-06,31
en.wikipedia.org/wiki/Category_talk:People_from_Kanpur_Dehat_district,,1,0,1,7e-06,31
en.wikipedia.org/w/index.php?title=Category:People_from_Kanpur_Dehat_district&action=edit,,1,0,1,7e-06,31
en.wikipedia.org/w/index.php?title=Category:People_from_Kanpur_Dehat_district&action=history,,1,0,1,7e-06,31
en.wikipedia.org/wiki/Special:WhatLinksHere/Category:People_from_Kanpur_Dehat_district,,1,0,1,7e-06,31
en.wikipedia.org/wiki/Special:RecentChangesLinked/Category:People_from_Kanpur_Dehat_district,,1,0,1,7e-06,31
en.wikipedia.org/w/index.php?title=Category:People_from_Kanpur_Dehat_district&oldid=579548843,,1,0,1,7e-06,31
en.wikipedia.org/w/index.php?title=Category:People_from_Kanpur_Dehat_district&action=info,,1,0,1,7e-06,31
en.wikipedia.org/w/index.php?title=Category:People_from_Kanpur_Dehat_district&printable=yes,,1,0,1,7e-06,31
en.wikipedia.org/wiki/Avinash_Singh_Chauhan,,1,0,1,7e-06,31
en.wikipedia.org/wiki/Bhagwandin_Kushwaha,,1,0,1,7e-06,31
en.wikipedia.org/wiki/Radhey_Shyam_Kori,,2,0,2,7e-06,31
en.wikipedia.org/wiki/Jwala_Prasad_Kureel,,2,0,2,7e-06,31
en.wikipedia.org/wiki/Keshari_Lal,,2,0,2,7e-06,31
en.wikipedia.org/wiki/K._Nath,,1,0,1,7e-06,31
en.wikipedia.org/wiki/Mathura_Prasad_Pal,,1,0,1,7e-06,31
en.wikipedia.org/wiki/Poonam_Sankhwar,,2,0,2,7e-06,31
en.wikipedia.org/wiki/Ratna_Vajra_Rinpoche,,1,0,1,7e-06,31
en.wikipedia.org/wiki/Nirmala_Sankhwar,,1,0,1,7e-06,31
en.wikipedia.org/wiki/Pyare_Lal_Sankhwar,,2,0,2,7e-06,31
en.wikipedia.org/wiki/Santosh_Shukla,,1,0,1,7e-06,31
en.wikipedia.org/wiki/Chatta_Singh,,1,0,1,7e-06,31
en.wikipedia.org/wiki/Devendra_Singh_(politician),,1,0,1,7e-06,31
en.wikipedia.org/wiki/Tula_Ram,,2,0,2,7e-06,31
en.wikipedia.org/wiki/Category:Kanpur_Dehat_district,,5,0,5,7e-06,31
en.wikipedia.org/wiki/Category:People_from_Uttar_Pradesh_by_district,,1,0,1,7e-06,31
wikidata.org/wiki/Special:EntityPage/Q8881242,,1,0,1,7e-06,31
en.wikipedia.org/wiki/Category_talk:Universities_and_colleges_in_Kanpur,,1,0,1,7e-06,31
en.wikipedia.org/w/index.php?title=Category:Universities_and_colleges_in_Kanpur&action=edit,,1,0,1,7e-06,31
en.wikipedia.org/w/index.php?title=Category:Universities_and_colleges_in_Kanpur&action=history,,1,0,1,7e-06,31
en.wikipedia.org/wiki/Special:WhatLinksHere/Category:Universities_and_colleges_in_Kanpur,,1,0,1,7e-06,31
en.wikipedia.org/wiki/Special:RecentChangesLinked/Category:Universities_and_colleges_in_Kanpur,,1,0,1,7e-06,31
en.wikipedia.org/w/index.php?title=Category:Universities_and_colleges_in_Kanpur&oldid=1035120487,,1,0,1,7e-06,31
en.wikipedia.org/w/index.php?title=Category:Universities_and_colleges_in_Kanpur&action=info,,1,0,1,7e-06,31
en.wikipedia.org/w/index.php?title=Category:Universities_and_colleges_in_Kanpur&printable=yes,,1,0,1,7e-06,31
en.wikipedia.org/wiki/Brahmanand_College_Kanpur,,1,0,1,7e-06,31
en.wikipedia.org/wiki/Pt._Jawaharlal_Nehru_Government_Homeopathic_Medical_College_Hospital,,1,0,1,7e-06,31
en.wikipedia.org/wiki/S.N._Sen_B.V._Post_Graduate_College,,2,0,2,7e-06,31
en.wikipedia.org/wiki/Category:Universities_and_colleges_in_Uttar_Pradesh_by_city,,1,0,1,7e-06,31
en.wikipedia.org/w/index.php?title=Special:UserLogin&returnto=Category%3AVillages+in+Etawah+district,,1,0,1,7e-06,31
hi.wikipedia.org/wiki/श्रेणी:इटावा_ज़िले_के_गाँव,,1,0,1,7e-06,31
wikidata.org/wiki/Special:EntityPage/Q8898829,,1,0,1,7e-06,31
en.wikipedia.org/wiki/Category_talk:Villages_in_Etawah_district,,1,0,1,7e-06,31
en.wikipedia.org/w/index.php?title=Category:Villages_in_Etawah_district&action=edit,,1,0,1,7e-06,31
en.wikipedia.org/w/index.php?title=Category:Villages_in_Etawah_district&action=history,,1,0,1,7e-06,31
en.wikipedia.org/wiki/Special:WhatLinksHere/Category:Villages_in_Etawah_district,,1,0,1,7e-06,31
en.wikipedia.org/wiki/Special:RecentChangesLinked/Category:Villages_in_Etawah_district,,1,0,1,7e-06,31
en.wikipedia.org/w/index.php?title=Category:Villages_in_Etawah_district&oldid=1017603935,,1,0,1,7e-06,31
en.wikipedia.org/w/index.php?title=Category:Villages_in_Etawah_district&action=info,,1,0,1,7e-06,31
en.wikipedia.org/w/index.php?title=Category:Villages_in_Etawah_district&printable=yes,,1,0,1,7e-06,31
commons.wikimedia.org/wiki/Category:Villages_in_Etawah_district,,1,0,1,7e-06,31
en.wikipedia.org/wiki/Category:Saifai,,3,0,3,7e-06,31
en.wikipedia.org/wiki/Category:Sarsai_Nawar,,2,0,2,7e-06,31
en.wikipedia.org/wiki/Aheripur,,7,0,7,7e-06,31
en.wikipedia.org/wiki/Divrasai,,7,0,7,7e-06,31
en.wikipedia.org/wiki/Mahewa,,7,0,7,7e-06,31
en.wikipedia.org/wiki/Parasani,,7,0,7,7e-06,31
en.wikipedia.org/wiki/Sarsai_Nawar,,8,0,8,7e-06,31
en.wikipedia.org/wiki/Veerpur,,7,0,7,7e-06,31
en.wikipedia.org/wiki/Category:Villages_in_Uttar_Pradesh,,6,0,6,7e-06,31
en.wikipedia.org/wiki/Category:Villages_in_India_by_district,,6,0,6,7e-06,31
en.wikipedia.org/wiki/Category:Etawah_district,,3,0,3,7e-06,31
en.wikipedia.org/wiki/Category:Use_dmy_dates_from_January_2016,,6,0,6,7e-06,31
en.wikipedia.org/wiki/Category:Use_dmy_dates_from_February_2020,,3,0,3,7e-06,31
en.wikipedia.org/wiki/Category:Use_dmy_dates_from_May_2022,,3,0,3,6e-06,31
en.wikipedia.org/wiki/Category:Use_Indian_English_from_May_2014,,6,0,6,7e-06,31
en.wikipedia.org/wiki/Category:Use_Indian_English_from_March_2016,,2,0,2,6e-06,31
en.wikipedia.org/wiki/Category:Use_Indian_English_from_August_2018,,5,0,5,7e-06,31
hi.wikipedia.org/wiki/श्रेणी:औरैया_ज़िले_के_गाँव,,1,0,1,7e-06,31
wikidata.org/wiki/Special:EntityPage/Q24977322,,1,0,1,7e-06,31
en.wikipedia.org/wiki/Category_talk:Villages_in_Auraiya_district,,1,0,1,7e-06,31
en.wikipedia.org/w/index.php?title=Category:Villages_in_Auraiya_district&action=edit,,1,0,1,7e-06,31
en.wikipedia.org/w/index.php?title=Category:Villages_in_Auraiya_district&action=history,,1,0,1,7e-06,31
en.wikipedia.org/wiki/Special:WhatLinksHere/Category:Villages_in_Auraiya_district,,1,0,1,7e-06,31
en.wikipedia.org/wiki/Special:RecentChangesLinked/Category:Villages_in_Auraiya_district,,1,0,1,7e-06,31
en.wikipedia.org/w/index.php?title=Category:Villages_in_Auraiya_district&oldid=651672481,,1,0,1,7e-06,31
en.wikipedia.org/w/index.php?title=Category:Villages_in_Auraiya_district&action=info,,1,0,1,7e-06,31
en.wikipedia.org/w/index.php?title=Category:Villages_in_Auraiya_district&printable=yes,,1,0,1,7e-06,31
"en.wikipedia.org/wiki/Bela,_Auraiya",,1,0,1,7e-06,31
en.wikipedia.org/wiki/Chikta,,1,0,1,7e-06,31
en.wikipedia.org/wiki/Muradganj,,1,0,1,7e-06,31
hi.wikipedia.org/wiki/श्रेणी:फर्रुखाबाद_जिला_के_गाँव,,1,0,1,7e-06,31
wikidata.org/wiki/Special:EntityPage/Q8898835,,1,0,1,7e-06,31
en.wikipedia.org/wiki/Category_talk:Villages_in_Farrukhabad_district,,1,0,1,7e-06,31
en.wikipedia.org/w/index.php?title=Category:Villages_in_Farrukhabad_district&action=edit,,1,0,1,7e-06,31
en.wikipedia.org/w/index.php?title=Category:Villages_in_Farrukhabad_district&action=history,,1,0,1,7e-06,31
en.wikipedia.org/wiki/Special:WhatLinksHere/Category:Villages_in_Farrukhabad_district,,1,0,1,7e-06,31
en.wikipedia.org/wiki/Special:RecentChangesLinked/Category:Villages_in_Farrukhabad_district,,1,0,1,7e-06,31
en.wikipedia.org/w/index.php?title=Category:Villages_in_Farrukhabad_district&oldid=1041670426,,1,0,1,7e-06,31
en.wikipedia.org/w/index.php?title=Category:Villages_in_Farrukhabad_district&action=info,,1,0,1,7e-06,31
en.wikipedia.org/w/index.php?title=Category:Villages_in_Farrukhabad_district&printable=yes,,1,0,1,7e-06,31
en.wikipedia.org/wiki/Pataunja,,2,0,2,7e-06,31
en.wikipedia.org/wiki/Category:Farrukhabad_district,,2,0,2,7e-06,31
hi.wikipedia.org/wiki/श्रेणी:कानपुर_नगर_ज़िले_के_गाँव,,1,0,1,7e-06,31
wikidata.org/wiki/Special:EntityPage/Q8899069,,1,0,1,7e-06,31
en.wikipedia.org/wiki/Category_talk:Villages_in_Kanpur_Nagar_district,,1,0,1,7e-06,31
en.wikipedia.org/w/index.php?title=Category:Villages_in_Kanpur_Nagar_district&action=edit,,1,0,1,7e-06,31
en.wikipedia.org/w/index.php?title=Category:Villages_in_Kanpur_Nagar_district&action=history,,1,0,1,7e-06,31
en.wikipedia.org/wiki/Special:WhatLinksHere/Category:Villages_in_Kanpur_Nagar_district,,1,0,1,7e-06,31
en.wikipedia.org/wiki/Special:RecentChangesLinked/Category:Villages_in_Kanpur_Nagar_district,,1,0,1,7e-06,31
en.wikipedia.org/w/index.php?title=Category:Villages_in_Kanpur_Nagar_district&oldid=964436145,,1,0,1,7e-06,31
en.wikipedia.org/w/index.php?title=Category:Villages_in_Kanpur_Nagar_district&action=info,,1,0,1,7e-06,31
en.wikipedia.org/w/index.php?title=Category:Villages_in_Kanpur_Nagar_district&printable=yes,,1,0,1,7e-06,31
en.wikipedia.org/wiki/Akbarpur_Senga,,1,0,1,7e-06,31
"en.wikipedia.org/wiki/Anei,_Kanpur_Nagar",,1,0,1,7e-06,31
en.wikipedia.org/wiki/Ankin,,1,0,1,7e-06,31
en.wikipedia.org/wiki/Arjunpur_(Bilhaur),,1,0,1,7e-06,31
en.wikipedia.org/wiki/Aurangpur_Sabhi,,1,0,1,7e-06,31
en.wikipedia.org/wiki/Babhiyapur,,2,0,2,7e-06,31
en.wikipedia.org/wiki/Baira_Khanpur,,1,0,1,7e-06,31
en.wikipedia.org/wiki/Bairi_Alipur,,1,0,1,7e-06,31
en.wikipedia.org/wiki/Bakothi,,1,0,1,7e-06,31
en.wikipedia.org/wiki/Baramau,,1,0,1,7e-06,31
"en.wikipedia.org/wiki/Baranda,_Bilhaur",,1,0,1,7e-06,31
en.wikipedia.org/wiki/Bawan_Jhala_Muzaffarpur,,1,0,1,7e-06,31
en.wikipedia.org/wiki/Bedipur,,1,0,1,7e-06,31
"en.wikipedia.org/wiki/Bibipur,_Bilhaur",,1,0,1,7e-06,31
en.wikipedia.org/wiki/Bilhaur_Dehat,,1,0,1,7e-06,31
en.wikipedia.org/wiki/Birthi_Haveli,,1,0,1,7e-06,31
en.wikipedia.org/wiki/Chak_Khaspur,,2,0,2,7e-06,31
en.wikipedia.org/wiki/Chaubi_Gahi_Shikohabad,,1,0,1,7e-06,31
en.wikipedia.org/wiki/Chaukhandi,,1,0,1,7e-06,31
en.wikipedia.org/wiki/Dadarpur_Katha,,1,0,1,7e-06,31
en.wikipedia.org/wiki/Dadikha,,1,0,1,7e-06,31
en.wikipedia.org/wiki/Debipur_Sarai,,1,0,1,7e-06,31
en.wikipedia.org/wiki/Dewkali_Bilhaur,,1,0,1,7e-06,31
en.wikipedia.org/wiki/Gajana_(Bilhaur),,1,0,1,7e-06,31
en.wikipedia.org/wiki/Garh,,2,0,2,7e-06,31
en.wikipedia.org/wiki/Gilawat_Aminabad,,1,0,1,7e-06,31
en.wikipedia.org/wiki/Gujepur,,1,0,1,7e-06,31
en.wikipedia.org/wiki/Halpura,,1,0,1,7e-06,31
en.wikipedia.org/wiki/Hashimpur,,1,0,1,7e-06,31
en.wikipedia.org/wiki/Katari_Bohnar,,1,0,1,7e-06,31
en.wikipedia.org/wiki/Kati_Kui,,1,0,1,7e-06,31
en.wikipedia.org/wiki/Kursauli,,1,0,1,7e-06,31
en.wikipedia.org/wiki/Lakshmi_Villa,,2,0,2,7e-06,31
en.wikipedia.org/wiki/Madarpur_(Bilhaur),,1,0,1,7e-06,31
en.wikipedia.org/wiki/Musahebpur,,1,0,1,7e-06,31
en.wikipedia.org/wiki/Rahimpur_Bishdhan,,1,0,1,7e-06,31
"en.wikipedia.org/wiki/Ramaipur,_Kanpur",,1,0,1,7e-06,31
en.wikipedia.org/wiki/Saraiya_Bhoor,,1,0,1,7e-06,31
en.wikipedia.org/wiki/Shambhua,,1,0,1,7e-06,31
en.wikipedia.org/wiki/Sujawalpur,,1,0,1,7e-06,31
en.wikipedia.org/wiki/Tikwapur,,1,0,1,7e-06,31
fa.wikipedia.org/wiki/رده:روستاهای_بخش_کانپور_دیهات,,1,0,1,7e-06,31
hi.wikipedia.org/wiki/श्रेणी:कानपुर_देहात_ज़िले_के_गाँव,,1,0,1,7e-06,31
wikidata.org/wiki/Special:EntityPage/Q8899618,,1,0,1,7e-06,31
en.wikipedia.org/wiki/Category_talk:Villages_in_Kanpur_Dehat_district,,1,0,1,7e-06,31
en.wikipedia.org/w/index.php?title=Category:Villages_in_Kanpur_Dehat_district&action=edit,,1,0,1,7e-06,31
en.wikipedia.org/w/index.php?title=Category:Villages_in_Kanpur_Dehat_district&action=history,,1,0,1,7e-06,31
en.wikipedia.org/wiki/Special:WhatLinksHere/Category:Villages_in_Kanpur_Dehat_district,,1,0,1,7e-06,31
en.wikipedia.org/wiki/Special:RecentChangesLinked/Category:Villages_in_Kanpur_Dehat_district,,1,0,1,7e-06,31
en.wikipedia.org/w/index.php?title=Category:Villages_in_Kanpur_Dehat_district&oldid=579548875,,1,0,1,7e-06,31
en.wikipedia.org/w/index.php?title=Category:Villages_in_Kanpur_Dehat_district&action=info,,1,0,1,7e-06,31
en.wikipedia.org/w/index.php?title=Category:Villages_in_Kanpur_Dehat_district&printable=yes,,1,0,1,7e-06,31
en.wikipedia.org/wiki/Amauli_Thakuran,,1,0,1,7e-06,31
en.wikipedia.org/wiki/Ambiyapur,,2,0,2,7e-06,31
en.wikipedia.org/wiki/Bairi_Sawai,,1,0,1,7e-06,31
"en.wikipedia.org/wiki/Bhatauli,_Kanpur_Dehat",,1,0,1,7e-06,31
en.wikipedia.org/wiki/Chapar_Ghata,,2,0,2,7e-06,31
en.wikipedia.org/wiki/Chaunrah,,2,0,2,7e-06,31
en.wikipedia.org/wiki/Dharau,,2,0,2,7e-06,31
en.wikipedia.org/wiki/Durrajpur,,2,0,2,7e-06,31
en.wikipedia.org/wiki/Gahlon,,1,0,1,7e-06,31
en.wikipedia.org/wiki/Injuwarampur,,1,0,1,7e-06,31
en.wikipedia.org/wiki/Jignipurwa,,1,0,1,7e-06,31
"en.wikipedia.org/wiki/Lalpur,_Kanpur_Dehat",,1,0,1,7e-06,31
en.wikipedia.org/wiki/Mulahi,,1,0,1,7e-06,31
"en.wikipedia.org/wiki/Paman,_Kanpur_Dehat",,2,0,2,7e-06,31
en.wikipedia.org/wiki/Parmu_ka_Purwa,,1,0,1,7e-06,31
"en.wikipedia.org/wiki/Rajpur,_Kanpur_Dehat",,2,0,2,7e-06,31
"en.wikipedia.org/wiki/Satti,_Kanpur",,1,0,1,7e-06,31
en.wikipedia.org/wiki/Tilaunchi,,2,0,2,7e-06,31
hi.wikipedia.org/wiki/श्रेणी:कन्नौज_जिला_के_गाँव,,1,0,1,7e-06,31
wikidata.org/wiki/Special:EntityPage/Q8899067,,1,0,1,7e-06,31
en.wikipedia.org/wiki/Category_talk:Villages_in_Kannauj_district,,1,0,1,7e-06,31
en.wikipedia.org/w/index.php?title=Category:Villages_in_Kannauj_district&action=edit,,1,0,1,7e-06,31
en.wikipedia.org/w/index.php?title=Category:Villages_in_Kannauj_district&action=history,,1,0,1,7e-06,31
en.wikipedia.org/wiki/Special:WhatLinksHere/Category:Villages_in_Kannauj_district,,1,0,1,7e-06,31
en.wikipedia.org/wiki/Special:RecentChangesLinked/Category:Villages_in_Kannauj_district,,1,0,1,7e-06,31
en.wikipedia.org/w/index.php?title=Category:Villages_in_Kannauj_district&oldid=1195529641,,1,0,1,7e-06,31
en.wikipedia.org/w/index.php?title=Category:Villages_in_Kannauj_district&action=info,,1,0,1,7e-06,31
en.wikipedia.org/w/index.php?title=Category:Villages_in_Kannauj_district&printable=yes,,1,0,1,7e-06,31
"en.wikipedia.org/wiki/Bishungarh,_Uttar_Pradesh",,3,0,3,7e-06,31
en.wikipedia.org/wiki/Nigoh_Khas,,2,0,2,7e-06,31
en.wikipedia.org/wiki/Category:Kannauj_district,,3,0,3,7e-06,31
en.wikipedia.org/wiki/Integral_Coach_Factory,,3,0,3,6e-06,31
en.wikipedia.org/wiki/Chennai_Egmore_railway_station,,3,0,3,6e-06,31
en.wikipedia.org/wiki/Tambaram_railway_station,,3,0,3,6e-06,31
en.wikipedia.org/wiki/Railway_stations_in_Chennai,,3,0,3,6e-06,31
en.wikipedia.org/wiki/M._A._Chidambaram_Stadium,,3,0,3,6e-06,31
en.wikipedia.org/w/index.php?title=Special:CreateAccount&returnto=Chandari+Junction+railway+station,,1,0,1,6e-06,31
en.wikipedia.org/w/index.php?title=Special:UserLogin&returnto=Chandari+Junction+railway+station,,1,0,1,6e-06,31
ur.wikipedia.org/wiki/چندری(کانپور)_ریلوے_اسٹیشن,,1,0,1,6e-06,31
wikidata.org/wiki/Special:EntityPage/Q5070973,,1,0,1,6e-06,31
en.wikipedia.org/wiki/Talk:Chandari_Junction_railway_station,,1,0,1,6e-06,31
en.wikipedia.org/w/index.php?title=Chandari_Junction_railway_station&action=edit,,1,0,1,6e-06,31
en.wikipedia.org/w/index.php?title=Chandari_Junction_railway_station&action=history,,1,0,1,6e-06,31
en.wikipedia.org/wiki/Special:WhatLinksHere/Chandari_Junction_railway_station,,1,0,1,6e-06,31
en.wikipedia.org/wiki/Special:RecentChangesLinked/Chandari_Junction_railway_station,,1,0,1,6e-06,31
en.wikipedia.org/w/index.php?title=Chandari_Junction_railway_station&oldid=1276773963,,1,0,1,6e-06,31
en.wikipedia.org/w/index.php?title=Chandari_Junction_railway_station&action=info,,1,0,1,6e-06,31
en.wikipedia.org/w/index.php?title=Chandari_Junction_railway_station&printable=yes,,1,0,1,6e-06,31
en.wikipedia.org/wiki/Railways_in_Kanpur,,1,0,1,6e-06,31
en.wikipedia.org/w/index.php?title=Chandari_Junction_railway_station&action=edit&section=1,,1,0,1,6e-06,31
indiarailinfo.com/station/map/chandari-cnbi/5244,,1,0,1,6e-06,31
m.patrika.com/news/kanpur/chandari-station-terminal-preparations-1023815/,,1,0,1,6e-06,31
m.jagran.com/uttar-pradesh/kanpur-city-10239622.html,,1,0,1,6e-06,31
minextlive.jagran.com/chandari-station-would-reduce-preasure-of-central-station-126452,,1,0,1,6e-06,31
en.wikipedia.org/wiki/Category:Pages_with_no_open_date_in_Infobox_station,,1,0,1,6e-06,31
en.wikipedia.org/wiki/Bhind,,4,0,4,6e-06,31
en.wikipedia.org/w/index.php?title=Special:CreateAccount&returnto=Chobepur,,1,0,1,7e-06,31
en.wikipedia.org/w/index.php?title=Special:UserLogin&returnto=Chobepur,,1,0,1,7e-06,31
wikidata.org/wiki/Special:EntityPage/Q5103465,,1,0,1,7e-06,31
en.wikipedia.org/wiki/Talk:Chobepur,,1,0,1,7e-06,31
en.wikipedia.org/w/index.php?title=Chobepur&action=edit,,1,0,1,7e-06,31
en.wikipedia.org/w/index.php?title=Chobepur&action=history,,1,0,1,7e-06,31
en.wikipedia.org/wiki/Special:WhatLinksHere/Chobepur,,1,0,1,7e-06,31
en.wikipedia.org/wiki/Special:RecentChangesLinked/Chobepur,,1,0,1,7e-06,31
en.wikipedia.org/w/index.php?title=Chobepur&oldid=1275951253,,1,0,1,7e-06,31
en.wikipedia.org/w/index.php?title=Chobepur&action=info,,1,0,1,7e-06,31
en.wikipedia.org/w/index.php?title=Special:DownloadAsPdf&page=Chobepur&action=show-download-screen,,1,0,1,7e-06,31
en.wikipedia.org/w/index.php?title=Chobepur&printable=yes,,1,0,1,7e-06,31
"google.com/search?as_eq=wikipedia&q=""Chobepur""",,1,0,1,7e-06,31
"google.com/search?tbm=nws&q=""Chobepur""+-wikipedia&tbs=ar:1",,1,0,1,7e-06,31
"google.com/search?&q=""Chobepur""&tbs=bkt:s&tbm=bks",,1,0,1,7e-06,31
"google.com/search?tbs=bks:1&q=""Chobepur""+-wikipedia",,1,0,1,7e-06,31
"scholar.google.com/scholar?q=""Chobepur""",,1,0,1,7e-06,31
"jstor.org/action/doBasicSearch?Query=""Chobepur""&acc=on&wc=on",,1,0,1,7e-06,31
en.wikipedia.org/wiki/Kanpur_Metropolitan_Area,,2,0,2,7e-06,31
en.wikipedia.org/w/index.php?title=Chobepur&action=edit&section=1,,1,0,1,7e-06,31
en.wikipedia.org/w/index.php?title=Chobepur&action=edit&section=2,,1,0,1,7e-06,31
"en.wikipedia.org/wiki/Ghaziabad,_Uttar_Pradesh",,2,0,2,7e-06,31
en.wikipedia.org/w/index.php?title=Chobepur&action=edit&section=3,,1,0,1,7e-06,31
en.wikipedia.org/w/index.php?title=Chobepur&action=edit&section=4,,1,0,1,7e-06,31
en.wikipedia.org/w/index.php?title=Chobepur&action=edit&section=5,,1,0,1,7e-06,31
en.wikipedia.org/w/index.php?title=Chobepur&action=edit&section=6,,1,0,1,7e-06,31
en.wikipedia.org/w/index.php?title=Non_river&action=edit&redlink=1,,1,0,1,7e-06,31
en.wikipedia.org/wiki/Stone_inscription,,1,0,1,7e-06,31
en.wikipedia.org/w/index.php?title=Chobepur&action=edit&section=7,,1,0,1,7e-06,31
jstor.org/stable/44141195,,1,0,1,7e-06,31
en.m.wikipedia.org/w/index.php?title=Chobepur&mobileaction=toggle_view_mobile,,1,0,1,7e-06,31
en.wikipedia.org/w/index.php?title=Special:CreateAccount&returnto=Chhibramau,,1,0,1,6e-06,31
en.wikipedia.org/w/index.php?title=Special:UserLogin&returnto=Chhibramau,,1,0,1,6e-06,31
zh-min-nan.wikipedia.org/wiki/Chhibramau,,1,0,1,6e-06,31
ceb.wikipedia.org/wiki/Chhibrāmau,,1,0,1,6e-06,31
de.wikipedia.org/wiki/Chhibramau,,1,0,1,6e-06,31
es.wikipedia.org/wiki/Chhibramau,,1,0,1,6e-06,31
hi.wikipedia.org/wiki/छिबरामऊ,,1,0,1,6e-06,31
bpy.wikipedia.org/wiki/ছিব্রামৌ,,1,0,1,6e-06,31
it.wikipedia.org/wiki/Chhibramau,,1,0,1,6e-06,31
mg.wikipedia.org/wiki/Chhibramau,,1,0,1,6e-06,31
ms.wikipedia.org/wiki/Chhibramau,,1,0,1,6e-06,31
nl.wikipedia.org/wiki/Chhibramau,,1,0,1,6e-06,31
new.wikipedia.org/wiki/छिब्रमौ,,1,0,1,6e-06,31
pl.wikipedia.org/wiki/Chhibramau,,1,0,1,6e-06,31
pt.wikipedia.org/wiki/Chhibramau,,1,0,1,6e-06,31
ru.wikipedia.org/wiki/Чхибрамау,,1,0,1,6e-06,31
sv.wikipedia.org/wiki/Chhibrāmau,,1,0,1,6e-06,31
ur.wikipedia.org/wiki/چھبراماؤ,,1,0,1,6e-06,31
vi.wikipedia.org/wiki/Chhibramau,,1,0,1,6e-06,31
zh.wikipedia.org/wiki/奇布拉毛,,1,0,1,6e-06,31
wikidata.org/wiki/Special:EntityPage/Q985000,,1,0,1,6e-06,31
en.wikipedia.org/wiki/Chhibramau,,6,0,6,7e-06,31
en.wikipedia.org/wiki/Talk:Chhibramau,,1,0,1,6e-06,31
en.wikipedia.org/w/index.php?title=Chhibramau&action=edit,,1,0,1,6e-06,31
en.wikipedia.org/w/index.php?title=Chhibramau&action=history,,1,0,1,6e-06,31
en.wikipedia.org/wiki/Special:WhatLinksHere/Chhibramau,,1,0,1,6e-06,31
en.wikipedia.org/wiki/Special:RecentChangesLinked/Chhibramau,,1,0,1,6e-06,31
en.wikipedia.org/w/index.php?title=Chhibramau&oldid=1286320131,,1,0,1,6e-06,31
en.wikipedia.org/w/index.php?title=Chhibramau&action=info,,1,0,1,6e-06,31
en.wikipedia.org/w/index.php?title=Special:DownloadAsPdf&page=Chhibramau&action=show-download-screen,,1,0,1,6e-06,31
en.wikipedia.org/w/index.php?title=Chhibramau&printable=yes,,1,0,1,6e-06,31
en.wikipedia.org/wiki/Archana_Pandey,,1,0,1,6e-06,31
chhibramau.in/,,1,0,1,6e-06,31
en.wikipedia.org/wiki/Nagar_palika_parishad,,1,0,1,6e-06,31
en.wikipedia.org/w/index.php?title=Chhibramau&action=edit&section=1,,1,0,1,6e-06,31
geohack.toolforge.org/geohack.php?pagename=Chhibramau&params=27_09_N_79_30_E_,,1,0,1,6e-06,31
en.wikipedia.org/w/index.php?title=Chhibramau&action=edit&section=2,,1,0,1,6e-06,31
en.wikipedia.org/w/index.php?title=Chhibramau&action=edit&section=3,,1,0,1,6e-06,31
en.wikipedia.org/wiki/Bewar,,1,0,1,6e-06,31
en.wikipedia.org/wiki/James_Hope_Grant,,1,0,1,6e-06,31
en.wikipedia.org/wiki/Kuraoli,,1,0,1,6e-06,31
en.wikipedia.org/wiki/Gursahaiganj,,5,0,5,7e-06,31
en.wikipedia.org/w/index.php?title=Chhibramau&action=edit&section=4,,1,0,1,6e-06,31
en.wikipedia.org/wiki/2001_Census_of_India,,1,0,1,6e-06,31
en.wikipedia.org/w/index.php?title=Chhibramau&action=edit&section=5,,1,0,1,6e-06,31
en.wikipedia.org/w/index.php?title=Chhibramau&action=edit&section=6,,1,0,1,6e-06,31
fallingrain.com/world/IN/36/Chhibramau.html,,1,0,1,6e-06,31
mainpuri.nic.in/history.htm,,1,0,1,6e-06,31
web.archive.org/web/20070701221509/http://mainpuri.nic.in/history.htm,,1,0,1,6e-06,31
chhibramau.in/nagar-palika-parishad-chhibramau-npp-chhibramau/,,1,0,1,6e-06,31
en.wikipedia.org/w/index.php?title=Chhibramau&action=edit&section=7,,1,0,1,6e-06,31
sec.up.nic.in/,,1,0,1,6e-06,31
en.wikipedia.org/wiki/Template_talk:Kannauj_district,,5,0,5,7e-06,31
en.wikipedia.org/wiki/Special:EditPage/Template:Kannauj_district,,5,0,5,7e-06,31
en.wikipedia.org/wiki/Samdhan,,5,0,5,7e-06,31
en.wikipedia.org/wiki/Saurikh,,5,0,5,7e-06,31
"en.wikipedia.org/wiki/Sikanderpur,_Kannauj",,5,0,5,7e-06,31
en.wikipedia.org/wiki/Talgram,,5,0,5,7e-06,31
"en.wikipedia.org/wiki/Tirwa,_Kannauj",,5,0,5,7e-06,31
en.wikipedia.org/wiki/Category:Cities_and_towns_in_Kannauj_district,,2,0,2,7e-06,31
en.wikipedia.org/wiki/Category:Articles_that_may_contain_original_research_from_June_2021,,1,0,1,6e-06,31
en.m.wikipedia.org/w/index.php?title=Chhibramau&mobileaction=toggle_view_mobile,,1,0,1,6e-06,31
en.wikipedia.org/w/index.php?title=Special:CreateAccount&returnto=Civil+Lines,,1,0,1,7e-06,31
en.wikipedia.org/w/index.php?title=Special:UserLogin&returnto=Civil+Lines,,1,0,1,7e-06,31
wikidata.org/wiki/Special:EntityPage/Q5124503,,1,0,1,7e-06,31
en.wikipedia.org/wiki/Talk:Civil_Lines,,1,0,1,7e-06,31
en.wikipedia.org/w/index.php?title=Civil_Lines&action=edit,,1,0,1,7e-06,31
en.wikipedia.org/w/index.php?title=Civil_Lines&action=history,,1,0,1,7e-06,31
en.wikipedia.org/wiki/Special:WhatLinksHere/Civil_Lines,,1,0,1,7e-06,31
en.wikipedia.org/wiki/Special:RecentChangesLinked/Civil_Lines,,1,0,1,7e-06,31
en.wikipedia.org/w/index.php?title=Civil_Lines&oldid=1260781127,,1,0,1,7e-06,31
en.wikipedia.org/w/index.php?title=Civil_Lines&action=info,,1,0,1,7e-06,31
en.wikipedia.org/w/index.php?title=Civil_Lines&printable=yes,,1,0,1,7e-06,31
en.wikipedia.org/wiki/Civil_Lines_(disambiguation),,1,0,1,7e-06,31
en.wikipedia.org/wiki/Divisional_commissioner,,1,0,1,7e-06,31
en.wikipedia.org/w/index.php?title=Civil_Lines&action=edit&section=1,,1,0,1,7e-06,31
"en.wikipedia.org/wiki/Civil_Lines,_Allahabad",,1,0,1,7e-06,31
"en.wikipedia.org/wiki/Civil_Lines,_Bareilly",,1,0,1,7e-06,31
"en.wikipedia.org/wiki/Civil_Lines,_Budaun",,1,0,1,7e-06,31
"en.wikipedia.org/wiki/Civil_Lines,_Moradabad",,1,0,1,7e-06,31
en.wikipedia.org/w/index.php?title=Civil_Lines&action=edit&section=2,,1,0,1,7e-06,31
"en.wikipedia.org/wiki/Civil_Lines,_Faisalabad",,1,0,1,7e-06,31
"en.wikipedia.org/wiki/Civil_Lines,_Karachi",,1,0,1,7e-06,31
"en.wikipedia.org/wiki/Civil_Lines,_Rawalpindi",,1,0,1,7e-06,31
en.wikipedia.org/w/index.php?title=Civil_Lines&action=edit&section=3,,1,0,1,7e-06,31
books.google.com/books?id=K0WGOixWwO0C&q=white+town+allahabad&pg=PT25,,1,0,1,7e-06,31
en.wikipedia.org/wiki/Special:BookSources/9780143102809,,1,0,1,7e-06,31
en.wikipedia.org/wiki/Category:Types_of_towns,,1,0,1,7e-06,31
en.wikipedia.org/wiki/Category:Urban_studies_and_planning_terminology,,1,0,1,7e-06,31
en.wikipedia.org/wiki/Category:Use_British_English_from_September_2024,,1,0,1,7e-06,31
en.m.wikipedia.org/w/index.php?title=Civil_Lines&mobileaction=toggle_view_mobile,,1,0,1,7e-06,31
en.wikipedia.org/wiki/AICTE,,4,0,4,7e-06,31
en.wikipedia.org/w/index.php?title=Special:CreateAccount&returnto=Derapur,,1,0,1,7e-06,31
en.wikipedia.org/w/index.php?title=Special:UserLogin&returnto=Derapur,,1,0,1,7e-06,31
el.wikipedia.org/wiki/Ντεραπούρ,,1,0,1,7e-06,31
es.wikipedia.org/wiki/Derapur,,1,0,1,7e-06,31
"hi.wikipedia.org/wiki/डेरापुर,_कानपुर_देहात",,1,0,1,7e-06,31
uk.wikipedia.org/wiki/Дерапур,,1,0,1,7e-06,31
wikidata.org/wiki/Special:EntityPage/Q5261353,,1,0,1,7e-06,31
en.wikipedia.org/wiki/Talk:Derapur,,1,0,1,7e-06,31
en.wikipedia.org/w/index.php?title=Derapur&action=edit,,1,0,1,7e-06,31
en.wikipedia.org/w/index.php?title=Derapur&action=history,,1,0,1,7e-06,31
en.wikipedia.org/wiki/Special:WhatLinksHere/Derapur,,1,0,1,7e-06,31
en.wikipedia.org/wiki/Special:RecentChangesLinked/Derapur,,1,0,1,7e-06,31
en.wikipedia.org/w/index.php?title=Derapur&oldid=1277419268,,1,0,1,7e-06,31
en.wikipedia.org/w/index.php?title=Derapur&action=info,,1,0,1,7e-06,31
en.wikipedia.org/w/index.php?title=Special:DownloadAsPdf&page=Derapur&action=show-download-screen,,1,0,1,7e-06,31
en.wikipedia.org/w/index.php?title=Derapur&printable=yes,,1,0,1,7e-06,31
geohack.toolforge.org/geohack.php?pagename=Derapur&params=26_25_0_N_79_48_0_E_type:city_region:IN-UP,,1,0,1,7e-06,31
en.wikipedia.org/wiki/Special:EditPage/Derapur,,1,0,1,7e-06,31
"google.com/search?as_eq=wikipedia&q=""Derapur""",,1,0,1,7e-06,31
"google.com/search?tbm=nws&q=""Derapur""+-wikipedia&tbs=ar:1",,1,0,1,7e-06,31
"google.com/search?&q=""Derapur""&tbs=bkt:s&tbm=bks",,1,0,1,7e-06,31
"google.com/search?tbs=bks:1&q=""Derapur""+-wikipedia",,1,0,1,7e-06,31
"scholar.google.com/scholar?q=""Derapur""",,1,0,1,7e-06,31
"jstor.org/action/doBasicSearch?Query=""Derapur""&acc=on&wc=on",,1,0,1,7e-06,31
en.wikipedia.org/w/index.php?title=Derapur&action=edit&section=1,,1,0,1,7e-06,31
en.wikipedia.org/w/index.php?title=Derapur&action=edit&section=2,,1,0,1,7e-06,31
en.wikipedia.org/wiki/Galuapur_Inter_College,,2,0,2,7e-06,31
en.wikipedia.org/w/index.php?title=Derapur&action=edit&section=3,,1,0,1,7e-06,31
en.wikipedia.org/w/index.php?title=Derapur&action=edit&section=4,,1,0,1,7e-06,31
en.wikipedia.org/w/index.php?title=Derapur&action=edit&section=5,,1,0,1,7e-06,31
en.wikipedia.org/wiki/File:Kapaleshwar_Temple.jpg,,1,0,1,7e-06,31
en.wikipedia.org/w/index.php?title=Derapur&action=edit&section=6,,1,0,1,7e-06,31
en.wikipedia.org/w/index.php?title=Derapur&action=edit&section=7,,1,0,1,7e-06,31
en.wikipedia.org/w/index.php?title=Derapur&action=edit&section=8,,1,0,1,7e-06,31
en.wikipedia.org/wiki/File:Galuwapur_Inter_College.jpg,,1,0,1,7e-06,31
en.wikipedia.org/wiki/File:Gudha_Devi_Shyam_Bihari_Degree_College.jpg,,1,0,1,7e-06,31
en.wikipedia.org/w/index.php?title=Derapur&action=edit&section=9,,1,0,1,7e-06,31
en.wikipedia.org/w/index.php?title=Derapur&action=edit&section=10,,1,0,1,7e-06,31
india9.com/i9show/Derapur-75196.htm,,1,0,1,7e-06,31
en.wikipedia.org/wiki/Category:Articles_needing_additional_references_from_February_2025,,1,0,1,7e-06,31
en.wikipedia.org/wiki/Category:Articles_with_unsourced_statements_from_April_2019,,1,0,1,7e-06,31
en.m.wikipedia.org/w/index.php?title=Derapur&mobileaction=toggle_view_mobile,,1,0,1,7e-06,31
"en.wikipedia.org/wiki/Rajiv_Gandhi_International_Cricket_Stadium,_Dehradun",,3,0,3,6e-06,31
en.wikipedia.org/w/index.php?title=Special:CreateAccount&returnto=Dibiyapur,,1,0,1,6e-06,31
en.wikipedia.org/w/index.php?title=Special:UserLogin&returnto=Dibiyapur,,1,0,1,6e-06,31
zh-min-nan.wikipedia.org/wiki/Dibiyapur,,1,0,1,6e-06,31
es.wikipedia.org/wiki/Dibiyapur,,1,0,1,6e-06,31
hi.wikipedia.org/wiki/दिबियापुर,,1,0,1,6e-06,31
bpy.wikipedia.org/wiki/দিব্যাপুর,,1,0,1,6e-06,31
it.wikipedia.org/wiki/Dibiyapur,,1,0,1,6e-06,31
ks.wikipedia.org/wiki/دیبیاپور,,1,0,1,6e-06,31
ms.wikipedia.org/wiki/Dibiyapur,,1,0,1,6e-06,31
nl.wikipedia.org/wiki/Dibiyapur,,1,0,1,6e-06,31
new.wikipedia.org/wiki/दिवियापुर,,1,0,1,6e-06,31
pl.wikipedia.org/wiki/Dibiyapur,,1,0,1,6e-06,31
pt.wikipedia.org/wiki/Dibiyapur,,1,0,1,6e-06,31
ru.wikipedia.org/wiki/Дибиапур,,1,0,1,6e-06,31
ur.wikipedia.org/wiki/دبیاپور,,1,0,1,6e-06,31
vi.wikipedia.org/wiki/Dibiyapur,,1,0,1,6e-06,31
zh.wikipedia.org/wiki/迪比耶普尔,,1,0,1,6e-06,31
wikidata.org/wiki/Special:EntityPage/Q1257009,,1,0,1,6e-06,31
en.wikipedia.org/wiki/Talk:Dibiyapur,,1,0,1,6e-06,31
en.wikipedia.org/w/index.php?title=Dibiyapur&action=edit,,1,0,1,6e-06,31
en.wikipedia.org/w/index.php?title=Dibiyapur&action=history,,1,0,1,6e-06,31
en.wikipedia.org/wiki/Special:WhatLinksHere/Dibiyapur,,1,0,1,6e-06,31
en.wikipedia.org/wiki/Special:RecentChangesLinked/Dibiyapur,,1,0,1,6e-06,31
en.wikipedia.org/w/index.php?title=Dibiyapur&oldid=1294291290,,1,0,1,6e-06,31
en.wikipedia.org/w/index.php?title=Dibiyapur&action=info,,1,0,1,6e-06,31
en.wikipedia.org/w/index.php?title=Special:DownloadAsPdf&page=Dibiyapur&action=show-download-screen,,1,0,1,6e-06,31
en.wikipedia.org/w/index.php?title=Dibiyapur&printable=yes,,1,0,1,6e-06,31
commons.wikimedia.org/wiki/Category:Dibiyapur,,1,0,1,6e-06,31
en.wikipedia.org/w/index.php?title=Kuldeep_Yadav_Arjun&action=edit&redlink=1,,1,0,1,6e-06,31
en.wikipedia.org/wiki/State_Highway_21_(Uttar_Pradesh),,1,0,1,6e-06,31
en.wikipedia.org/wiki/Kanpur–Delhi_section,,6,0,6,7e-06,31
en.wikipedia.org/wiki/Howrah–Gaya–Delhi_line,,5,0,5,7e-06,31
en.wikipedia.org/wiki/Lower_Ganga_Canal,,1,0,1,6e-06,31
en.wikipedia.org/w/index.php?title=Dibiyapur&action=edit&section=1,,1,0,1,6e-06,31
en.wikipedia.org/w/index.php?title=Dibiyapur&action=edit&section=2,,1,0,1,6e-06,31
en.wikipedia.org/w/index.php?title=Dibiyapur&action=edit&section=3,,1,0,1,6e-06,31
en.wikipedia.org/wiki/Sahayal,,1,0,1,6e-06,31
en.wikipedia.org/w/index.php?title=Dibiyapur&action=edit&section=4,,1,0,1,6e-06,31
en.wikipedia.org/w/index.php?title=Dibiyapur&action=edit&section=5,,1,0,1,6e-06,31
en.wikipedia.org/wiki/File:Phaphund_Railway_Station_(4).jpg,,2,0,2,6e-06,31
en.wikipedia.org/w/index.php?title=Kanchausi_railway_station&action=edit&redlink=1,,2,0,2,6e-06,31
en.wikipedia.org/w/index.php?title=Pata_railway_station&action=edit&redlink=1,,2,0,2,6e-06,31
en.wikipedia.org/w/index.php?title=Dibiyapur&action=edit&section=6,,1,0,1,6e-06,31
en.wikipedia.org/w/index.php?title=Dibiyapur&action=edit&section=7,,1,0,1,6e-06,31
en.wikipedia.org/wiki/Kalka_Mail,,2,0,2,6e-06,31
en.wikipedia.org/wiki/Gomti_Express,,1,0,1,6e-06,31
en.wikipedia.org/wiki/Udyan_Abha_Toofan_Express,,1,0,1,6e-06,31
en.wikipedia.org/wiki/Sangam_Express,,1,0,1,6e-06,31
en.wikipedia.org/w/index.php?title=Dibiyapur&action=edit&section=8,,1,0,1,6e-06,31
en.wikipedia.org/w/index.php?title=Dibiyapur&action=edit&section=9,,1,0,1,6e-06,31
en.wikipedia.org/w/index.php?title=Dibiyapur&action=edit&section=10,,1,0,1,6e-06,31
en.wikipedia.org/w/index.php?title=Dibiyapur&action=edit&section=11,,1,0,1,6e-06,31
en.wikipedia.org/w/index.php?title=Dibiyapur&action=edit&section=12,,1,0,1,6e-06,31
en.wikipedia.org/w/index.php?title=Dibiyapur&action=edit&section=13,,1,0,1,6e-06,31
en.wikipedia.org/w/index.php?title=Dibiyapur&action=edit&section=14,,1,0,1,6e-06,31
en.wikipedia.org/wiki/Lakhan_Singh,,1,0,1,6e-06,31
en.wikipedia.org/wiki/Dibiyapur_(Assembly_constituency),,1,0,1,6e-06,31
en.wikipedia.org/wiki/First_Yogi_Adityanath_ministry,,1,0,1,6e-06,31
en.wikipedia.org/w/index.php?title=Dibiyapur&action=edit&section=15,,1,0,1,6e-06,31
en.wikipedia.org/w/index.php?title=Dibiyapur&action=edit&section=16,,1,0,1,6e-06,31
en.wikipedia.org/wiki/Wikipedia:Manual_of_Style/Embedded_lists,,3,0,3,6e-06,31
en.wikipedia.org/w/index.php?title=Dibiyapur&action=edit&section=17,,1,0,1,6e-06,31
"en.wikipedia.org/wiki/Kendriya_Vidyalaya,_NTPC_Dibiyapur",,1,0,1,6e-06,31
en.wikipedia.org/w/index.php?title=Dibiyapur&action=edit&section=18,,1,0,1,6e-06,31
en.wikipedia.org/w/index.php?title=Saraswati_Vidya_Mandir_Inter_College&action=edit&redlink=1,,1,0,1,6e-06,31
en.wikipedia.org/w/index.php?title=Dibiyapur&action=edit&section=19,,1,0,1,6e-06,31
en.wikipedia.org/wiki/Saraswati_Shishu_Mandir,,1,0,1,6e-06,31
en.wikipedia.org/w/index.php?title=Gail_D.A.V._Model_School&action=edit&redlink=1,,1,0,1,6e-06,31
en.wikipedia.org/w/index.php?title=Vivekanand_Gramodyog_Mahavidyalaya&action=edit&redlink=1,,1,0,1,6e-06,31
en.wikipedia.org/w/index.php?title=Dibiyapur&action=edit&section=20,,1,0,1,6e-06,31
censusindia.co.in/towns/dibiyapur-population-auraiya-uttar-pradesh-800991,,1,0,1,6e-06,31
en.wikipedia.org/w/index.php?title=Dibiyapur&action=edit&section=21,,1,0,1,6e-06,31
en.wikipedia.org/w/index.php?title=Dibiyapur&action=edit&section=22,,1,0,1,6e-06,31
en.wikipedia.org/w/index.php?title=Dibiyapur&action=edit&section=23,,1,0,1,6e-06,31
accuweather.com/en/in/dibiyapur/201419/december-weather/201419?year=2019,,1,0,1,6e-06,31
en.wikipedia.org/w/index.php?title=Dibiyapur&action=edit&section=24,,1,0,1,6e-06,31
en.wikipedia.org/w/index.php?title=Dibiyapur&action=edit&section=25,,1,0,1,6e-06,31
en.wikipedia.org/w/index.php?title=Dibiyapur&action=edit&section=26,,1,0,1,6e-06,31
en.wikipedia.org/w/index.php?title=Dibiyapur&action=edit&section=27,,1,0,1,6e-06,31
en.wikipedia.org/w/index.php?title=Dibiyapur&action=edit&section=28,,1,0,1,6e-06,31
en.wikipedia.org/w/index.php?title=Dibiyapur&action=edit&section=29,,1,0,1,6e-06,31
en.wikipedia.org/w/index.php?title=Shalimar_Shopping_Complex&action=edit&redlink=1,,1,0,1,6e-06,31
en.wikipedia.org/w/index.php?title=Gail_Gaon&action=edit&redlink=1,,1,0,1,6e-06,31
en.wikipedia.org/wiki/Cheese,,1,0,1,6e-06,31
en.wikipedia.org/w/index.php?title=Dibiyapur&action=edit&section=30,,1,0,1,6e-06,31
"en.wikipedia.org/wiki/File:Gail_Vihar_Dibiyapur,_District_Auraiya.jpg",,1,0,1,6e-06,31
"en.wikipedia.org/wiki/File:Residential_Quarters_CISF_Dibiyapur,_District_Auraiya.jpg",,1,0,1,6e-06,31
en.wikipedia.org/w/index.php?title=GAIL_Vihar&action=edit&redlink=1,,1,0,1,6e-06,31
en.wikipedia.org/w/index.php?title=NTPC_Township&action=edit&redlink=1,,1,0,1,6e-06,31
en.wikipedia.org/w/index.php?title=Dibiyapur&action=edit&section=31,,1,0,1,6e-06,31
en.wikipedia.org/w/index.php?title=Dibiyapur&action=edit&section=32,,1,0,1,6e-06,31
en.wikipedia.org/w/index.php?title=Panchmukhi_Shiv_Mandir&action=edit&redlink=1,,1,0,1,6e-06,31
en.wikipedia.org/w/index.php?title=Dibiyapur&action=edit&section=33,,1,0,1,6e-06,31
en.wikipedia.org/w/index.php?title=Dibiyapur&action=edit&section=34,,1,0,1,6e-06,31
en.wikipedia.org/w/index.php?title=Dibiyapur&action=edit&section=35,,1,0,1,6e-06,31
en.wikipedia.org/w/index.php?title=Dibiyapur&action=edit&section=36,,1,0,1,6e-06,31
en.wikipedia.org/wiki/Chaitra,,1,0,1,6e-06,31
en.wikipedia.org/wiki/Rakshabandhan,,1,0,1,6e-06,31
en.wikipedia.org/wiki/Deepawali,,1,0,1,6e-06,31
en.wikipedia.org/wiki/Purnima,,1,0,1,6e-06,31
en.wikipedia.org/w/index.php?title=Dibiyapur&action=edit&section=37,,1,0,1,6e-06,31
"en.wikipedia.org/wiki/File:Muslims_in_Britain-_Eid_Ul_Fitr_Celebrations,_1941_D5129.jpg",,1,0,1,6e-06,31
en.wikipedia.org/wiki/Eid_prayers,,1,0,1,6e-06,31
en.wikipedia.org/wiki/Eid-ul-Fitr,,1,0,1,6e-06,31
en.wikipedia.org/wiki/Bakra_Eid,,1,0,1,6e-06,31
en.wikipedia.org/w/index.php?title=Dibiyapur&action=edit&section=38,,1,0,1,6e-06,31
en.wikipedia.org/wiki/File:Palki.jpg,,1,0,1,6e-06,31
en.wikipedia.org/w/index.php?title=Dibiyapur&action=edit&section=39,,1,0,1,6e-06,31
en.wikipedia.org/w/index.php?title=Dibiyapur&action=edit&section=40,,1,0,1,6e-06,31
en.wikipedia.org/wiki/Dussehra,,1,0,1,6e-06,31
en.wikipedia.org/w/index.php?title=Dibiyapur&action=edit&section=41,,1,0,1,6e-06,31
en.wikipedia.org/w/index.php?title=Dibiyapur&action=edit&section=42,,1,0,1,6e-06,31
en.wikipedia.org/w/index.php?title=Dibiyapur&action=edit&section=43,,1,0,1,6e-06,31
auraiya.nic.in/how-to-reach/,,1,0,1,6e-06,31
web.archive.org/web/20170610150530/http://eciresults.nic.in/ConstituencywiseS24203.htm?ac=203,,1,0,1,6e-06,31
eciresults.nic.in/ConstituencywiseS24203.htm?ac=203,,1,0,1,6e-06,31
gaildav.in/,,1,0,1,6e-06,31
stjosephsschooldibi.in/,,1,0,1,6e-06,31
web.archive.org/web/20140728172539/http://svmdibiyapur.com/index.aspx,,1,0,1,6e-06,31
svmdibiyapur.com/index.aspx,,1,0,1,6e-06,31
gaildav.orggailorg/,,1,0,1,6e-06,31
web.archive.org/web/20190327102418/http://www.vgmdibiyapurauraiya.org/,,1,0,1,6e-06,31
vgmdibiyapurauraiya.org/,,1,0,1,6e-06,31
ntpc.co.in/index.php?option=com_content&view=article&id=310&Itemid=84&lang=en,,1,0,1,6e-06,31
web.archive.org/web/20140515235746/http://www.gail.nic.in/final_site/gailoffices.html,,1,0,1,6e-06,31
gail.nic.in/final_site/gailoffices.html,,1,0,1,6e-06,31
en.wikipedia.org/w/index.php?title=Dibiyapur&action=edit&section=44,,1,0,1,6e-06,31
auraiya.nic.in/tourist-places/,,1,0,1,6e-06,31
en.wikipedia.org/wiki/Category:Dibiyapur,,1,0,1,6e-06,31
en.wikipedia.org/wiki/Category:Pages_using_Indian_Railways_adjacent_stations_with_unknown_termini,,3,0,3,6e-06,31
en.wikipedia.org/wiki/Category:Wikipedia_list_cleanup_from_August_2022,,1,0,1,6e-06,31
en.wikipedia.org/wiki/Category:Pages_using_bar_box_without_float_left_or_float_right,,1,0,1,6e-06,31
en.m.wikipedia.org/w/index.php?title=Dibiyapur&mobileaction=toggle_view_mobile,,1,0,1,6e-06,31
upload.wikimedia.org/wikipedia/commons/thumb/8/8f/Palki.jpg/120px-Palki.jpg,,1,0,1,6e-06,31
en.wikipedia.org/w/index.php?title=Special:CreateAccount&returnto=Etawah,,1,0,1,6e-06,31
en.wikipedia.org/w/index.php?title=Special:UserLogin&returnto=Etawah,,1,0,1,6e-06,31
awa.wikipedia.org/wiki/इटावा,,1,0,1,6e-06,31
azb.wikipedia.org/wiki/اتاوه,,1,0,1,6e-06,31
bn.wikipedia.org/wiki/ইটাওয়া,,1,0,1,6e-06,31
zh-min-nan.wikipedia.org/wiki/Etawah_(siâⁿ),,1,0,1,6e-06,31
bh.wikipedia.org/wiki/इटावा,,1,0,1,6e-06,31
ca.wikipedia.org/wiki/Etawah,,1,0,1,6e-06,31
ceb.wikipedia.org/wiki/Etāwah_(lungsod),,1,0,1,6e-06,31
cs.wikipedia.org/wiki/Itáva,,1,0,1,6e-06,31
de.wikipedia.org/wiki/Etawah,,1,0,1,6e-06,31
es.wikipedia.org/wiki/Etawah,,1,0,1,6e-06,31
eo.wikipedia.org/wiki/Etavah,,1,0,1,6e-06,31
fa.wikipedia.org/wiki/اتاوه,,1,0,1,6e-06,31
fr.wikipedia.org/wiki/Etawah,,1,0,1,6e-06,31
gu.wikipedia.org/wiki/ઈટાવા,,1,0,1,6e-06,31
ko.wikipedia.org/wiki/에타와,,1,0,1,6e-06,31
hi.wikipedia.org/wiki/इटावा,,1,0,1,6e-06,31
bpy.wikipedia.org/wiki/এটাৱা,,1,0,1,6e-06,31
id.wikipedia.org/wiki/Etawah,,1,0,1,6e-06,31
it.wikipedia.org/wiki/Etawah,,1,0,1,6e-06,31
kn.wikipedia.org/wiki/ಇಟಾವಾ,,1,0,1,6e-06,31
pam.wikipedia.org/wiki/Etawah,,1,0,1,6e-06,31
mai.wikipedia.org/wiki/इटावा,,1,0,1,6e-06,31
mg.wikipedia.org/wiki/Etawah,,1,0,1,6e-06,31
mr.wikipedia.org/wiki/इटावा,,1,0,1,6e-06,31
arz.wikipedia.org/wiki/ايتاوا,,1,0,1,6e-06,31
ms.wikipedia.org/wiki/Etawah,,1,0,1,6e-06,31
nl.wikipedia.org/wiki/Etawah_(stad),,1,0,1,6e-06,31
new.wikipedia.org/wiki/इतावाह,,1,0,1,6e-06,31
ja.wikipedia.org/wiki/イターワー,,1,0,1,6e-06,31
no.wikipedia.org/wiki/Etawah,,1,0,1,6e-06,31
or.wikipedia.org/wiki/ଏଟାୱା,,1,0,1,6e-06,31
pa.wikipedia.org/wiki/ਇਟਾਵਾ,,1,0,1,6e-06,31
pnb.wikipedia.org/wiki/اٹاوہ,,1,0,1,6e-06,31
pl.wikipedia.org/wiki/Etawah_(miasto),,1,0,1,6e-06,31
ru.wikipedia.org/wiki/Этавах,,1,0,1,6e-06,31
sa.wikipedia.org/wiki/इटावा,,1,0,1,6e-06,31
sat.wikipedia.org/wiki/ᱤᱴᱟᱣᱟ,,1,0,1,6e-06,31
sco.wikipedia.org/wiki/Etawah,,1,0,1,6e-06,31
simple.wikipedia.org/wiki/Etawah,,1,0,1,6e-06,31
sr.wikipedia.org/wiki/Етава,,1,0,1,6e-06,31
sv.wikipedia.org/wiki/Etawah,,1,0,1,6e-06,31
ta.wikipedia.org/wiki/இட்டாவா,,1,0,1,6e-06,31
te.wikipedia.org/wiki/ఎటావా,,1,0,1,6e-06,31
uk.wikipedia.org/wiki/Етавах,,1,0,1,6e-06,31
ur.wikipedia.org/wiki/اٹاوہ,,1,0,1,6e-06,31
vi.wikipedia.org/wiki/Etawah,,1,0,1,6e-06,31
war.wikipedia.org/wiki/Etawah,,1,0,1,6e-06,31
zh.wikipedia.org/wiki/埃塔瓦,,1,0,1,6e-06,31
wikidata.org/wiki/Special:EntityPage/Q878237,,1,0,1,6e-06,31
en.wikipedia.org/wiki/Talk:Etawah,,1,0,1,6e-06,31
en.wikipedia.org/w/index.php?title=Etawah&action=edit,,1,0,1,6e-06,31
en.wikipedia.org/w/index.php?title=Etawah&action=history,,1,0,1,6e-06,31
en.wikipedia.org/wiki/Special:WhatLinksHere/Etawah,,1,0,1,6e-06,31
en.wikipedia.org/wiki/Special:RecentChangesLinked/Etawah,,1,0,1,6e-06,31
en.wikipedia.org/w/index.php?title=Etawah&oldid=1302085141,,1,0,1,6e-06,31
en.wikipedia.org/w/index.php?title=Etawah&action=info,,1,0,1,6e-06,31
en.wikipedia.org/w/index.php?title=Special:QrCode&url=https%3A%2F%2Fen.wikipedia.org%2Fwiki%2FEtawah,,1,0,1,6e-06,31
en.wikipedia.org/w/index.php?title=Special:DownloadAsPdf&page=Etawah&action=show-download-screen,,1,0,1,6e-06,31
en.wikipedia.org/w/index.php?title=Etawah&printable=yes,,1,0,1,6e-06,31
commons.wikimedia.org/wiki/Category:Etawah,,1,0,1,6e-06,31
en.wikivoyage.org/wiki/Etawah,,2,0,2,6e-06,31
geohack.toolforge.org/geohack.php?pagename=Etawah&params=26.77_N_79.03_E_type:city_region:IN-UP,,1,0,1,6e-06,31
en.wikipedia.org/wiki/Etawah_(disambiguation),,1,0,1,6e-06,31
en.wikipedia.org/wiki/File:VVIP_Guest_House_(Sumer_SIngh_Fort).jpg,,1,0,1,6e-06,31
en.wikipedia.org/wiki/Jitendra_Kumar_Dohare,,3,0,3,6e-06,31
etawah.nic.in/,,3,0,3,6e-06,31
en.wikipedia.org/w/index.php?title=Confluence_0geography)&action=edit&redlink=1,,1,0,1,6e-06,31
en.wikipedia.org/wiki/Tomaras_of_Gwalior,,1,0,1,6e-06,31
en.wikipedia.org/w/index.php?title=Etawah&action=edit&section=1,,1,0,1,6e-06,31
en.wikipedia.org/w/index.php?title=Etawah&action=edit&section=2,,1,0,1,6e-06,31
en.wikipedia.org/w/index.php?title=Etawah&action=edit&section=3,,1,0,1,6e-06,31
en.wikipedia.org/w/index.php?title=Etawah&action=edit&section=4,,1,0,1,6e-06,31
en.wikipedia.org/wiki/File:Ettaia-ettawa.ruins.1830s-1850s.jpg,,1,0,1,6e-06,31
en.wikipedia.org/w/index.php?title=Etawah&action=edit&section=5,,1,0,1,6e-06,31
en.wikipedia.org/wiki/Jaichandra,,1,0,1,6e-06,31
en.wikipedia.org/wiki/Battle_of_Chandawar,,1,0,1,6e-06,31
en.wikipedia.org/wiki/Muhammad_of_Ghor,,1,0,1,6e-06,31
en.wikipedia.org/wiki/Chandelas_of_Jejakabhukti,,1,0,1,6e-06,31
en.wikipedia.org/wiki/Chahamanas_of_Shakambari,,1,0,1,6e-06,31
en.wikipedia.org/wiki/Nasir_ud_din_Muhammad_Shah_III,,1,0,1,6e-06,31
en.wikipedia.org/wiki/Bahlul_Lodi,,1,0,1,6e-06,31
en.wikipedia.org/wiki/Ibrahim_Lodi,,1,0,1,6e-06,31
en.wikipedia.org/wiki/Humayun,,2,0,2,6e-06,31
en.wikipedia.org/wiki/Maham_Anga,,1,0,1,6e-06,31
en.wikipedia.org/wiki/Kingdom_of_Rohilkhand,,1,0,1,6e-06,31
en.wikipedia.org/w/index.php?title=Etawah&action=edit&section=6,,1,0,1,6e-06,31
en.wikipedia.org/w/index.php?title=Etawah&action=edit&section=7,,1,0,1,6e-06,31
en.wikipedia.org/w/index.php?title=Etawah&action=edit&section=8,,1,0,1,6e-06,31
en.wikipedia.org/w/index.php?title=Etawah&action=edit&section=9,,1,0,1,6e-06,31
en.wikipedia.org/wiki/Special:EditPage/Etawah,,1,0,1,6e-06,31
en.wikipedia.org/w/index.php?title=Etawah&action=edit&section=10,,1,0,1,6e-06,31
en.wikipedia.org/w/index.php?title=Etawah&action=edit&section=11,,1,0,1,6e-06,31
en.wikipedia.org/w/index.php?title=Etawah&action=edit&section=12,,1,0,1,6e-06,31
en.wikipedia.org/w/index.php?title=Etawah&action=edit&section=13,,1,0,1,6e-06,31
en.wikipedia.org/w/index.php?title=Etawah&action=edit&section=14,,1,0,1,6e-06,31
en.wikipedia.org/wiki/Saifai_Airport,,1,0,1,6e-06,31
en.wikipedia.org/w/index.php?title=Etawah&action=edit&section=15,,1,0,1,6e-06,31
en.wikipedia.org/wiki/File:Itawah_Jn_Railway_Station.jpg,,2,0,2,6e-06,31
en.wikipedia.org/wiki/Kasganj,,2,0,2,6e-06,31
en.wikipedia.org/wiki/File:Etawah_Jn.jpg,,2,0,2,6e-06,31
en.wikipedia.org/wiki/Bindki,,2,0,2,6e-06,31
en.wikipedia.org/wiki/Kanpur_New_Delhi_Shatabdi_Express,,1,0,1,6e-06,31
en.wikipedia.org/w/index.php?title=Etawah&action=edit&section=16,,1,0,1,6e-06,31
en.wikipedia.org/wiki/Agra_Lucknow_Expressway,,4,0,4,7e-06,31
en.wikipedia.org/w/index.php?title=Etawah&action=edit&section=17,,1,0,1,6e-06,31
en.wikipedia.org/w/index.php?title=Etawah&action=edit&section=18,,1,0,1,6e-06,31
en.wikipedia.org/wiki/File:CAET_Main_Building.jpg,,2,0,2,6e-06,31
"en.wikipedia.org/wiki/College_of_Fisheries_Science_and_Research_Centre,_Etawah",,1,0,1,6e-06,31
"en.wikipedia.org/wiki/Government_Girls_Post_Graduate_College,_Etawah",,2,0,2,6e-06,31
en.wikipedia.org/w/index.php?title=Etawah&action=edit&section=19,,1,0,1,6e-06,31
en.wikipedia.org/w/index.php?title=Etawah&action=edit&section=20,,1,0,1,6e-06,31
en.wikipedia.org/wiki/File:Etawah_Safari_Park.jpg,,2,0,2,6e-06,31
en.wikipedia.org/w/index.php?title=Etawah&action=edit&section=21,,1,0,1,6e-06,31
en.wikipedia.org/w/index.php?title=Etawah&action=edit&section=22,,1,0,1,6e-06,31
en.wikipedia.org/wiki/Sarus_Crane,,2,0,2,6e-06,31
en.wikipedia.org/w/index.php?title=Etawah&action=edit&section=23,,1,0,1,6e-06,31
en.wikipedia.org/wiki/File:Sarsai_City_Cycle_Highway.jpg,,1,0,1,6e-06,31
en.wikipedia.org/wiki/Agra-Etawah_Cycle_Highway,,1,0,1,6e-06,31
en.wikipedia.org/w/index.php?title=Etawah&action=edit&section=24,,1,0,1,6e-06,31
en.wikipedia.org/w/index.php?title=Etawah&action=edit&section=25,,1,0,1,6e-06,31
en.wikipedia.org/wiki/File:Kali_Vahan_Shakti_peeth.jpg,,1,0,1,6e-06,31
en.wikipedia.org/wiki/File:Tixcy_Temple.jpg,,1,0,1,6e-06,31
en.wikipedia.org/wiki/Hajari_Mahadev_Temple,,2,0,2,6e-06,31
en.wikipedia.org/wiki/Pachnada,,2,0,2,6e-06,31
en.wikipedia.org/w/index.php?title=Bharehshwar_Mahadev_Mandir&action=edit&redlink=1,,1,0,1,6e-06,31
en.wikipedia.org/w/index.php?title=Brahmani_Devi&action=edit&redlink=1,,1,0,1,6e-06,31
en.wikipedia.org/w/index.php?title=Jain_Mandir_Kunaira&action=edit&redlink=1,,1,0,1,6e-06,31
en.wikipedia.org/w/index.php?title=Kali_Vahan_Mandir&action=edit&redlink=1,,1,0,1,6e-06,31
en.wikipedia.org/w/index.php?title=Kundeshwar_Mahadev_Temple&action=edit&redlink=1,,1,0,1,6e-06,31
en.wikipedia.org/w/index.php?title=Maa_Kalika_Devi_Mandir&action=edit&redlink=1,,1,0,1,6e-06,31
en.wikipedia.org/w/index.php?title=Nasia_Ji_Digambar_Jain_Temple&action=edit&redlink=1,,1,0,1,6e-06,31
en.wikipedia.org/w/index.php?title=Neel_Kanth_Mahadev_Mandir&action=edit&redlink=1,,1,0,1,6e-06,31
en.wikipedia.org/w/index.php?title=Pili_Kothi&action=edit&redlink=1,,1,0,1,6e-06,31
en.wikipedia.org/w/index.php?title=Pilua_Mahavir&action=edit&redlink=1,,1,0,1,6e-06,31
en.wikipedia.org/w/index.php?title=Sai_Mandir&action=edit&redlink=1,,1,0,1,6e-06,31
en.wikipedia.org/wiki/Shahi_Jama_Masjid,,1,0,1,6e-06,31
"en.wikipedia.org/w/index.php?title=Tixi_Temple,_Etawah&action=edit&redlink=1",,1,0,1,6e-06,31
"en.wikipedia.org/w/index.php?title=St._Xaviers_School,_Chakarnagar&action=edit&redlink=1",,1,0,1,6e-06,31
en.wikipedia.org/w/index.php?title=Baba_Siddh_mandir_sahson_hanumantpur&action=edit&redlink=1,,1,0,1,6e-06,31
en.wikipedia.org/w/index.php?title=Etawah&action=edit&section=26,,1,0,1,6e-06,31
en.wikipedia.org/wiki/Mohsin-ul-Mulk,,1,0,1,6e-06,31
en.wikipedia.org/wiki/Kaptan_Singh,,1,0,1,6e-06,31
en.wikipedia.org/w/index.php?title=Etawah&action=edit&section=27,,1,0,1,6e-06,31
census2011.co.in/census/city/130-etawah.html,,1,0,1,6e-06,31
web.archive.org/web/20170210025054/http://www.census2011.co.in/census/city/130-etawah.html,,1,0,1,6e-06,31
web.archive.org/web/20210422021526/http://nppetawah.in/,,1,0,1,6e-06,31
nppetawah.in/,,1,0,1,6e-06,31
indiastatpublications.com/District_Factbook/Uttar_Pradesh/Etawah,,1,0,1,6e-06,31
cdn.s3waas.gov.in/s374db120f0a8e5646ef5a30154e9f6deb/uploads/2018/08/2018083193.pdf,,1,0,1,6e-06,31
etawah.nic.in/history/,,1,0,1,6e-06,31
jstor.org/stable/44158633,,1,0,1,6e-06,31
web.archive.org/web/20210306073007/http://nppetawah.in/en/page/history-of-etawah-city,,1,0,1,6e-06,31
nppetawah.in/en/page/history-of-etawah-city,,1,0,1,6e-06,31
en.wikipedia.org/w/index.php?title=Etawah&action=edit&section=28,,1,0,1,6e-06,31
web.archive.org/web/20121201033126/http://www.etawahcity.com/,,1,0,1,6e-06,31
mapmyindia.com/embed_preview.jsp?x=-1213736&y=5979557&z=5&width=800&height=800,,1,0,1,6e-06,31
en.wikipedia.org/wiki/Template_talk:Etawah_district,,6,0,6,7e-06,31
en.wikipedia.org/wiki/Special:EditPage/Template:Etawah_district,,6,0,6,7e-06,31
en.wikipedia.org/wiki/Bakewar,,6,0,6,7e-06,31
en.wikipedia.org/wiki/Bharthana,,7,0,7,7e-06,31
en.wikipedia.org/wiki/Ekdil,,6,0,6,7e-06,31
en.wikipedia.org/wiki/Lakhna,,6,0,6,7e-06,31
wikidata.org/wiki/Q878237,,1,0,1,6e-06,31
d-nb.info/gnd/4814459-9,,1,0,1,6e-06,31
aleph.nkp.cz/F/?func=find-c&local_base=aut&ccl_term=ica=ge1035425&CON_LNG=ENG,,1,0,1,6e-06,31
lux.collections.yale.edu/view/place/a4e7c171-0abc-4fe3-a3f1-61b1b06f1bd7,,1,0,1,6e-06,31
en.wikipedia.org/wiki/Category:Tourism_in_Uttar_Pradesh,,1,0,1,6e-06,31
en.wikipedia.org/wiki/Category:Articles_needing_additional_references_from_September_2024,,2,0,2,6e-06,31
en.wikipedia.org/wiki/Category:Articles_needing_cleanup_from_September_2024,,1,0,1,6e-06,31
en.wikipedia.org/wiki/Category:Wikipedia_list_cleanup_from_September_2024,,1,0,1,6e-06,31
en.wikipedia.org/wiki/Category:Articles_needing_cleanup_from_July_2021,,1,0,1,6e-06,31
en.m.wikipedia.org/w/index.php?title=Etawah&mobileaction=toggle_view_mobile,,1,0,1,6e-06,31
upload.wikimedia.org/wikipedia/commons/thumb/1/1f/BSicon_LSTR.svg/20px-BSicon_LSTR.svg.png,,2,0,2,6e-06,31
upload.wikimedia.org/wikipedia/commons/thumb/4/42/BSicon_KXBHFa-L.svg/20px-BSicon_KXBHFa-L.svg.png,,1,0,1,6e-06,31
upload.wikimedia.org/wikipedia/commons/thumb/c/cc/BSicon_XBHF-R.svg/20px-BSicon_XBHF-R.svg.png,,1,0,1,6e-06,31
upload.wikimedia.org/wikipedia/commons/thumb/3/3c/BSicon_STR.svg/20px-BSicon_STR.svg.png,,2,0,2,6e-06,31
upload.wikimedia.org/wikipedia/commons/thumb/d/d0/BSicon_HST.svg/20px-BSicon_HST.svg.png,,3,0,3,7e-06,31
upload.wikimedia.org/wikipedia/commons/thumb/d/de/BSicon_KBHFe.svg/20px-BSicon_KBHFe.svg.png,,2,0,2,6e-06,31
upload.wikimedia.org/wikipedia/commons/thumb/b/be/Etawah_Jn.jpg/250px-Etawah_Jn.jpg,,1,0,1,6e-06,31
upload.wikimedia.org/wikipedia/commons/thumb/9/91/Tixcy_Temple.jpg/250px-Tixcy_Temple.jpg,,1,0,1,6e-06,31
en.wikipedia.org/w/index.php?title=Special:CreateAccount&returnto=Etawah+Junction+railway+station,,1,0,1,6e-06,31
en.wikipedia.org/w/index.php?title=Special:UserLogin&returnto=Etawah+Junction+railway+station,,1,0,1,6e-06,31
bn.wikipedia.org/wiki/ইটাওয়া_জংশন_রেলওয়ে_স্টেশন,,1,0,1,6e-06,31
pa.wikipedia.org/wiki/ਇਟਾਵਾ_ਜੰਕਸ਼ਨ_ਰੇਲਵੇ_ਸਟੇਸ਼ਨ,,1,0,1,6e-06,31
sat.wikipedia.org/wiki/ᱤᱴᱟᱣᱟ_ᱡᱚᱸᱠᱥᱚᱱ_ᱨᱮᱞᱣᱮ_ᱥᱴᱮᱥᱚᱱ,,1,0,1,6e-06,31
ur.wikipedia.org/wiki/اٹاوہ_جنکشن_ریلوے_اسٹیشن,,1,0,1,6e-06,31
wikidata.org/wiki/Special:EntityPage/Q15217008,,1,0,1,6e-06,31
en.wikipedia.org/wiki/Talk:Etawah_Junction_railway_station,,1,0,1,6e-06,31
en.wikipedia.org/w/index.php?title=Etawah_Junction_railway_station&action=edit,,1,0,1,6e-06,31
en.wikipedia.org/w/index.php?title=Etawah_Junction_railway_station&action=history,,1,0,1,6e-06,31
en.wikipedia.org/wiki/Special:WhatLinksHere/Etawah_Junction_railway_station,,1,0,1,6e-06,31
en.wikipedia.org/wiki/Special:RecentChangesLinked/Etawah_Junction_railway_station,,1,0,1,6e-06,31
en.wikipedia.org/w/index.php?title=Etawah_Junction_railway_station&oldid=1303118135,,1,0,1,6e-06,31
en.wikipedia.org/w/index.php?title=Etawah_Junction_railway_station&action=info,,1,0,1,6e-06,31
en.wikipedia.org/w/index.php?title=Etawah_Junction_railway_station&printable=yes,,1,0,1,6e-06,31
commons.wikimedia.org/wiki/Category:Etawah_Junction_railway_station,,1,0,1,6e-06,31
en.wikipedia.org/w/index.php?title=Etawah–Indore_section&action=edit&redlink=1,,1,0,1,6e-06,31
en.wikipedia.org/wiki/Mainpuri–Etawah_line,,1,0,1,6e-06,31
en.wikipedia.org/w/index.php?title=Etawah_Junction_railway_station&action=edit&section=1,,1,0,1,6e-06,31
en.wikipedia.org/wiki/East_Indian_Railway_Company,,6,0,6,7e-06,31
en.wikipedia.org/wiki/Old_Naini_Bridge,,2,0,2,6e-06,31
en.wikipedia.org/w/index.php?title=Etawah_Junction_railway_station&action=edit&section=2,,1,0,1,6e-06,31
en.wikipedia.org/w/index.php?title=Etawah_Junction_railway_station&action=edit&section=3,,1,0,1,6e-06,31
irfca.org/faq/faq-hist.html,,1,0,1,6e-06,31
"ncr.indianrailways.gov.in/view_section.jsp?lang=0&id=0,1,396,403,500",,1,0,1,6e-06,31
irfca.org/docs/electrification-history.html,,2,0,2,6e-06,31
en.wikipedia.org/w/index.php?title=Etawah_Junction_railway_station&action=edit&section=4,,1,0,1,6e-06,31
indiarailinfo.com/arrivals/etawah-etw/707,,1,0,1,6e-06,31
en.wikipedia.org/w/index.php?title=Ekdil_railway_station&action=edit&redlink=1,,1,0,1,6e-06,31
en.wikipedia.org/wiki/Category:Railway_stations_in_India_opened_in_1866,,1,0,1,6e-06,31
en.wikipedia.org/wiki/Category:Railway_junction_stations_in_Uttar_Pradesh,,1,0,1,6e-06,31
en.wikipedia.org/wiki/Category:Railway_stations_in_Etawah_district,,1,0,1,6e-06,31
en.wikipedia.org/wiki/Category:Transport_in_Etawah,,1,0,1,6e-06,31
en.m.wikipedia.org/w/index.php?title=Etawah_Junction_railway_station&mobileaction=toggle_view_mobile,,1,0,1,6e-06,31
upload.wikimedia.org/wikipedia/commons/thumb/b/be/Etawah_Jn.jpg/500px-Etawah_Jn.jpg,,1,0,1,6e-06,31
en.wikipedia.org/w/index.php?title=Special:CreateAccount&returnto=Etawah+district,,1,0,1,6e-06,31
en.wikipedia.org/w/index.php?title=Special:UserLogin&returnto=Etawah+district,,1,0,1,6e-06,31
ar.wikipedia.org/wiki/منطقة_ايتواه,,1,0,1,6e-06,31
bn.wikipedia.org/wiki/ইটাওয়া_জেলা,,1,0,1,6e-06,31
zh-min-nan.wikipedia.org/wiki/Etawah_(koān),,1,0,1,6e-06,31
bh.wikipedia.org/wiki/इटावा_जिला,,1,0,1,6e-06,31
ca.wikipedia.org/wiki/Districte_d%27Etawah,,1,0,1,6e-06,31
ceb.wikipedia.org/wiki/Etāwah_(distrito),,1,0,1,6e-06,31
da.wikipedia.org/wiki/Etawah_(distrikt),,1,0,1,6e-06,31
de.wikipedia.org/wiki/Etawah_(Distrikt),,1,0,1,6e-06,31
es.wikipedia.org/wiki/Distrito_de_Etawah,,1,0,1,6e-06,31
eu.wikipedia.org/wiki/Etawah_barrutia,,1,0,1,6e-06,31
fa.wikipedia.org/wiki/بخش_اتاوا,,1,0,1,6e-06,31
fr.wikipedia.org/wiki/District_d%27Etawah,,1,0,1,6e-06,31
gu.wikipedia.org/wiki/ઇટાવા_જિલ્લો,,1,0,1,6e-06,31
hi.wikipedia.org/wiki/इटावा_जिला,,1,0,1,6e-06,31
it.wikipedia.org/wiki/Distretto_di_Etawah,,1,0,1,6e-06,31
mr.wikipedia.org/wiki/इटावा_जिल्हा,,1,0,1,6e-06,31
arz.wikipedia.org/wiki/ايتواه,,1,0,1,6e-06,31
nl.wikipedia.org/wiki/Etawah_(district),,1,0,1,6e-06,31
ne.wikipedia.org/wiki/इटावा_जिल्ला,,1,0,1,6e-06,31
new.wikipedia.org/wiki/इटावा_जिल्ला,,1,0,1,6e-06,31
no.wikipedia.org/wiki/Etawah_(distrikt),,1,0,1,6e-06,31
pnb.wikipedia.org/wiki/ضلع_اٹاوہ,,1,0,1,6e-06,31
ru.wikipedia.org/wiki/Этавах_(округ),,1,0,1,6e-06,31
sa.wikipedia.org/wiki/इटावामण्डलम्,,1,0,1,6e-06,31
sat.wikipedia.org/wiki/ᱤᱴᱟᱣᱟ_ᱦᱚᱱᱚᱛ,,1,0,1,6e-06,31
sco.wikipedia.org/wiki/Etawah_destrict,,1,0,1,6e-06,31
simple.wikipedia.org/wiki/Etawah_district,,1,0,1,6e-06,31
sv.wikipedia.org/wiki/Etawah_(distrikt),,1,0,1,6e-06,31
ta.wikipedia.org/wiki/இட்டாவா_மாவட்டம்,,1,0,1,6e-06,31
te.wikipedia.org/wiki/ఎటావా_జిల్లా,,1,0,1,6e-06,31
ur.wikipedia.org/wiki/ضلع_اٹاوہ,,1,0,1,6e-06,31
vi.wikipedia.org/wiki/Etawah_(huyện),,1,0,1,6e-06,31
zh.wikipedia.org/wiki/埃塔瓦縣,,1,0,1,6e-06,31
wikidata.org/wiki/Special:EntityPage/Q1815288,,1,0,1,6e-06,31
en.wikipedia.org/wiki/Talk:Etawah_district,,1,0,1,6e-06,31
en.wikipedia.org/w/index.php?title=Etawah_district&action=edit,,1,0,1,6e-06,31
en.wikipedia.org/w/index.php?title=Etawah_district&action=history,,1,0,1,6e-06,31
en.wikipedia.org/wiki/Special:WhatLinksHere/Etawah_district,,1,0,1,6e-06,31
en.wikipedia.org/wiki/Special:RecentChangesLinked/Etawah_district,,1,0,1,6e-06,31
en.wikipedia.org/w/index.php?title=Etawah_district&oldid=1303794658,,1,0,1,6e-06,31
en.wikipedia.org/w/index.php?title=Etawah_district&action=info,,1,0,1,6e-06,31
en.wikipedia.org/w/index.php?title=Etawah_district&printable=yes,,1,0,1,6e-06,31
commons.wikimedia.org/wiki/Category:Etawah_district,,1,0,1,6e-06,31
en.wikipedia.org/wiki/File:Ravines_in_Etawah.jpg,,1,0,1,6e-06,31
en.wikipedia.org/wiki/File:India_Uttar_Pradesh_districts_2012_Etawah.svg,,1,0,1,6e-06,31
en.wikipedia.org/wiki/State_Highway_83_(Uttar_Pradesh),,2,0,2,6e-06,31
en.wikipedia.org/w/index.php?title=Etawah_district&action=edit&section=1,,1,0,1,6e-06,31
en.wikipedia.org/w/index.php?title=Etawah_district&action=edit&section=2,,1,0,1,6e-06,31
en.wikipedia.org/wiki/Sub_Divisional_Magistrate,,1,0,1,6e-06,31
en.wikipedia.org/wiki/Community_development_block,,2,0,2,6e-06,31
en.wikipedia.org/w/index.php?title=Etawah_district&action=edit&section=3,,1,0,1,6e-06,31
en.wikipedia.org/w/index.php?title=Etawah_district&action=edit&section=4,,1,0,1,6e-06,31
en.wikipedia.org/w/index.php?title=Etawah_district&action=edit&section=5,,1,0,1,6e-06,31
en.wikipedia.org/wiki/Category:Universities_and_colleges_in_Etawah_district,,1,0,1,6e-06,31
en.wikipedia.org/w/index.php?title=Etawah_district&action=edit&section=6,,1,0,1,6e-06,31
en.wikipedia.org/wiki/Baba_Saheb_Dr._B.R.A._College_of_Agriculture_Engineering_%26_Technology,,1,0,1,6e-06,31
en.wikipedia.org/wiki/College_of_Dairy_Technology_(Etawah),,1,0,1,6e-06,31
en.wikipedia.org/wiki/College_of_Fisheries_Science_and_Research_Centre,,1,0,1,6e-06,31
en.wikipedia.org/wiki/U.P._Rural_Institute_of_Medical_Sciences_and_Research,,2,0,2,6e-06,31
en.wikipedia.org/wiki/Medical_research,,3,0,3,6e-06,31
en.wikipedia.org/wiki/Medical_College,,3,0,3,7e-06,31
en.wikipedia.org/wiki/Burn_centre,,3,0,3,6e-06,31
en.wikipedia.org/w/index.php?title=Etawah_district&action=edit&section=7,,1,0,1,6e-06,31
"en.wikipedia.org/wiki/Janta_College_Bakewar,_Etawah",,1,0,1,6e-06,31
"en.wikipedia.org/wiki/K.K._P.G._College,_Etawah",,1,0,1,6e-06,31
"en.wikipedia.org/wiki/Major_Dhyan_Chand_Sports_College,_Saifai",,1,0,1,6e-06,31
en.wikipedia.org/wiki/Sport_of_athletics,,4,0,4,6e-06,31
en.wikipedia.org/wiki/Pharmacy_College_Saifai,,6,0,6,7e-06,31
en.wikipedia.org/wiki/UPTU,,3,0,3,7e-06,31
"en.wikipedia.org/wiki/S.S._Memorial_Educational_Academy,_Saifai",,2,0,2,6e-06,31
"en.wikipedia.org/wiki/S.S._Memorial_Senior_Secondary_Public_School,_Saifai",,1,0,1,6e-06,31
en.wikipedia.org/w/index.php?title=Etawah_district&action=edit&section=8,,1,0,1,6e-06,31
en.wikipedia.org/wiki/File:Rathore_Park.jpg,,1,0,1,6e-06,31
en.wikipedia.org/w/index.php?title=Kundeshwar_Mahdev_Mandir&action=edit&redlink=1,,1,0,1,6e-06,31
en.wikipedia.org/w/index.php?title=Maa_Kalka_Devi&action=edit&redlink=1,,1,0,1,6e-06,31
en.wikipedia.org/w/index.php?title=Kalibaah_mandir&action=edit&redlink=1,,1,0,1,6e-06,31
en.wikipedia.org/w/index.php?title=Tixi_temple&action=edit&redlink=1,,1,0,1,6e-06,31
en.wikipedia.org/w/index.php?title=Etawah_district&action=edit&section=9,,1,0,1,6e-06,31
en.wikipedia.org/w/index.php?title=Etawah_district&action=edit&section=10,,1,0,1,6e-06,31
en.wikipedia.org/wiki/Wildlife_sanctuaries_in_Uttar_Pradesh,,1,0,1,6e-06,31
en.wikipedia.org/w/index.php?title=Etawah_district&action=edit&section=11,,1,0,1,6e-06,31
en.wikipedia.org/wiki/17th_Legislative_Assembly_of_Uttar_Pradesh,,1,0,1,6e-06,31
en.wikipedia.org/w/index.php?title=Etawah_district&action=edit&section=12,,1,0,1,6e-06,31
en.wikipedia.org/w/index.php?title=Etawah_district&action=edit&section=13,,1,0,1,6e-06,31
censusindia.gov.in/nada/index.php/catalog/1202/download/3822/DH_2011_0930_PART_A_DCHB_ETAWAH.pdf,,1,0,1,6e-06,31
etawah.nic.in/administrative-setup/,,1,0,1,6e-06,31
amarujala.com/uttar-pradesh/etawah/rims-becomes-ayurvigyan-university,,3,0,3,6e-06,31
ccspg.org/,,2,0,2,6e-06,31
upums.ac.in/StaticPages/CollegeofPharmacy.aspx,,3,0,3,6e-06,31
ssmssps.com/,,1,0,1,6e-06,31
en.wikipedia.org/w/index.php?title=Etawah_district&action=edit&section=14,,1,0,1,6e-06,31
en.wikipedia.org/wiki/Dhaulpur_district,,1,0,1,6e-06,31
en.wikipedia.org/wiki/Lakhimpur_Kheri_District,,2,0,2,6e-06,31
wikidata.org/wiki/Q1815288,,1,0,1,6e-06,31
viaf.org/viaf/149281266,,1,0,1,6e-06,31
d-nb.info/gnd/4814460-5,,1,0,1,6e-06,31
id.loc.gov/authorities/no2005017034,,1,0,1,6e-06,31
nli.org.il/en/authorities/987007482413905171,,1,0,1,6e-06,31
en.wikipedia.org/wiki/Category:Articles_with_unsourced_statements_from_December_2018,,1,0,1,6e-06,31
en.wikipedia.org/wiki/Category:Articles_needing_cleanup_from_May_2024,,1,0,1,6e-06,31
en.wikipedia.org/wiki/Category:Wikipedia_list_cleanup_from_May_2024,,1,0,1,6e-06,31
en.m.wikipedia.org/w/index.php?title=Etawah_district&mobileaction=toggle_view_mobile,,1,0,1,6e-06,31
upload.wikimedia.org/wikipedia/commons/thumb/b/b2/Ravines_in_Etawah.jpg/250px-Ravines_in_Etawah.jpg,,1,0,1,6e-06,31
upload.wikimedia.org/wikipedia/commons/thumb/7/7a/Rathore_Park.jpg/250px-Rathore_Park.jpg,,1,0,1,6e-06,31
en.wikipedia.org/w/index.php?title=Special:CreateAccount&returnto=Etawah+Safari+Park,,1,0,1,6e-06,31
en.wikipedia.org/w/index.php?title=Special:UserLogin&returnto=Etawah+Safari+Park,,1,0,1,6e-06,31
hi.wikipedia.org/wiki/इटावा_सफारी_पार्क,,1,0,1,6e-06,31
ta.wikipedia.org/wiki/இட்டாவா_வனவிலங்குப்_பூங்கா,,1,0,1,6e-06,31
wikidata.org/wiki/Special:EntityPage/Q93969065,,1,0,1,6e-06,31
en.wikipedia.org/wiki/Talk:Etawah_Safari_Park,,1,0,1,6e-06,31
en.wikipedia.org/w/index.php?title=Etawah_Safari_Park&action=edit,,1,0,1,6e-06,31
en.wikipedia.org/w/index.php?title=Etawah_Safari_Park&action=history,,1,0,1,6e-06,31
en.wikipedia.org/wiki/Special:WhatLinksHere/Etawah_Safari_Park,,1,0,1,6e-06,31
en.wikipedia.org/wiki/Special:RecentChangesLinked/Etawah_Safari_Park,,1,0,1,6e-06,31
en.wikipedia.org/w/index.php?title=Etawah_Safari_Park&oldid=1263370573,,1,0,1,6e-06,31
en.wikipedia.org/w/index.php?title=Etawah_Safari_Park&action=info,,1,0,1,6e-06,31
en.wikipedia.org/w/index.php?title=Etawah_Safari_Park&printable=yes,,1,0,1,6e-06,31
etawahlionsafari.org/,,1,0,1,6e-06,31
en.wikipedia.org/wiki/Safari_park,,1,0,1,6e-06,31
en.wikipedia.org/wiki/Asiatic_lion,,1,0,1,6e-06,31
en.wikipedia.org/w/index.php?title=Etawah_Safari_Park&action=edit&section=1,,1,0,1,6e-06,31
en.wikipedia.org/wiki/Category:All_self-contradictory_articles,,1,0,1,6e-06,31
en.wikipedia.org/w/index.php?title=Etawah_Safari_Park&action=edit&section=2,,1,0,1,6e-06,31
en.wikipedia.org/wiki/Bear,,1,0,1,6e-06,31
en.wikipedia.org/w/index.php?title=Etawah_Safari_Park&action=edit&section=3,,1,0,1,6e-06,31
en.wikipedia.org/wiki/Canine_distemper,,1,0,1,6e-06,31
en.wikipedia.org/w/index.php?title=Etawah_Safari_Park&action=edit&section=4,,1,0,1,6e-06,31
"en.wikipedia.org/wiki/File:Visitor_Facilitation_Centre,_Etawah_Safari_Park.jpg",,1,0,1,6e-06,31
en.wikipedia.org/wiki/4D_film,,1,0,1,6e-06,31
en.wikipedia.org/w/index.php?title=Etawah_Safari_Park&action=edit&section=5,,1,0,1,6e-06,31
en.wikipedia.org/w/index.php?title=Etawah_Safari_Park&action=edit&section=6,,1,0,1,6e-06,31
en.wikipedia.org/wiki/Gir_National_Park,,1,0,1,6e-06,31
en.wikipedia.org/wiki/Asiatic_Lion_Reintroduction_Project,,1,0,1,6e-06,31
en.wikipedia.org/wiki/Etawah_gharana,,1,0,1,6e-06,31
en.wikipedia.org/w/index.php?title=Etawah_Safari_Park&action=edit&section=7,,1,0,1,6e-06,31
cza.nic.in/uploads/documents/zoos/information/english/498.pdf,,1,0,1,6e-06,31
cza.nic.in/uploads/documents/reports/english/Annual%20report.etwah%20lion%20safari%201718pdf.pdf,,1,0,1,6e-06,31
arturba.com/portfolio_page/lion-safari-etawah/,,1,0,1,6e-06,31
indianexpress.com/article/india/india-news-india/akhilesh-yadav-etawah-lion-safari-two-cubs3069477/,,1,0,1,6e-06,31
12go.asia/en/post/5630/etawah-safari-park-will-be-opened-in-october,,1,0,1,6e-06,31
m.jagran.com/uttar-pradesh/etawah-civic-18028257.html,,1,0,1,6e-06,31
web.archive.org/web/20180629130751/https://m.jagran.com/uttar-pradesh/etawah-civic-18028257.html,,1,0,1,6e-06,31
m.jagran.com/uttar-pradesh/etawah-etawah-safari-chr39-s-green-flag-for-governance-16882836.html,,1,0,1,6e-06,31
cza.nic.in/uploads/documents/reports/english/AR_etwahzoo_2223.pdf,,1,0,1,6e-06,31
cza.nic.in/uploads/documents/reports/english/AR_etwahasafaripark_2324.pdf,,1,0,1,6e-06,31
en.wikipedia.org/w/index.php?title=Etawah_Safari_Park&action=edit&section=8,,1,0,1,6e-06,31
en.wikipedia.org/wiki/Template:Tourist_attractions_in_Agra,,3,0,3,7e-06,31
en.wikipedia.org/wiki/Template_talk:Tourist_attractions_in_Agra,,1,0,1,6e-06,31
en.wikipedia.org/wiki/Special:EditPage/Template:Tourist_attractions_in_Agra,,1,0,1,6e-06,31
en.wikipedia.org/wiki/Chini_Ka_Rauza,,3,0,3,7e-06,31
en.wikipedia.org/wiki/Gyarah_Sidi,,1,0,1,6e-06,31
en.wikipedia.org/wiki/Tomb_of_I%27timād-ud-Daulah,,3,0,3,7e-06,31
en.wikipedia.org/wiki/Tomb_of_Mariam-uz-Zamani,,2,0,2,7e-06,31
en.wikipedia.org/wiki/Akbar%27s_tomb,,1,0,1,6e-06,31
"en.wikipedia.org/wiki/Jama_Mosque,_Agra",,1,0,1,6e-06,31
en.wikipedia.org/wiki/Mina_Mosque,,1,0,1,6e-06,31
en.wikipedia.org/wiki/Moti_Masjid_(Agra_Fort),,1,0,1,6e-06,31
en.wikipedia.org/wiki/Nagina_Masjid,,1,0,1,6e-06,31
en.wikipedia.org/wiki/Humayun_Mosque,,1,0,1,6e-06,31
"en.wikipedia.org/wiki/Bateshwar,_Uttar_Pradesh",,1,0,1,6e-06,31
en.wikipedia.org/wiki/Guru_ka_Tal,,1,0,1,6e-06,31
en.wikipedia.org/wiki/Swamibagh,,1,0,1,6e-06,31
en.wikipedia.org/w/index.php?title=Kinari_Bazaar&action=edit&redlink=1,,1,0,1,6e-06,31
en.wikipedia.org/wiki/Loha_Mandi,,1,0,1,6e-06,31
en.wikipedia.org/wiki/Raja_ki_mandi,,1,0,1,6e-06,31
"en.wikipedia.org/wiki/Sadar_Bazaar,_Agra",,1,0,1,6e-06,31
en.wikipedia.org/wiki/Sanjay_Place,,1,0,1,6e-06,31
"en.wikipedia.org/wiki/Aram_Bagh,_Agra",,1,0,1,6e-06,31
en.wikipedia.org/wiki/Mehtab_Bagh,,3,0,3,7e-06,31
en.wikipedia.org/wiki/Paliwal_Park,,3,0,3,7e-06,31
en.wikipedia.org/wiki/Ram_Barat,,1,0,1,6e-06,31
en.wikipedia.org/wiki/Category:Safari_parks,,1,0,1,6e-06,31
en.wikipedia.org/wiki/Category:Protected_areas_of_Uttar_Pradesh,,1,0,1,6e-06,31
en.wikipedia.org/wiki/Category:Tourist_attractions_in_Etawah_district,,2,0,2,7e-06,31
en.wikipedia.org/wiki/Category:Tourist_attractions_in_Uttar_Pradesh,,1,0,1,6e-06,31
en.wikipedia.org/wiki/Category:Zoos_established_in_2019,,1,0,1,6e-06,31
en.wikipedia.org/wiki/Category:Self-contradictory_articles_from_January_2019,,1,0,1,6e-06,31
en.wikipedia.org/wiki/Category:Articles_containing_potentially_dated_statements_from_November_2019,,1,0,1,6e-06,31
en.wikipedia.org/wiki/Category:Articles_containing_potentially_dated_statements_from_December_2020,,1,0,1,6e-06,31
en.m.wikipedia.org/w/index.php?title=Etawah_Safari_Park&mobileaction=toggle_view_mobile,,1,0,1,6e-06,31
en.wikipedia.org/w/index.php?title=Special:CreateAccount&returnto=Etawah+Lok+Sabha+constituency,,1,0,1,6e-06,31
en.wikipedia.org/w/index.php?title=Special:UserLogin&returnto=Etawah+Lok+Sabha+constituency,,1,0,1,6e-06,31
bn.wikipedia.org/wiki/এটাওয়া_লোকসভা_কেন্দ্র,,1,0,1,6e-06,31
hi.wikipedia.org/wiki/इटावा_लोक_सभा_निर्वाचन_क्षेत्र,,1,0,1,6e-06,31
mr.wikipedia.org/wiki/इटावा_लोकसभा_मतदारसंघ,,1,0,1,6e-06,31
pa.wikipedia.org/wiki/ਇਟਾਵਾ_ਲੋਕ_ਸਭਾ_ਹਲਕਾ,,1,0,1,6e-06,31
ta.wikipedia.org/wiki/இட்டாவா_மக்களவைத்_தொகுதி,,1,0,1,6e-06,31
te.wikipedia.org/wiki/ఇటావా_లోక్‌సభ_నియోజకవర్గం,,1,0,1,6e-06,31
wikidata.org/wiki/Special:EntityPage/Q5402455,,1,0,1,6e-06,31
en.wikipedia.org/wiki/Talk:Etawah_Lok_Sabha_constituency,,1,0,1,6e-06,31
en.wikipedia.org/w/index.php?title=Etawah_Lok_Sabha_constituency&action=edit,,1,0,1,6e-06,31
en.wikipedia.org/w/index.php?title=Etawah_Lok_Sabha_constituency&action=history,,1,0,1,6e-06,31
en.wikipedia.org/wiki/Special:WhatLinksHere/Etawah_Lok_Sabha_constituency,,1,0,1,6e-06,31
en.wikipedia.org/wiki/Special:RecentChangesLinked/Etawah_Lok_Sabha_constituency,,1,0,1,6e-06,31
en.wikipedia.org/w/index.php?title=Etawah_Lok_Sabha_constituency&oldid=1303328168,,1,0,1,6e-06,31
en.wikipedia.org/w/index.php?title=Etawah_Lok_Sabha_constituency&action=info,,1,0,1,6e-06,31
en.wikipedia.org/w/index.php?title=Etawah_Lok_Sabha_constituency&printable=yes,,1,0,1,6e-06,31
geohack.toolforge.org/geohack.php?pagename=Etawah_Lok_Sabha_constituency&params=26.78_N_79.02_E_,,1,0,1,6e-06,31
en.wikipedia.org/w/index.php?title=Etawah_Lok_Sabha_constituency&action=edit&section=1,,1,0,1,6e-06,31
en.wikipedia.org/wiki/Ajit_Singh_Pal,,2,0,2,6e-06,31
en.wikipedia.org/w/index.php?title=Etawah_Lok_Sabha_constituency&action=edit&section=2,,1,0,1,6e-06,31
en.wikipedia.org/wiki/Arjun_Singh_Bhadoria,,1,0,1,6e-06,31
en.wikipedia.org/wiki/Socialist_Party_(India),,3,0,3,6e-06,31
en.wikipedia.org/wiki/Samyukta_Socialist_Party,,1,0,1,6e-06,31
en.wikipedia.org/wiki/Ram_Singh_Shakya,,1,0,1,6e-06,31
en.wikipedia.org/wiki/Janata_Party_(Secular),,4,0,4,7e-06,31
en.wikipedia.org/wiki/Sukhda_Misra,,2,0,2,6e-06,31
en.wikipedia.org/w/index.php?title=Etawah_Lok_Sabha_constituency&action=edit&section=3,,1,0,1,6e-06,31
en.wikipedia.org/w/index.php?title=Etawah_Lok_Sabha_constituency&action=edit&section=4,,1,0,1,6e-06,31
en.wikipedia.org/w/index.php?title=Etawah_Lok_Sabha_constituency&action=edit&section=5,,1,0,1,6e-06,31
en.wikipedia.org/wiki/Pragatisheel_Samajwadi_Party_(Lohiya),,2,0,2,6e-06,31
en.wikipedia.org/w/index.php?title=Etawah_Lok_Sabha_constituency&action=edit&section=6,,1,0,1,6e-06,31
en.wikipedia.org/w/index.php?title=Hans_Mukhi_Kori&action=edit&redlink=1,,1,0,1,6e-06,31
en.wikipedia.org/w/index.php?title=Etawah_Lok_Sabha_constituency&action=edit&section=7,,1,0,1,6e-06,31
en.wikipedia.org/w/index.php?title=Etawah_Lok_Sabha_constituency&action=edit&section=8,,1,0,1,6e-06,31
timesofindia.indiatimes.com/elections/lok-sabha-constituencies/uttar-pradesh/etawah,,1,0,1,6e-06,31
results.eci.gov.in/PcResultGenJune2024/candidateswise-S2441.htm,,1,0,1,6e-06,31
en.m.wikipedia.org/w/index.php?title=Etawah_Lok_Sabha_constituency&mobileaction=toggle_view_mobile,,1,0,1,6e-06,31
en.wikipedia.org/w/index.php?title=Special:CreateAccount&returnto=Farrukhabad,,1,0,1,6e-06,31
en.wikipedia.org/w/index.php?title=Special:UserLogin&returnto=Farrukhabad,,1,0,1,6e-06,31
azb.wikipedia.org/wiki/فرخ‌آباد_(هیندوستان),,1,0,1,6e-06,31
bh.wikipedia.org/wiki/फर्रूखाबाद,,1,0,1,6e-06,31
ceb.wikipedia.org/wiki/Farrukhābād_(lungsod),,1,0,1,6e-06,31
de.wikipedia.org/wiki/Farrukhabad,,1,0,1,6e-06,31
es.wikipedia.org/wiki/Farrujābād,,1,0,1,6e-06,31
eo.wikipedia.org/wiki/Faruĥabad,,1,0,1,6e-06,31
fa.wikipedia.org/wiki/فرخ‌آباد_(هند),,1,0,1,6e-06,31
fr.wikipedia.org/wiki/Farrukhabad,,1,0,1,6e-06,31
hi.wikipedia.org/wiki/फ़र्रूख़ाबाद,,1,0,1,6e-06,31
bpy.wikipedia.org/wiki/ফারুখাবাদ-তিলকরা-ফতেহগড়,,1,0,1,6e-06,31
it.wikipedia.org/wiki/Farrukhabad-cum-Fatehgarh,,1,0,1,6e-06,31
pam.wikipedia.org/wiki/Farrukhabad,,1,0,1,6e-06,31
mr.wikipedia.org/wiki/फरुखाबाद,,1,0,1,6e-06,31
ms.wikipedia.org/wiki/Farrukhabad-cum-Fatehgarh,,1,0,1,6e-06,31
nl.wikipedia.org/wiki/Farrukhabad_(stad),,1,0,1,6e-06,31
ja.wikipedia.org/wiki/ファッルハーバード,,1,0,1,6e-06,31
pa.wikipedia.org/wiki/ਫ਼ਰੂਖ਼ਾਬਾਦ,,1,0,1,6e-06,31
pnb.wikipedia.org/wiki/فرخ_آباد,,1,0,1,6e-06,31
pl.wikipedia.org/wiki/Farrukhabad_(miasto),,1,0,1,6e-06,31
sat.wikipedia.org/wiki/ᱯᱷᱚᱨᱨᱩᱠᱷᱟᱵᱟᱫᱽ,,1,0,1,6e-06,31
sr.wikipedia.org/wiki/Фарукабад,,1,0,1,6e-06,31
sv.wikipedia.org/wiki/Farrukhabad-cum-Fatehgarh,,1,0,1,6e-06,31
ta.wikipedia.org/wiki/பரூக்காபாத்,,1,0,1,6e-06,31
uk.wikipedia.org/wiki/Фаррукхабад,,1,0,1,6e-06,31
ur.wikipedia.org/wiki/فرخ_آباد,,1,0,1,6e-06,31
vi.wikipedia.org/wiki/Farrukhabad-cum-Fatehgarh,,1,0,1,6e-06,31
zh.wikipedia.org/wiki/法鲁卡巴德-丘姆-法泰赫加尔,,1,0,1,6e-06,31
wikidata.org/wiki/Special:EntityPage/Q4549,,1,0,1,6e-06,31
en.wikipedia.org/wiki/Talk:Farrukhabad,,1,0,1,6e-06,31
en.wikipedia.org/w/index.php?title=Farrukhabad&action=edit,,1,0,1,6e-06,31
en.wikipedia.org/w/index.php?title=Farrukhabad&action=history,,1,0,1,6e-06,31
en.wikipedia.org/wiki/Special:WhatLinksHere/Farrukhabad,,1,0,1,6e-06,31
en.wikipedia.org/wiki/Special:RecentChangesLinked/Farrukhabad,,1,0,1,6e-06,31
en.wikipedia.org/w/index.php?title=Farrukhabad&oldid=1301402622,,1,0,1,6e-06,31
en.wikipedia.org/w/index.php?title=Farrukhabad&action=info,,1,0,1,6e-06,31
en.wikipedia.org/w/index.php?title=Farrukhabad&printable=yes,,1,0,1,6e-06,31
commons.wikimedia.org/wiki/Category:Farrukhabad,,1,0,1,6e-06,31
en.wikipedia.org/wiki/Farrokhabad_(disambiguation),,1,0,1,6e-06,31
en.wikipedia.org/wiki/Special:EditPage/Farrukhabad,,1,0,1,6e-06,31
"google.com/search?as_eq=wikipedia&q=""Farrukhabad""",,1,0,1,6e-06,31
"google.com/search?tbm=nws&q=""Farrukhabad""+-wikipedia&tbs=ar:1",,1,0,1,6e-06,31
"google.com/search?&q=""Farrukhabad""&tbs=bkt:s&tbm=bks",,1,0,1,6e-06,31
"google.com/search?tbs=bks:1&q=""Farrukhabad""+-wikipedia",,1,0,1,6e-06,31
"scholar.google.com/scholar?q=""Farrukhabad""",,1,0,1,6e-06,31
"jstor.org/action/doBasicSearch?Query=""Farrukhabad""&acc=on&wc=on",,1,0,1,6e-06,31
en.wikipedia.org/wiki/File:Tomb_of_Mohd._Khan_Bangash_Nawab.jpg,,1,0,1,6e-06,31
en.wikipedia.org/wiki/Farrukhsiyar,,2,0,2,6e-06,31
en.wikipedia.org/wiki/Mukesh_Rajput,,1,0,1,6e-06,31
en.wikipedia.org/wiki/Superintendent_of_police,,1,0,1,6e-06,31
en.wikipedia.org/w/index.php?title=Farrukhabad&action=edit&section=1,,1,0,1,6e-06,31
en.wikipedia.org/wiki/File:Foggy_chauraha.jpg,,1,0,1,6e-06,31
en.wikipedia.org/w/index.php?title=Farrukhabad&action=edit&section=2,,1,0,1,6e-06,31
en.wikipedia.org/w/index.php?title=Farrukhabad&action=edit&section=3,,1,0,1,6e-06,31
en.wikipedia.org/wiki/Zardozi,,2,0,2,6e-06,31
en.wikipedia.org/wiki/Zari,,1,0,1,6e-06,31
en.wikipedia.org/w/index.php?title=Farrukhabad&action=edit&section=4,,1,0,1,6e-06,31
en.wikipedia.org/w/index.php?title=Farrukhabad&action=edit&section=5,,1,0,1,6e-06,31
en.wikipedia.org/wiki/Template:Railways_around_Farrukhabad,,1,0,1,6e-06,31
en.wikipedia.org/wiki/Template_talk:Railways_around_Farrukhabad,,1,0,1,6e-06,31
en.wikipedia.org/wiki/Special:EditPage/Template:Railways_around_Farrukhabad,,1,0,1,6e-06,31
en.wikipedia.org/wiki/Kasganj_railway_station,,1,0,1,6e-06,31
en.wikipedia.org/wiki/Yaqutganj_railway_station,,1,0,1,6e-06,31
en.wikipedia.org/wiki/Kamalganj,,4,0,4,7e-06,31
en.wikipedia.org/wiki/Kaimganj_railway_station,,2,0,2,6e-06,31
en.wikipedia.org/wiki/Kamalganj_railway_station,,1,0,1,6e-06,31
en.wikipedia.org/w/index.php?title=Farrukhabad&action=edit&section=6,,1,0,1,6e-06,31
en.wikipedia.org/w/index.php?title=Farrukhabad&action=edit&section=7,,1,0,1,6e-06,31
"en.wikipedia.org/wiki/Mohammadabad,_Farrukhabad",,4,0,4,7e-06,31
en.wikipedia.org/wiki/Small_aircraft,,1,0,1,6e-06,31
en.wikipedia.org/wiki/Helicopter,,1,0,1,6e-06,31
en.wikipedia.org/w/index.php?title=Farrukhabad&action=edit&section=8,,1,0,1,6e-06,31
en.wikipedia.org/wiki/Devrampur,,1,0,1,6e-06,31
en.wikipedia.org/wiki/Badayun,,1,0,1,6e-06,31
en.wikipedia.org/w/index.php?title=Farrukhabad&action=edit&section=9,,1,0,1,6e-06,31
farrukhabad.nic.in/directory/,,1,0,1,6e-06,31
censusindia.gov.in/pca/SearchDetails.aspx?Id=169122,,1,0,1,6e-06,31
en.wikipedia.org/wiki/Special:BookSources/978-93-90290-05-5,,1,0,1,6e-06,31
books.google.com/books?id=1lhbDwAAQBAJ&dq=Farrukhabad+founded+Nawab+Muhammad+Khan+Bangash&pg=PT23,,1,0,1,6e-06,31
en.wikipedia.org/wiki/Special:BookSources/978-1-64249-882-0,,1,0,1,6e-06,31
books.google.com/books?id=ehrzDwAAQBAJ&dq=Farrukhabad+zardozi+12th+century&pg=PA282,,1,0,1,6e-06,31
en.wikipedia.org/wiki/Special:BookSources/978-93-131-9643-3,,1,0,1,6e-06,31
indiantollways.com/tag/expressway/page/2/,,1,0,1,6e-06,31
en.wikisource.org/wiki/1911_Encyclopædia_Britannica/Farukhabad,,2,0,2,6e-06,31
en.wikipedia.org/wiki/Template_talk:Farrukhabad_district,,4,0,4,7e-06,31
en.wikipedia.org/wiki/Special:EditPage/Template:Farrukhabad_district,,4,0,4,7e-06,31
en.wikipedia.org/wiki/Kampil,,6,0,6,7e-06,31
"en.wikipedia.org/wiki/Shamsabad,_Farrukhabad",,4,0,4,7e-06,31
en.wikipedia.org/wiki/Kasganj_District,,4,0,4,7e-06,31
"en.wikipedia.org/wiki/Lalitpur_District,_India",,4,0,4,7e-06,31
en.wikipedia.org/wiki/Category:Populated_places_established_in_1714,,1,0,1,6e-06,31
en.wikipedia.org/wiki/Category:1714_establishments_in_Asia,,1,0,1,6e-06,31
en.wikipedia.org/wiki/Category:Articles_needing_additional_references_from_February_2017,,3,0,3,6e-06,31
en.m.wikipedia.org/w/index.php?title=Farrukhabad&mobileaction=toggle_view_mobile,,1,0,1,6e-06,31
upload.wikimedia.org/wikipedia/commons/thumb/9/90/Foggy_chauraha.jpg/250px-Foggy_chauraha.jpg,,1,0,1,6e-06,31
upload.wikimedia.org/wikipedia/commons/thumb/a/aa/BSicon_CONTg.svg/20px-BSicon_CONTg.svg.png,,3,0,3,6e-06,31
upload.wikimedia.org/wikipedia/commons/thumb/7/76/BSicon_BHF.svg/20px-BSicon_BHF.svg.png,,3,0,3,6e-06,31
upload.wikimedia.org/wikipedia/commons/thumb/5/5f/BSicon_CONTgq.svg/20px-BSicon_CONTgq.svg.png,,3,0,3,6e-06,31
upload.wikimedia.org/wikipedia/commons/thumb/4/47/BSicon_ABZgr.svg/20px-BSicon_ABZgr.svg.png,,3,0,3,6e-06,31
upload.wikimedia.org/wikipedia/commons/thumb/d/d1/BSicon_CONTf.svg/20px-BSicon_CONTf.svg.png,,2,0,2,6e-06,31
en.wikipedia.org/w/index.php?title=Special:CreateAccount&returnto=Fatehpur+Lok+Sabha+constituency,,1,0,1,6e-06,31
en.wikipedia.org/w/index.php?title=Special:UserLogin&returnto=Fatehpur+Lok+Sabha+constituency,,1,0,1,6e-06,31
bn.wikipedia.org/wiki/ফতেপুর_লোকসভা_কেন্দ্র,,1,0,1,6e-06,31
hi.wikipedia.org/wiki/फतेहपुर_लोक_सभा_निर्वाचन_क्षेत्र,,1,0,1,6e-06,31
mr.wikipedia.org/wiki/फतेहपूर_लोकसभा_मतदारसंघ,,1,0,1,6e-06,31
pa.wikipedia.org/wiki/ਫਤਿਹਪੁਰ_ਲੋਕ_ਸਭਾ_ਹਲਕਾ,,1,0,1,6e-06,31
ta.wikipedia.org/wiki/பதேபூர்_மக்களவைத்_தொகுதி,,1,0,1,6e-06,31
te.wikipedia.org/wiki/ఫతేపూర్_లోక్‌సభ_నియోజకవర్గం,,1,0,1,6e-06,31
wikidata.org/wiki/Special:EntityPage/Q5437428,,1,0,1,6e-06,31
en.wikipedia.org/wiki/Talk:Fatehpur_Lok_Sabha_constituency,,1,0,1,6e-06,31
en.wikipedia.org/w/index.php?title=Fatehpur_Lok_Sabha_constituency&action=edit,,1,0,1,6e-06,31
en.wikipedia.org/w/index.php?title=Fatehpur_Lok_Sabha_constituency&action=history,,1,0,1,6e-06,31
en.wikipedia.org/wiki/Special:WhatLinksHere/Fatehpur_Lok_Sabha_constituency,,1,0,1,6e-06,31
en.wikipedia.org/wiki/Special:RecentChangesLinked/Fatehpur_Lok_Sabha_constituency,,1,0,1,6e-06,31
en.wikipedia.org/w/index.php?title=Fatehpur_Lok_Sabha_constituency&oldid=1308104909,,1,0,1,6e-06,31
en.wikipedia.org/w/index.php?title=Fatehpur_Lok_Sabha_constituency&action=info,,1,0,1,6e-06,31
en.wikipedia.org/w/index.php?title=Fatehpur_Lok_Sabha_constituency&printable=yes,,1,0,1,6e-06,31
geohack.toolforge.org/geohack.php?pagename=Fatehpur_Lok_Sabha_constituency&params=25.92_N_80.81_E_,,1,0,1,6e-06,31
en.wikipedia.org/w/index.php?title=Fatehpur_Lok_Sabha_constituency&action=edit&section=1,,1,0,1,6e-06,31
en.wikipedia.org/wiki/Rajendra_Singh_Patel,,1,0,1,6e-06,31
en.wikipedia.org/wiki/Jai_Kumar_Singh_Jaiki,,1,0,1,6e-06,31
en.wikipedia.org/wiki/Chandra_Prakash_Lodhi,,1,0,1,6e-06,31
en.wikipedia.org/wiki/Vikas_Gupta_(politician),,1,0,1,6e-06,31
en.wikipedia.org/wiki/Usha_Maurya,,1,0,1,6e-06,31
en.wikipedia.org/wiki/Krishna_Paswan,,1,0,1,6e-06,31
en.wikipedia.org/w/index.php?title=Fatehpur_Lok_Sabha_constituency&action=edit&section=2,,1,0,1,6e-06,31
en.wikipedia.org/wiki/Ansar_Harvani,,1,0,1,6e-06,31
en.wikipedia.org/wiki/Sant_Bux_Singh,,1,0,1,6e-06,31
en.wikipedia.org/wiki/Bashir_Ahmed_(Member_of_Parliament),,1,0,1,6e-06,31
en.wikipedia.org/wiki/Liaquat_Husain,,1,0,1,6e-06,31
en.wikipedia.org/wiki/Hari_Krishna_Shastri,,1,0,1,6e-06,31
en.wikipedia.org/wiki/Vishambhar_Prasad_Nishad,,1,0,1,6e-06,31
en.wikipedia.org/wiki/Ashok_Kumar_Patel,,1,0,1,6e-06,31
en.wikipedia.org/wiki/Mahendra_Prasad_Nishad,,1,0,1,6e-06,31
en.wikipedia.org/wiki/Rakesh_Sachan,,3,0,3,6e-06,31
en.wikipedia.org/w/index.php?title=Fatehpur_Lok_Sabha_constituency&action=edit&section=3,,1,0,1,6e-06,31
en.wikipedia.org/w/index.php?title=Fatehpur_Lok_Sabha_constituency&action=edit&section=4,,1,0,1,6e-06,31
en.wikipedia.org/wiki/NOTA,,3,0,3,7e-06,31
en.wikipedia.org/w/index.php?title=Fatehpur_Lok_Sabha_constituency&action=edit&section=5,,1,0,1,6e-06,31
en.wikipedia.org/w/index.php?title=Fatehpur_Lok_Sabha_constituency&action=edit&section=6,,1,0,1,6e-06,31
en.wikipedia.org/wiki/All_India_Trinamool_Congress,,1,0,1,6e-06,31
en.wikipedia.org/w/index.php?title=Fatehpur_Lok_Sabha_constituency&action=edit&section=7,,1,0,1,6e-06,31
en.wikipedia.org/wiki/Radhey_Shyam_Gupta,,1,0,1,6e-06,31
en.wikipedia.org/w/index.php?title=Fatehpur_Lok_Sabha_constituency&action=edit&section=8,,1,0,1,6e-06,31
en.wikipedia.org/w/index.php?title=Fatehpur_Lok_Sabha_constituency&action=edit&section=9,,1,0,1,6e-06,31
en.wikipedia.org/w/index.php?title=Fatehpur_Lok_Sabha_constituency&action=edit&section=10,,1,0,1,6e-06,31
eci.nic.in/eci_main/CurrentElections/CONSOLIDATED_ORDER%20_ECI%20.pdf,,1,0,1,6e-06,31
timesofindia.indiatimes.com/elections/lok-sabha-constituencies/uttar-pradesh/fatehpur,,1,0,1,6e-06,31
results.eci.gov.in/PcResultGenJune2024/candidateswise-S2449.htm,,1,0,1,6e-06,31
resultuniversity.com/election/fatehpur-lok-sabha,,1,0,1,6e-06,31
elections.in/parliamentary-constituencies/1967-election-results.html,,1,0,1,6e-06,31
en.wikipedia.org/w/index.php?title=Fatehpur_Lok_Sabha_constituency&action=edit&section=11,,1,0,1,6e-06,31
en.wikipedia.org/wiki/Template:Prayagraj_division_topics,,3,0,3,7e-06,31
en.wikipedia.org/wiki/Template_talk:Prayagraj_division_topics,,2,0,2,7e-06,31
en.wikipedia.org/wiki/Special:EditPage/Template:Prayagraj_division_topics,,2,0,2,7e-06,31
en.wikipedia.org/wiki/1954_Prayag_Kumbh_Mela_stampede,,2,0,2,7e-06,31
en.wikipedia.org/wiki/2013_Prayag_Kumbh_Mela_stampede,,2,0,2,7e-06,31
en.wikipedia.org/wiki/2025_Prayag_Kumbh_Mela_crowd_crush,,2,0,2,7e-06,31
en.wikipedia.org/wiki/History_of_Prayagraj,,2,0,2,7e-06,31
en.wikipedia.org/wiki/Allahabad_Bypass_Expressway,,3,0,3,7e-06,31
en.wikipedia.org/wiki/Prayagraj_Lok_Sabha_constituency,,2,0,2,7e-06,31
en.wikipedia.org/wiki/Template:Fatehpur_district,,2,0,2,7e-06,31
en.wikipedia.org/wiki/Template:Kaushambi_district,,2,0,2,7e-06,31
"en.wikipedia.org/wiki/Template:Pratapgarh_district,_Uttar_Pradesh",,2,0,2,7e-06,31
en.wikipedia.org/wiki/Template:Prayagraj_district,,2,0,2,7e-06,31
en.wikipedia.org/wiki/Category:Villages_in_Fatehpur_district,,2,0,2,7e-06,31
en.wikipedia.org/wiki/Category:Villages_in_Kaushambi_district,,2,0,2,7e-06,31
"en.wikipedia.org/wiki/Category:Villages_in_Pratapgarh_district,_Uttar_Pradesh",,2,0,2,7e-06,31
en.wikipedia.org/wiki/Category:Villages_in_Prayagraj_district,,2,0,2,7e-06,31
"en.wikipedia.org/wiki/Category:People_from_Fatehpur,_Uttar_Pradesh",,2,0,2,7e-06,31
en.wikipedia.org/wiki/Category:People_from_Kaushambi_district,,2,0,2,7e-06,31
"en.wikipedia.org/wiki/Category:People_from_Pratapgarh,_Uttar_Pradesh",,2,0,2,7e-06,31
en.wikipedia.org/wiki/Category:People_from_Prayagraj,,2,0,2,7e-06,31
en.wikipedia.org/wiki/Category:Fatehpur_district,,1,0,1,6e-06,31
en.m.wikipedia.org/w/index.php?title=Fatehpur_Lok_Sabha_constituency&mobileaction=toggle_view_mobile,,1,0,1,6e-06,31
en.wikipedia.org/wiki/Mirzapur,,2,0,2,6e-06,31
en.wikipedia.org/wiki/Munger,,3,0,3,6e-06,31
en.wikipedia.org/wiki/Punpun_River,,2,0,2,6e-06,31
en.wikipedia.org/wiki/Rajmahal,,2,0,2,6e-06,31
en.wikipedia.org/wiki/Howrah_Bridge,,2,0,2,6e-06,31
en.wikipedia.org/wiki/Koilwar_Bridge,,2,0,2,6e-06,31
en.wikipedia.org/w/index.php?title=Special:CreateAccount&returnto=Farrukhabad+district,,1,0,1,6e-06,31
en.wikipedia.org/w/index.php?title=Special:UserLogin&returnto=Farrukhabad+district,,1,0,1,6e-06,31
ar.wikipedia.org/wiki/منطقة_فرروخاباد,,1,0,1,6e-06,31
bn.wikipedia.org/wiki/ফারুখাবাদ_জেলা,,1,0,1,6e-06,31
zh-min-nan.wikipedia.org/wiki/Farrukhabad_(koān),,1,0,1,6e-06,31
bh.wikipedia.org/wiki/फर्रूखाबाद_जिला,,1,0,1,6e-06,31
ca.wikipedia.org/wiki/Districte_de_Farrukhabad,,1,0,1,6e-06,31
ceb.wikipedia.org/wiki/Farrukhābād_(distrito),,1,0,1,6e-06,31
da.wikipedia.org/wiki/Farrukhabad_(distrikt),,1,0,1,6e-06,31
de.wikipedia.org/wiki/Farrukhabad_(Distrikt),,1,0,1,6e-06,31
es.wikipedia.org/wiki/Distrito_de_Farrukhabad,,1,0,1,6e-06,31
eu.wikipedia.org/wiki/Farrukhabad_barrutia,,1,0,1,6e-06,31
fa.wikipedia.org/wiki/بخش_فرخ‌آباد,,1,0,1,6e-06,31
fr.wikipedia.org/wiki/District_de_Farrukhabad,,1,0,1,6e-06,31
gu.wikipedia.org/wiki/ફાર્રુખાબાદ_જિલ્લો,,1,0,1,6e-06,31
hi.wikipedia.org/wiki/फ़र्रूख़ाबाद_जिला,,1,0,1,6e-06,31
it.wikipedia.org/wiki/Distretto_di_Farrukhabad,,1,0,1,6e-06,31
mr.wikipedia.org/wiki/फरुखाबाद_जिल्हा,,1,0,1,6e-06,31
arz.wikipedia.org/wiki/فرروخاباد,,1,0,1,6e-06,31
nl.wikipedia.org/wiki/Farrukhabad_(district),,1,0,1,6e-06,31
ne.wikipedia.org/wiki/फर्रुखाबाद_जिल्ला,,1,0,1,6e-06,31
new.wikipedia.org/wiki/फर्रूखाबाद_जिल्ला,,1,0,1,6e-06,31
no.wikipedia.org/wiki/Farrukhabad_(distrikt),,1,0,1,6e-06,31
pnb.wikipedia.org/wiki/ضلع_فرخ_آباد,,1,0,1,6e-06,31
ru.wikipedia.org/wiki/Фаррукхабад_(округ),,1,0,1,6e-06,31
sa.wikipedia.org/wiki/फर्रुकाबादमण्डलम्,,1,0,1,6e-06,31
sat.wikipedia.org/wiki/ᱯᱷᱚᱨᱨᱩᱠᱷᱟᱵᱟᱫᱽ_ᱦᱚᱱᱚᱛ,,1,0,1,6e-06,31
sv.wikipedia.org/wiki/Farrukhabad,,1,0,1,6e-06,31
ta.wikipedia.org/wiki/பரூக்காபாது_மாவட்டம்,,1,0,1,6e-06,31
te.wikipedia.org/wiki/ఫరూఖాబాద్_జిల్లా,,1,0,1,6e-06,31
ur.wikipedia.org/wiki/ضلع_فرخ_آباد,,1,0,1,6e-06,31
vi.wikipedia.org/wiki/Farrukhabad_(huyện),,1,0,1,6e-06,31
zh.wikipedia.org/wiki/法魯卡巴德縣,,1,0,1,6e-06,31
wikidata.org/wiki/Special:EntityPage/Q1897251,,1,0,1,6e-06,31
en.wikipedia.org/wiki/Talk:Farrukhabad_district,,1,0,1,6e-06,31
en.wikipedia.org/w/index.php?title=Farrukhabad_district&action=edit,,1,0,1,6e-06,31
en.wikipedia.org/w/index.php?title=Farrukhabad_district&action=history,,1,0,1,6e-06,31
en.wikipedia.org/wiki/Special:WhatLinksHere/Farrukhabad_district,,1,0,1,6e-06,31
en.wikipedia.org/wiki/Special:RecentChangesLinked/Farrukhabad_district,,1,0,1,6e-06,31
en.wikipedia.org/w/index.php?title=Farrukhabad_district&oldid=1289739162,,1,0,1,6e-06,31
en.wikipedia.org/w/index.php?title=Farrukhabad_district&action=info,,1,0,1,6e-06,31
en.wikipedia.org/w/index.php?title=Farrukhabad_district&printable=yes,,1,0,1,6e-06,31
commons.wikimedia.org/wiki/Category:Farrukhabad_district,,1,0,1,6e-06,31
en.wikipedia.org/wiki/Special:EditPage/Farrukhabad_district,,1,0,1,6e-06,31
"google.com/search?as_eq=wikipedia&q=""Farrukhabad+district""",,1,0,1,6e-06,31
"google.com/search?tbm=nws&q=""Farrukhabad+district""+-wikipedia&tbs=ar:1",,1,0,1,6e-06,31
"google.com/search?&q=""Farrukhabad+district""&tbs=bkt:s&tbm=bks",,1,0,1,6e-06,31
"google.com/search?tbs=bks:1&q=""Farrukhabad+district""+-wikipedia",,1,0,1,6e-06,31
"scholar.google.com/scholar?q=""Farrukhabad+district""",,1,0,1,6e-06,31
"jstor.org/action/doBasicSearch?Query=""Farrukhabad+district""&acc=on&wc=on",,1,0,1,6e-06,31
en.wikipedia.org/wiki/File:Tomb_of_Nawab_Rasheed_Khan_Kaimganj.JPG,,1,0,1,6e-06,31
en.wikipedia.org/wiki/File:India_Uttar_Pradesh_districts_2012_Farrukhabad.svg,,1,0,1,6e-06,31
en.wikipedia.org/wiki/Ramganga_River,,2,0,2,7e-06,31
en.wikipedia.org/w/index.php?title=Farrukhabad_district&action=edit&section=1,,1,0,1,6e-06,31
en.wikipedia.org/wiki/Pathan,,1,0,1,6e-06,31
en.wikipedia.org/wiki/Jahandar_Shah,,2,0,2,7e-06,31
en.wikipedia.org/wiki/Khanqah,,1,0,1,6e-06,31
en.wikipedia.org/wiki/Battle_of_Farrukhabad,,1,0,1,6e-06,31
"en.wikipedia.org/wiki/Gerard_Lake,_1st_Viscount_Lake",,1,0,1,6e-06,31
en.wikipedia.org/w/index.php?title=Farrukhabad_district&action=edit&section=2,,1,0,1,6e-06,31
en.wikipedia.org/wiki/West_Virginia,,1,0,1,6e-06,31
en.wikipedia.org/w/index.php?title=Farrukhabad_district&action=edit&section=3,,1,0,1,6e-06,31
en.wikipedia.org/w/index.php?title=Farrukhabad_district&action=edit&section=4,,1,0,1,6e-06,31
en.wikipedia.org/w/index.php?title=Farrukhabad_district&action=edit&section=5,,1,0,1,6e-06,31
en.wikipedia.org/wiki/Village,,1,0,1,6e-06,31
en.wikipedia.org/wiki/Cantonment_Board,,1,0,1,6e-06,31
en.wikipedia.org/w/index.php?title=Farrukhabad_district&action=edit&section=6,,1,0,1,6e-06,31
ipindia.gov.in/registered-gls.htm,,1,0,1,6e-06,31
en.wikipedia.org/w/index.php?title=Farrukhabad_district&action=edit&section=7,,1,0,1,6e-06,31
en.wikipedia.org/w/index.php?title=Farrukhabad_district&action=edit&section=8,,1,0,1,6e-06,31
documents1.worldbank.org/curated/en/751141468269412833/pdf/889670WP0URGEN00Box385254B00PUBLIC0.pdf,,1,0,1,6e-06,31
en.wikipedia.org/w/index.php?title=Farrukhabad_district&action=edit&section=9,,1,0,1,6e-06,31
en.wikipedia.org/w/index.php?title=Farrukhabad_district&action=edit&section=10,,1,0,1,6e-06,31
en.wikipedia.org/wiki/Rajput_Regiment,,1,0,1,6e-06,31
en.wikipedia.org/wiki/Sikh_Light_Infantry,,1,0,1,6e-06,31
en.wikipedia.org/w/index.php?title=Farrukhabad_district&action=edit&section=11,,1,0,1,6e-06,31
en.wikipedia.org/w/index.php?title=Farrukhabad_district&action=edit&section=12,,1,0,1,6e-06,31
en.wikipedia.org/w/index.php?title=Farrukhabad_district&action=edit&section=13,,1,0,1,6e-06,31
en.wikipedia.org/wiki/Tirthankara,,1,0,1,6e-06,31
en.wikipedia.org/wiki/Vaishali_(ancient_city),,1,0,1,6e-06,31
en.wikipedia.org/w/index.php?title=Farrukhabad_district&action=edit&section=14,,1,0,1,6e-06,31
en.wikipedia.org/wiki/Sankassa,,2,0,2,6e-06,31
uptourism.gov.in/en/page/buddhist-circuit,,1,0,1,6e-06,31
en.wikipedia.org/w/index.php?title=Farrukhabad_district&action=edit&section=15,,1,0,1,6e-06,31
en.wikipedia.org/w/index.php?title=Farrukhabad_district&action=edit&section=16,,1,0,1,6e-06,31
en.wikipedia.org/w/index.php?title=Farrukhabad_district&action=edit&section=17,,1,0,1,6e-06,31
en.wikipedia.org/wiki/Farukhabad_gharana,,1,0,1,6e-06,31
en.wikipedia.org/wiki/Drums,,1,0,1,6e-06,31
scroll.in/article/822465/listen-tabla-maestros-of-the-farrukhabad-gharana-seamlessly-blend-styles,,1,0,1,6e-06,31
en.wikipedia.org/wiki/Tom_Alter,,1,0,1,6e-06,31
en.wikipedia.org/w/index.php?title=Farrukhabad_district&action=edit&section=18,,1,0,1,6e-06,31
en.wikipedia.org/w/index.php?title=Farrukhabad_district&action=edit&section=19,,1,0,1,6e-06,31
en.wikipedia.org/w/index.php?title=Farrukhabad_district&action=edit&section=20,,1,0,1,6e-06,31
en.wikipedia.org/w/index.php?title=Farrukhabad_district&action=edit&section=21,,1,0,1,6e-06,31
en.wikipedia.org/w/index.php?title=Farrukhabad_district&action=edit&section=22,,1,0,1,6e-06,31
en.wikipedia.org/w/index.php?title=Farrukhabad_district&action=edit&section=23,,1,0,1,6e-06,31
en.wikipedia.org/wiki/Anwar_Farrukhabadi,,1,0,1,6e-06,31
en.wikipedia.org/wiki/Sufism_in_India,,1,0,1,6e-06,31
en.wikipedia.org/wiki/Nusrat_Fateh_Ali_Khan,,1,0,1,6e-06,31
en.wikipedia.org/wiki/Anna_Martha_Fullerton,,1,0,1,6e-06,31
en.wikipedia.org/wiki/George_Stuart_Fullerton,,1,0,1,6e-06,31
en.wikipedia.org/wiki/Khurshed_Alam_Khan,,1,0,1,6e-06,31
en.wikipedia.org/w/index.php?title=Farrukhabad_district&action=edit&section=24,,1,0,1,6e-06,31
en.wikipedia.org/wiki/Special:BookSources/9780199081110,,1,0,1,6e-06,31
doi.org/10.1177%2F097152159700400101,,1,0,1,6e-06,31
api.semanticscholar.org/CorpusID:145321852,,1,0,1,6e-06,31
jstor.org/stable/44138936,,1,0,1,6e-06,31
en.wikipedia.org/wiki/Jos_Gommans,,1,0,1,6e-06,31
en.wikipedia.org/wiki/Special:BookSources/9789004101098,,1,0,1,6e-06,31
web.archive.org/web/20120405033402/http://www.nird.org.in/brgf/doc/brgf_BackgroundNote.pdf,,1,0,1,6e-06,31
nird.org.in/brgf/doc/brgf_BackgroundNote.pdf,,1,0,1,6e-06,31
dcmsme.gov.in/dips/DIP%20Farrukhabad%20JK%20Sinha%20AD%20Mech.pdf,,1,0,1,6e-06,31
agriculture.up.nic.in/WriteReadData/CDAP-RKVY/Farrukhabad.pdf,,1,0,1,6e-06,31
doi.org/10.1080%2F02666030.2001.9628598,,1,0,1,6e-06,31
api.semanticscholar.org/CorpusID:194082854,,1,0,1,6e-06,31
doi.org/10.1080%2F02666030.2002.9628613,,1,0,1,6e-06,31
api.semanticscholar.org/CorpusID:191481325,,1,0,1,6e-06,31
en.wikipedia.org/wiki/Special:BookSources/9788173045745,,1,0,1,6e-06,31
en.wikipedia.org/w/index.php?title=Farrukhabad_district&action=edit&section=25,,1,0,1,6e-06,31
en.wikipedia.org/wiki/Kanshiram_Nagar_district,,1,0,1,6e-06,31
wikidata.org/wiki/Q1897251,,1,0,1,6e-06,31
viaf.org/viaf/141903549,,1,0,1,6e-06,31
id.oclc.org/worldcat/entity/E39PBJdgWkxcw7Ck8VqfJxtkDq,,1,0,1,6e-06,31
d-nb.info/gnd/4566530-8,,1,0,1,6e-06,31
id.loc.gov/authorities/n81074446,,1,0,1,6e-06,31
nli.org.il/en/authorities/987007566841205171,,1,0,1,6e-06,31
en.wikipedia.org/wiki/Category:Articles_needing_additional_references_from_August_2015,,1,0,1,6e-06,31
en.m.wikipedia.org/w/index.php?title=Farrukhabad_district&mobileaction=toggle_view_mobile,,1,0,1,6e-06,31
en.wikipedia.org/w/index.php?title=Special:CreateAccount&returnto=Ghatampur,,1,0,1,6e-06,31
en.wikipedia.org/w/index.php?title=Special:UserLogin&returnto=Ghatampur,,1,0,1,6e-06,31
zh-min-nan.wikipedia.org/wiki/Ghatampur,,1,0,1,6e-06,31
ceb.wikipedia.org/wiki/Ghātampur,,1,0,1,6e-06,31
es.wikipedia.org/wiki/Ghatampur,,1,0,1,6e-06,31
hi.wikipedia.org/wiki/घाटमपुर,,1,0,1,6e-06,31
bpy.wikipedia.org/wiki/ঘাতামপুর,,1,0,1,6e-06,31
it.wikipedia.org/wiki/Ghatampur,,1,0,1,6e-06,31
mg.wikipedia.org/wiki/Ghatampur,,1,0,1,6e-06,31
ms.wikipedia.org/wiki/Ghatampur,,1,0,1,6e-06,31
nl.wikipedia.org/wiki/Ghatampur,,1,0,1,6e-06,31
new.wikipedia.org/wiki/घतम्पुर,,1,0,1,6e-06,31
pl.wikipedia.org/wiki/Ghatampur,,1,0,1,6e-06,31
pt.wikipedia.org/wiki/Ghatampur,,1,0,1,6e-06,31
sv.wikipedia.org/wiki/Ghātampur,,1,0,1,6e-06,31
ur.wikipedia.org/wiki/گھتم_پور,,1,0,1,6e-06,31
vi.wikipedia.org/wiki/Ghatampur,,1,0,1,6e-06,31
zh.wikipedia.org/wiki/加塔姆普尔,,1,0,1,6e-06,31
wikidata.org/wiki/Special:EntityPage/Q1707190,,1,0,1,6e-06,31
en.wikipedia.org/wiki/Talk:Ghatampur,,1,0,1,6e-06,31
en.wikipedia.org/w/index.php?title=Ghatampur&action=edit,,1,0,1,6e-06,31
en.wikipedia.org/w/index.php?title=Ghatampur&action=history,,1,0,1,6e-06,31
en.wikipedia.org/wiki/Special:WhatLinksHere/Ghatampur,,1,0,1,6e-06,31
en.wikipedia.org/wiki/Special:RecentChangesLinked/Ghatampur,,1,0,1,6e-06,31
en.wikipedia.org/w/index.php?title=Ghatampur&oldid=1308336272,,1,0,1,6e-06,31
en.wikipedia.org/w/index.php?title=Ghatampur&action=info,,1,0,1,6e-06,31
en.wikipedia.org/w/index.php?title=Special:DownloadAsPdf&page=Ghatampur&action=show-download-screen,,1,0,1,6e-06,31
en.wikipedia.org/w/index.php?title=Ghatampur&printable=yes,,1,0,1,6e-06,31
commons.wikimedia.org/wiki/Category:Ghatampur,,1,0,1,6e-06,31
en.wikipedia.org/wiki/Special:EditPage/Ghatampur,,1,0,1,6e-06,31
"google.com/search?as_eq=wikipedia&q=""Ghatampur""",,1,0,1,6e-06,31
"google.com/search?tbm=nws&q=""Ghatampur""+-wikipedia&tbs=ar:1",,1,0,1,6e-06,31
"google.com/search?&q=""Ghatampur""&tbs=bkt:s&tbm=bks",,1,0,1,6e-06,31
"google.com/search?tbs=bks:1&q=""Ghatampur""+-wikipedia",,1,0,1,6e-06,31
"scholar.google.com/scholar?q=""Ghatampur""",,1,0,1,6e-06,31
"jstor.org/action/doBasicSearch?Query=""Ghatampur""&acc=on&wc=on",,1,0,1,6e-06,31
en.wikipedia.org/w/index.php?title=Ghatampur&action=edit&section=1,,1,0,1,6e-06,31
geohack.toolforge.org/geohack.php?pagename=Ghatampur&params=26.17_N_80.17_E_,,1,0,1,6e-06,31
en.wikipedia.org/w/index.php?title=Ghatampur&action=edit&section=2,,1,0,1,6e-06,31
en.wikipedia.org/w/index.php?title=Ghatampur&action=edit&section=3,,1,0,1,6e-06,31
latlong.net/place/ghatampur-uttar-pradesh-india-3141.html,,1,0,1,6e-06,31
fallingrain.com/world/IN/36/Ghatampur.html,,1,0,1,6e-06,31
en.wikipedia.org/w/index.php?title=Ghatampur&action=edit&section=4,,1,0,1,6e-06,31
upelections.co.in/uttar-pradesh-assembly-constituencies/ghatampur,,1,0,1,6e-06,31
kanpurnagar.nic.in/tourist-place/bhitargaon-temple/,,1,0,1,6e-06,31
en.m.wikipedia.org/w/index.php?title=Ghatampur&mobileaction=toggle_view_mobile,,1,0,1,6e-06,31
en.wikipedia.org/w/index.php?title=Special:CreateAccount&returnto=Govind+Nagar,,1,0,1,6e-06,31
en.wikipedia.org/w/index.php?title=Special:UserLogin&returnto=Govind+Nagar,,1,0,1,6e-06,31
wikidata.org/wiki/Special:EntityPage/Q5589839,,1,0,1,6e-06,31
en.wikipedia.org/wiki/Talk:Govind_Nagar,,1,0,1,6e-06,31
en.wikipedia.org/w/index.php?title=Govind_Nagar&action=edit,,1,0,1,6e-06,31
en.wikipedia.org/w/index.php?title=Govind_Nagar&action=history,,1,0,1,6e-06,31
en.wikipedia.org/wiki/Special:WhatLinksHere/Govind_Nagar,,1,0,1,6e-06,31
en.wikipedia.org/wiki/Special:RecentChangesLinked/Govind_Nagar,,1,0,1,6e-06,31
en.wikipedia.org/w/index.php?title=Govind_Nagar&oldid=1255328658,,1,0,1,6e-06,31
en.wikipedia.org/w/index.php?title=Govind_Nagar&action=info,,1,0,1,6e-06,31
en.wikipedia.org/w/index.php?title=Govind_Nagar&printable=yes,,1,0,1,6e-06,31
en.wikipedia.org/wiki/Special:EditPage/Govind_Nagar,,1,0,1,6e-06,31
"google.com/search?as_eq=wikipedia&q=""Govind+Nagar""",,1,0,1,6e-06,31
"google.com/search?tbm=nws&q=""Govind+Nagar""+-wikipedia&tbs=ar:1",,1,0,1,6e-06,31
"google.com/search?&q=""Govind+Nagar""&tbs=bkt:s&tbm=bks",,1,0,1,6e-06,31
"google.com/search?tbs=bks:1&q=""Govind+Nagar""+-wikipedia",,1,0,1,6e-06,31
"scholar.google.com/scholar?q=""Govind+Nagar""",,1,0,1,6e-06,31
"jstor.org/action/doBasicSearch?Query=""Govind+Nagar""&acc=on&wc=on",,1,0,1,6e-06,31
en.wikipedia.org/wiki/Govind_Vallabh_Pant,,2,0,2,6e-06,31
en.wikipedia.org/wiki/Dada_Nagar,,1,0,1,6e-06,31
en.wikipedia.org/wiki/Govindpuri_Railway_Station,,2,0,2,7e-06,31
en.wikipedia.org/wiki/Category:Shopping_districts_and_streets_in_India,,2,0,2,7e-06,31
en.wikipedia.org/wiki/Category:Articles_lacking_sources_from_October_2015,,2,0,2,7e-06,31
en.m.wikipedia.org/w/index.php?title=Govind_Nagar&mobileaction=toggle_view_mobile,,1,0,1,6e-06,31
en.wikipedia.org/w/index.php?title=Special:CreateAccount&returnto=Govindpuri+railway+station,,1,0,1,6e-06,31
en.wikipedia.org/w/index.php?title=Special:UserLogin&returnto=Govindpuri+railway+station,,1,0,1,6e-06,31
ur.wikipedia.org/wiki/گووندپوری،کانپور_ریلوے_اسٹیشن,,1,0,1,6e-06,31
wikidata.org/wiki/Special:EntityPage/Q5589935,,1,0,1,6e-06,31
en.wikipedia.org/wiki/Talk:Govindpuri_railway_station,,1,0,1,6e-06,31
en.wikipedia.org/w/index.php?title=Govindpuri_railway_station&action=edit,,1,0,1,6e-06,31
en.wikipedia.org/w/index.php?title=Govindpuri_railway_station&action=history,,1,0,1,6e-06,31
en.wikipedia.org/wiki/Special:WhatLinksHere/Govindpuri_railway_station,,1,0,1,6e-06,31
en.wikipedia.org/wiki/Special:RecentChangesLinked/Govindpuri_railway_station,,1,0,1,6e-06,31
en.wikipedia.org/w/index.php?title=Govindpuri_railway_station&oldid=1303373467,,1,0,1,6e-06,31
en.wikipedia.org/w/index.php?title=Govindpuri_railway_station&action=info,,1,0,1,6e-06,31
en.wikipedia.org/w/index.php?title=Govindpuri_railway_station&printable=yes,,1,0,1,6e-06,31
en.wikipedia.org/wiki/Indian_Branch_Railway_Company,,4,0,4,6e-06,31
en.wikipedia.org/wiki/Kanpur_Anwarganj,,4,0,4,7e-06,31
en.wikipedia.org/wiki/International_Women%27s_Day,,1,0,1,6e-06,31
en.wikipedia.org/w/index.php?title=Govindpuri_railway_station&action=edit&section=1,,1,0,1,6e-06,31
en.wikipedia.org/w/index.php?title=Govindpuri_railway_station&action=edit&section=2,,1,0,1,6e-06,31
en.wikipedia.org/w/index.php?title=Govindpuri_railway_station&action=edit&section=3,,1,0,1,6e-06,31
en.wikipedia.org/w/index.php?title=Govindpuri_railway_station&action=edit&section=4,,1,0,1,6e-06,31
en.wikipedia.org/w/index.php?title=Govindpuri_railway_station&action=edit&section=5,,1,0,1,6e-06,31
en.wikipedia.org/wiki/Special:EditPage/Govindpuri_railway_station,,1,0,1,6e-06,31
en.wikipedia.org/wiki/Chitrakoot_Dham,,1,0,1,6e-06,31
en.wikipedia.org/wiki/Tundla,,3,0,3,6e-06,31
en.wikipedia.org/w/index.php?title=Govindpuri_railway_station&action=edit&section=6,,1,0,1,6e-06,31
en.wikipedia.org/w/index.php?title=Govindpuri_railway_station&action=edit&section=7,,1,0,1,6e-06,31
irfca.org/members/archive/messages.php?index=405,,1,0,1,6e-06,31
in.jagran.yahoo.com/epaper/index.php?location=30&edition=2010-04-26&pageno=7,,2,0,2,6e-06,31
en.wikipedia.org/wiki/Category:Railway_stations_in_India_opened_in_1921,,1,0,1,6e-06,31
en.wikipedia.org/wiki/Category:Articles_needing_additional_references_from_February_2019,,1,0,1,6e-06,31
en.wikipedia.org/wiki/Category:Articles_with_failed_verification_from_February_2019,,1,0,1,6e-06,31
en.m.wikipedia.org/w/index.php?title=Govindpuri_railway_station&mobileaction=toggle_view_mobile,,1,0,1,6e-06,31
en.wikipedia.org/w/index.php?title=Special:CreateAccount&returnto=Ghatampur+Lok+Sabha+constituency,,1,0,1,6e-06,31
en.wikipedia.org/w/index.php?title=Special:UserLogin&returnto=Ghatampur+Lok+Sabha+constituency,,1,0,1,6e-06,31
mr.wikipedia.org/wiki/घटमपूर_लोकसभा_मतदारसंघ_(१९५७-२००८),,1,0,1,6e-06,31
te.wikipedia.org/wiki/ఘతంపూర్_లోక్‌సభ_నియోజకవర్గం,,1,0,1,6e-06,31
wikidata.org/wiki/Special:EntityPage/Q13117035,,1,0,1,6e-06,31
en.wikipedia.org/wiki/Talk:Ghatampur_Lok_Sabha_constituency,,1,0,1,6e-06,31
en.wikipedia.org/w/index.php?title=Ghatampur_Lok_Sabha_constituency&action=edit,,1,0,1,6e-06,31
en.wikipedia.org/w/index.php?title=Ghatampur_Lok_Sabha_constituency&action=history,,1,0,1,6e-06,31
en.wikipedia.org/wiki/Special:WhatLinksHere/Ghatampur_Lok_Sabha_constituency,,1,0,1,6e-06,31
en.wikipedia.org/wiki/Special:RecentChangesLinked/Ghatampur_Lok_Sabha_constituency,,1,0,1,6e-06,31
en.wikipedia.org/w/index.php?title=Ghatampur_Lok_Sabha_constituency&oldid=1295438066,,1,0,1,6e-06,31
en.wikipedia.org/w/index.php?title=Ghatampur_Lok_Sabha_constituency&action=info,,1,0,1,6e-06,31
en.wikipedia.org/w/index.php?title=Ghatampur_Lok_Sabha_constituency&printable=yes,,1,0,1,6e-06,31
geohack.toolforge.org/geohack.php?pagename=Ghatampur_Lok_Sabha_constituency&params=26.2_N_80.2_E_,,1,0,1,6e-06,31
en.wikipedia.org/w/index.php?title=Ghatampur_Lok_Sabha_constituency&action=edit&section=1,,1,0,1,6e-06,31
en.wikipedia.org/w/index.php?title=Ghatampur_Lok_Sabha_constituency&action=edit&section=2,,1,0,1,6e-06,31
en.wikipedia.org/wiki/Ashkaran_Sankhwar,,1,0,1,6e-06,31
en.wikipedia.org/wiki/Kamal_Rani,,1,0,1,6e-06,31
en.wikipedia.org/w/index.php?title=Ghatampur_Lok_Sabha_constituency&action=edit&section=3,,1,0,1,6e-06,31
en.wikipedia.org/wiki/Aruna_Kori,,1,0,1,6e-06,31
en.wikipedia.org/w/index.php?title=Ghatampur_Lok_Sabha_constituency&action=edit&section=4,,1,0,1,6e-06,31
wikidata.org/wiki/Special:EntityPage/Q7903354,,2,0,2,6e-06,31
en.wikipedia.org/wiki/Talk:Uttar_Pradesh_Textile_Technology_Institute,,2,0,2,6e-06,31
en.wikipedia.org/w/index.php?title=Uttar_Pradesh_Textile_Technology_Institute&action=edit,,2,0,2,6e-06,31
en.wikipedia.org/w/index.php?title=Uttar_Pradesh_Textile_Technology_Institute&action=history,,2,0,2,6e-06,31
en.wikipedia.org/wiki/Special:WhatLinksHere/Uttar_Pradesh_Textile_Technology_Institute,,2,0,2,6e-06,31
en.wikipedia.org/wiki/Special:RecentChangesLinked/Uttar_Pradesh_Textile_Technology_Institute,,2,0,2,6e-06,31
en.wikipedia.org/w/index.php?title=Uttar_Pradesh_Textile_Technology_Institute&oldid=1306703135,,2,0,2,6e-06,31
en.wikipedia.org/w/index.php?title=Uttar_Pradesh_Textile_Technology_Institute&action=info,,2,0,2,6e-06,31
en.wikipedia.org/w/index.php?title=Uttar_Pradesh_Textile_Technology_Institute&printable=yes,,2,0,2,6e-06,31
en.wikipedia.org/wiki/Special:EditPage/Uttar_Pradesh_Textile_Technology_Institute,,2,0,2,6e-06,31
"google.com/search?as_eq=wikipedia&q=""Uttar+Pradesh+Textile+Technology+Institute""",,2,0,2,6e-06,31
"google.com/search?tbm=nws&q=""Uttar+Pradesh+Textile+Technology+Institute""+-wikipedia&tbs=ar:1",,2,0,2,6e-06,31
"google.com/search?&q=""Uttar+Pradesh+Textile+Technology+Institute""&tbs=bkt:s&tbm=bks",,2,0,2,6e-06,31
"google.com/search?tbs=bks:1&q=""Uttar+Pradesh+Textile+Technology+Institute""+-wikipedia",,2,0,2,6e-06,31
"scholar.google.com/scholar?q=""Uttar+Pradesh+Textile+Technology+Institute""",,2,0,2,6e-06,31
"jstor.org/action/doBasicSearch?Query=""Uttar+Pradesh+Textile+Technology+Institute""&acc=on&wc=on",,2,0,2,6e-06,31
uptti.ac.in/,,2,0,2,6e-06,31
en.wikipedia.org/w/index.php?title=Uttar_Pradesh_Textile_Technology_Institute&action=edit&section=1,,2,0,2,6e-06,31
en.wikipedia.org/w/index.php?title=Uttar_Pradesh_Textile_Technology_Institute&action=edit&section=2,,2,0,2,6e-06,31
en.wikipedia.org/w/index.php?title=Uttar_Pradesh_Textile_Technology_Institute&action=edit&section=3,,2,0,2,6e-06,31
en.wikipedia.org/w/index.php?title=Uttar_Pradesh_Textile_Technology_Institute&action=edit&section=4,,2,0,2,6e-06,31
en.wikipedia.org/w/index.php?title=Uttar_Pradesh_Textile_Technology_Institute&action=edit&section=5,,2,0,2,6e-06,31
livemint.com/Leisure/ZDIwIHEyFLl1y3lVvqtQ5J/The-first-Indians-on-Everest.html,,2,0,2,6e-06,31
web.archive.org/web/20230423020247/https://aktu.ac.in/,,2,0,2,6e-06,31
aktu.ac.in/,,5,0,5,7e-06,31
iitk.ac.in/infocell/iitk/history/kanpur.html,,2,0,2,6e-06,31
en.wikipedia.org/wiki/Special:BookSources/9788171413553,,2,0,2,6e-06,31
web.archive.org/web/20220926202309/http://www.dbrau.org.in/AboutUniversity.aspx,,2,0,2,6e-06,31
dbrau.org.in/AboutUniversity.aspx,,2,0,2,6e-06,31
gpkanpur.co.in/,,2,0,2,6e-06,31
web.archive.org/web/20110721152407/http://www.uptti.ac.in/about.php,,2,0,2,6e-06,31
uptti.ac.in/about.php,,2,0,2,6e-06,31
books.google.com/books?id=QXfjCgAAQBAJ&q=gcti+hostel+kanpur&pg=PT76,,2,0,2,6e-06,31
en.wikipedia.org/wiki/Special:BookSources/9789352141920,,2,0,2,6e-06,31
en.wikipedia.org/w/index.php?title=Uttar_Pradesh_Textile_Technology_Institute&action=edit&section=6,,2,0,2,6e-06,31
indiaeducation.ernet.in/insitutions/PROFILENEW1.ASP?no=U02241/,,2,0,2,6e-06,31
en.wikipedia.org/wiki/Category:Textile_schools_in_India,,2,0,2,6e-06,31
en.wikipedia.org/wiki/Category:Dr._A.P.J._Abdul_Kalam_Technical_University,,5,0,5,7e-06,31
en.wikipedia.org/wiki/Category:Universities_and_colleges_established_in_1914,,2,0,2,6e-06,31
en.wikipedia.org/wiki/Category:1914_establishments_in_India,,2,0,2,6e-06,31
en.wikipedia.org/wiki/Category:Articles_needing_additional_references_from_July_2012,,2,0,2,6e-06,31
en.wikipedia.org/wiki/Category:Articles_with_a_promotional_tone_from_April_2020,,2,0,2,6e-06,31
"hi.wikipedia.org/wiki/राजकीय_मेडिकल_कॉलेज,_कन्नौज",,1,0,1,7e-06,31
"ml.wikipedia.org/wiki/ഗവൺമെന്റ്_മെഡിക്കൽ_കോളേജ്,_കണ്ണൗജ്",,1,0,1,7e-06,31
wikidata.org/wiki/Special:EntityPage/Q99300637,,1,0,1,7e-06,31
"en.wikipedia.org/wiki/Dr._Bhimrao_Ramji_Ambedkar_Government_Medical_College,_Kannauj",,1,0,1,7e-06,31
"en.wikipedia.org/wiki/Talk:Dr._Bhimrao_Ramji_Ambedkar_Government_Medical_College,_Kannauj",,1,0,1,7e-06,31
en.wikipedia.org/wiki/File:GMCKannauj_logo.png,,1,0,1,7e-06,31
gmckannauj.in/,,1,0,1,7e-06,31
en.wikipedia.org/wiki/AIPMT,,1,0,1,7e-06,31
en.wikipedia.org/wiki/NEET,,2,0,2,7e-06,31
"en.wikipedia.org/wiki/Government_Medical_College,_Jalaun",,1,0,1,7e-06,31
"en.wikipedia.org/wiki/Government_Medical_College,_Azamgarh",,1,0,1,7e-06,31
"en.wikipedia.org/wiki/Maharshi_Vashishtha_Autonomous_State_Medical_College,_Basti",,1,0,1,7e-06,31
en.wikipedia.org/wiki/Mahamaya_Rajkiya_Allopathic_Medical_College,,1,0,1,7e-06,31
"en.wikipedia.org/wiki/Government_Medical_College,_Banda",,1,0,1,7e-06,31
kgmu.org/affiliated_colleges.php,,1,0,1,7e-06,31
mciindia.org/InformationDesk/ForStudents/ListofCollegesTeachingMBBS.aspx,,1,0,1,7e-06,31
likhaipadhai.blogspot.in/2015/11/blog-post_18.html,,1,0,1,7e-06,31
gmckannauj.org/,,1,0,1,7e-06,31
en.wikipedia.org/wiki/Template:UttarPradesh-university-stub,,1,0,1,7e-06,31
en.wikipedia.org/wiki/Template_talk:UttarPradesh-university-stub,,1,0,1,7e-06,31
en.wikipedia.org/wiki/Special:EditPage/Template:UttarPradesh-university-stub,,1,0,1,7e-06,31
en.wikipedia.org/wiki/Category:Colleges_in_Kannauj_district,,1,0,1,7e-06,31
en.wikipedia.org/wiki/Category:2016_establishments_in_Uttar_Pradesh,,1,0,1,7e-06,31
en.wikipedia.org/wiki/Category:Uttar_Pradesh_university_stubs,,1,0,1,7e-06,31
upload.wikimedia.org/wikipedia/en/0/0c/GMCKannauj_logo.png,,1,0,1,7e-06,31
upload.wikimedia.org/wikipedia/commons/thumb/8/84/Indian_School.png/40px-Indian_School.png,,1,0,1,7e-06,31
en.wikipedia.org/w/index.php?title=Special:CreateAccount&returnto=Green+Park+Stadium,,1,0,1,6e-06,31
en.wikipedia.org/w/index.php?title=Special:UserLogin&returnto=Green+Park+Stadium,,1,0,1,6e-06,31
as.wikipedia.org/wiki/গ্ৰীণ_পাৰ্ক_ষ্টেডিয়াম,,1,0,1,6e-06,31
bn.wikipedia.org/wiki/গ্রিন_পার্ক_স্টেডিয়াম,,1,0,1,6e-06,31
de.wikipedia.org/wiki/Green_Park_Stadium,,1,0,1,6e-06,31
hi.wikipedia.org/wiki/ग्रीन_पार्क_स्टेडियम,,1,0,1,6e-06,31
ml.wikipedia.org/wiki/ഗ്രീൻ_പാർക്ക്_സ്റ്റേഡിയം,,1,0,1,6e-06,31
mr.wikipedia.org/wiki/ग्रीन_पार्क,,1,0,1,6e-06,31
pnb.wikipedia.org/wiki/گرین_پارک_اسٹیڈیم,,1,0,1,6e-06,31
ta.wikipedia.org/wiki/கிரீன்பார்க்_துடுப்பாட்ட_அரங்கம்,,1,0,1,6e-06,31
te.wikipedia.org/wiki/గ్రీన్_పార్క్_స్టేడియం,,1,0,1,6e-06,31
ur.wikipedia.org/wiki/گرین_پارک_اسٹیڈیم,,1,0,1,6e-06,31
wikidata.org/wiki/Special:EntityPage/Q5602959,,1,0,1,6e-06,31
en.wikipedia.org/wiki/Talk:Green_Park_Stadium,,1,0,1,6e-06,31
en.wikipedia.org/w/index.php?title=Green_Park_Stadium&action=edit,,1,0,1,6e-06,31
en.wikipedia.org/w/index.php?title=Green_Park_Stadium&action=history,,1,0,1,6e-06,31
en.wikipedia.org/wiki/Special:WhatLinksHere/Green_Park_Stadium,,1,0,1,6e-06,31
en.wikipedia.org/wiki/Special:RecentChangesLinked/Green_Park_Stadium,,1,0,1,6e-06,31
en.wikipedia.org/w/index.php?title=Green_Park_Stadium&oldid=1309122901,,1,0,1,6e-06,31
en.wikipedia.org/w/index.php?title=Green_Park_Stadium&action=info,,1,0,1,6e-06,31
en.wikipedia.org/w/index.php?title=Green_Park_Stadium&printable=yes,,1,0,1,6e-06,31
commons.wikimedia.org/wiki/Category:Green_Park_Stadium,,1,0,1,6e-06,31
en.wikipedia.org/wiki/Special:EditPage/Green_Park_Stadium,,1,0,1,6e-06,31
en.wikipedia.org/wiki/Template:Infobox_cricket_ground,,1,0,1,6e-06,31
en.wikipedia.org/wiki/Wikipedia:Templates_for_discussion/Log/2025_September_3,,2,0,2,6e-06,31
en.wikipedia.org/wiki/India_women%27s_national_cricket_team,,1,0,1,6e-06,31
en.wikipedia.org/wiki/Gujarat_Titans,,2,0,2,6e-06,31
en.wikipedia.org/wiki/Gujarat_Lions,,1,0,1,6e-06,31
en.wikipedia.org/wiki/England_cricket_team,,1,0,1,6e-06,31
en.wikipedia.org/wiki/Bangladesh_national_cricket_team,,1,0,1,6e-06,31
en.wikipedia.org/wiki/Sri_Lanka_national_cricket_team,,1,0,1,6e-06,31
en.wikipedia.org/wiki/New_Zealand_national_cricket_team,,1,0,1,6e-06,31
espncricinfo.com/ci/content/ground/58204.html,,1,0,1,6e-06,31
en.wikipedia.org/wiki/Test_cricket,,1,0,1,6e-06,31
en.wikipedia.org/wiki/One_Day_International,,1,0,1,6e-06,31
en.wikipedia.org/wiki/Twenty20_International,,1,0,1,6e-06,31
en.wikipedia.org/wiki/Ganga_river,,2,0,2,6e-06,31
en.wikipedia.org/wiki/Bob_Woolmer,,1,0,1,6e-06,31
en.wikipedia.org/w/index.php?title=Green_Park_Stadium&action=edit&section=1,,1,0,1,6e-06,31
en.wikipedia.org/wiki/West_Indies_cricket_team,,1,0,1,6e-06,31
en.wikipedia.org/w/index.php?title=Green_Park_Stadium&action=edit&section=2,,1,0,1,6e-06,31
en.wikipedia.org/wiki/File:Kanpur_pitch.jpg,,1,0,1,6e-06,31
en.wikipedia.org/w/index.php?title=Green_Park_Stadium&action=edit&section=3,,1,0,1,6e-06,31
en.wikipedia.org/wiki/1987_Cricket_World_Cup_Group_B,,1,0,1,6e-06,31
en.wikipedia.org/wiki/Nehru_Cup_(cricket),,1,0,1,6e-06,31
en.wikipedia.org/wiki/1993_Hero_Cup,,1,0,1,6e-06,31
en.wikipedia.org/wiki/Wills_world_series_1994–95,,1,0,1,6e-06,31
en.wikipedia.org/wiki/Zimbabwe_national_cricket_team,,1,0,1,6e-06,31
en.wikipedia.org/wiki/Day/night_cricket,,1,0,1,6e-06,31
en.wikipedia.org/wiki/Rohit_Sharma,,1,0,1,6e-06,31
en.wikipedia.org/wiki/Shreyas_Iyer,,1,0,1,6e-06,31
en.wikipedia.org/w/index.php?title=Green_Park_Stadium&action=edit&section=4,,1,0,1,6e-06,31
en.wikipedia.org/wiki/File:Kanpur_green_park.jpg,,1,0,1,6e-06,31
en.wikipedia.org/wiki/File:Green_Park_Stadium_during_an_IPL_match_(1).jpg,,1,0,1,6e-06,31
en.wikipedia.org/wiki/File:Green_Park_Stadium_during_an_IPL_match_(2).jpg,,1,0,1,6e-06,31
en.wikipedia.org/wiki/File:England_Vs_India_T20_match_practice_session_at_Green_Park_Stadium.jpg,,1,0,1,6e-06,31
en.wikipedia.org/wiki/File:England_Vs_India_T20_match_at_Green_Park_Stadium_(2).jpg,,1,0,1,6e-06,31
en.wikipedia.org/wiki/File:Mahendra_Shukla_-_Green_Park.jpg,,1,0,1,6e-06,31
en.wikipedia.org/wiki/File:Green_Park_Stadium_Kanpur.jpg,,1,0,1,6e-06,31
en.wikipedia.org/w/index.php?title=Green_Park_Stadium&action=edit&section=5,,1,0,1,6e-06,31
en.wikipedia.org/wiki/List_of_international_cricket_centuries_at_the_Green_Park_Stadium,,1,0,1,6e-06,31
en.wikipedia.org/wiki/List_of_Test_cricket_grounds,,1,0,1,6e-06,31
en.wikipedia.org/w/index.php?title=Green_Park_Stadium&action=edit&section=6,,1,0,1,6e-06,31
kanpurnagar.nic.in/tourist-place/green-park/,,1,0,1,6e-06,31
matchpredictions.in/green-park-kanpur-tickets-prediction-highlights-schedule/,,1,0,1,6e-06,31
m.jagran.com/local/uttar-pradesh_kanpur-city-news-hindi.html,,1,0,1,6e-06,31
rediff.com/cricket/2008/apr/10biks.htm,,1,0,1,6e-06,31
en.wikipedia.org/wiki/Template:Cricket_grounds_in_India,,1,0,1,6e-06,31
en.wikipedia.org/wiki/Template_talk:Cricket_grounds_in_India,,1,0,1,6e-06,31
en.wikipedia.org/wiki/Special:EditPage/Template:Cricket_grounds_in_India,,1,0,1,6e-06,31
en.wikipedia.org/wiki/List_of_international_cricket_grounds_in_India,,1,0,1,6e-06,31
en.wikipedia.org/wiki/Holkar_Stadium,,1,0,1,6e-06,31
en.wikipedia.org/wiki/Madhavrao_Scindia_Cricket_Stadium,,1,0,1,6e-06,31
en.wikipedia.org/wiki/Shaheed_Veer_Narayan_Singh_International_Cricket_Stadium,,1,0,1,6e-06,31
en.wikipedia.org/wiki/Barabati_Stadium,,1,0,1,6e-06,31
en.wikipedia.org/wiki/Cuttack,,2,0,2,6e-06,31
en.wikipedia.org/wiki/Eden_Gardens,,1,0,1,6e-06,31
en.wikipedia.org/wiki/JSCA_International_Stadium_Complex,,1,0,1,6e-06,31
en.wikipedia.org/wiki/Arun_Jaitley_Cricket_Stadium,,1,0,1,6e-06,31
en.wikipedia.org/wiki/Himachal_Pradesh_Cricket_Association_Stadium,,1,0,1,6e-06,31
en.wikipedia.org/wiki/Punjab_Cricket_Association_IS_Bindra_Stadium,,1,0,1,6e-06,31
en.wikipedia.org/wiki/Sawai_Mansingh_Stadium,,1,0,1,6e-06,31
en.wikipedia.org/wiki/North_East_India,,1,0,1,6e-06,31
"en.wikipedia.org/wiki/Assam_Cricket_Association_Stadium,_Guwahati",,1,0,1,6e-06,31
en.wikipedia.org/wiki/ACA–VDCA_Cricket_Stadium,,1,0,1,6e-06,31
en.wikipedia.org/wiki/M._Chinnaswamy_Stadium,,2,0,2,6e-06,31
en.wikipedia.org/wiki/Greenfield_International_Stadium,,1,0,1,6e-06,31
en.wikipedia.org/wiki/West_India,,1,0,1,6e-06,31
en.wikipedia.org/wiki/Brabourne_Stadium,,1,0,1,6e-06,31
en.wikipedia.org/wiki/DY_Patil_Stadium,,1,0,1,6e-06,31
en.wikipedia.org/wiki/IPCL_Sports_Complex_Ground,,1,0,1,6e-06,31
en.wikipedia.org/wiki/Lalabhai_Contractor_Stadium,,1,0,1,6e-06,31
en.wikipedia.org/wiki/Maharashtra_Cricket_Association_Stadium,,1,0,1,6e-06,31
en.wikipedia.org/wiki/Narendra_Modi_Stadium,,2,0,2,6e-06,31
en.wikipedia.org/wiki/Saurashtra_Cricket_Association_Stadium,,1,0,1,6e-06,31
en.wikipedia.org/wiki/Vidarbha_Cricket_Association_Stadium,,1,0,1,6e-06,31
en.wikipedia.org/wiki/Wankhede_Stadium,,1,0,1,6e-06,31
en.wikipedia.org/wiki/Template:Test_cricket_grounds_in_India,,1,0,1,6e-06,31
en.wikipedia.org/wiki/Template_talk:Test_cricket_grounds_in_India,,1,0,1,6e-06,31
en.wikipedia.org/wiki/Special:EditPage/Template:Test_cricket_grounds_in_India,,1,0,1,6e-06,31
en.wikipedia.org/wiki/I._S._Bindra_Stadium,,1,0,1,6e-06,31
en.wikipedia.org/wiki/Niranjan_Shah_Stadium,,1,0,1,6e-06,31
en.wikipedia.org/wiki/Bombay_Gymkhana,,1,0,1,6e-06,31
"en.wikipedia.org/wiki/Nehru_Stadium,_Chennai",,1,0,1,6e-06,31
en.wikipedia.org/wiki/Vidarbha_Cricket_Association_Ground,,1,0,1,6e-06,31
en.wikipedia.org/wiki/Gandhi_Stadium,,1,0,1,6e-06,31
en.wikipedia.org/wiki/Sector_16_Stadium,,1,0,1,6e-06,31
en.wikipedia.org/wiki/Category:Sports_venues_in_Uttar_Pradesh,,2,0,2,6e-06,31
en.wikipedia.org/wiki/Category:Multi-purpose_stadiums_in_India,,2,0,2,6e-06,31
en.wikipedia.org/wiki/Category:Test_cricket_grounds_in_India,,1,0,1,6e-06,31
en.wikipedia.org/wiki/Category:Sport_in_Kanpur,,2,0,2,6e-06,31
en.wikipedia.org/wiki/Category:1945_establishments_in_India,,1,0,1,6e-06,31
en.wikipedia.org/wiki/Category:Sports_venues_completed_in_1945,,1,0,1,6e-06,31
en.wikipedia.org/wiki/Category:Wikipedia_articles_needing_copy_edit_from_November_2024,,1,0,1,6e-06,31
en.wikipedia.org/wiki/Category:All_Wikipedia_articles_needing_copy_edit,,1,0,1,6e-06,31
en.m.wikipedia.org/w/index.php?title=Green_Park_Stadium&mobileaction=toggle_view_mobile,,1,0,1,6e-06,31
upload.wikimedia.org/wikipedia/commons/thumb/5/52/Acap.svg/40px-Acap.svg.png,,1,0,1,6e-06,31
upload.wikimedia.org/wikipedia/en/thumb/b/be/Flag_of_England.svg/40px-Flag_of_England.svg.png,,1,0,1,6e-06,31
upload.wikimedia.org/wikipedia/commons/thumb/3/3c/Kanpur_pitch.jpg/250px-Kanpur_pitch.jpg,,1,0,1,6e-06,31
upload.wikimedia.org/wikipedia/commons/thumb/c/cc/Kanpur_green_park.jpg/500px-Kanpur_green_park.jpg,,1,0,1,6e-06,31
en.wikipedia.org/w/index.php?title=Special:CreateAccount&returnto=Howrah–New+Delhi+main+line,,1,0,1,6e-06,31
en.wikipedia.org/w/index.php?title=Special:UserLogin&returnto=Howrah–New+Delhi+main+line,,1,0,1,6e-06,31
bn.wikipedia.org/wiki/হাওড়া–দিল্লি_প্রধান_লাইন,,1,0,1,6e-06,31
bh.wikipedia.org/wiki/हवड़ा-दिल्ली_प्रधान_रेलपथ,,1,0,1,6e-06,31
fr.wikipedia.org/wiki/Ligne_de_Howrah_à_Delhi,,1,0,1,6e-06,31
hi.wikipedia.org/wiki/हावड़ा-दिल्ली_मुख्य_लाइन,,1,0,1,6e-06,31
mr.wikipedia.org/wiki/हावडा–नवी_दिल्ली_मुख्य_रेल्वेमार्ग,,1,0,1,6e-06,31
sat.wikipedia.org/wiki/ᱦᱟᱣᱲᱟ-ᱱᱟᱶᱟ_ᱫᱤᱞᱞᱤ_ᱢᱩᱬ_ᱞᱟᱭᱤᱱ,,1,0,1,6e-06,31
ta.wikipedia.org/wiki/ஹவுரா_-_தில்லி_முதன்மை_வழித்தடம்,,1,0,1,6e-06,31
wikidata.org/wiki/Special:EntityPage/Q17065278,,1,0,1,6e-06,31
en.wikipedia.org/wiki/Howrah–New_Delhi_main_line,,1,0,1,6e-06,31
en.wikipedia.org/wiki/Talk:Howrah–New_Delhi_main_line,,1,0,1,6e-06,31
en.wikipedia.org/w/index.php?title=Howrah–New_Delhi_main_line&action=edit,,1,0,1,6e-06,31
en.wikipedia.org/w/index.php?title=Howrah–New_Delhi_main_line&action=history,,1,0,1,6e-06,31
en.wikipedia.org/wiki/Special:WhatLinksHere/Howrah–New_Delhi_main_line,,1,0,1,6e-06,31
en.wikipedia.org/wiki/Special:RecentChangesLinked/Howrah–New_Delhi_main_line,,1,0,1,6e-06,31
en.wikipedia.org/w/index.php?title=Howrah–New_Delhi_main_line&oldid=1309246438,,1,0,1,6e-06,31
en.wikipedia.org/w/index.php?title=Howrah–New_Delhi_main_line&action=info,,1,0,1,6e-06,31
en.wikipedia.org/w/index.php?title=Howrah–New_Delhi_main_line&printable=yes,,1,0,1,6e-06,31
commons.wikimedia.org/wiki/Category:Howrah–Delhi_main_line,,1,0,1,6e-06,31
en.wikipedia.org/wiki/File:Lal_Quila_Express_(Kolkata_-_Delhi)_Route_map.png,,1,0,1,6e-06,31
en.wikipedia.org/wiki/5_ft_6_in_gauge_railway,,3,0,3,6e-06,31
en.wikipedia.org/wiki/25_kV_AC_railway_electrification,,3,0,3,6e-06,31
en.wikipedia.org/wiki/Overhead_line,,3,0,3,6e-06,31
en.wikipedia.org/wiki/Template:Howrah–Delhi_main_line,,1,0,1,6e-06,31
en.wikipedia.org/wiki/Template_talk:Howrah–Delhi_main_line,,1,0,1,6e-06,31
en.wikipedia.org/wiki/Special:EditPage/Template:Howrah–Delhi_main_line,,1,0,1,6e-06,31
en.wikipedia.org/wiki/Mughalsarai–Kanpur_section,,4,0,4,7e-06,31
en.wikipedia.org/wiki/Allahabad_Junction_railway_station,,1,0,1,6e-06,31
en.wikipedia.org/wiki/Howrah–Allahabad–Mumbai_line,,1,0,1,6e-06,31
en.wikipedia.org/wiki/Mughalsarai_Junction_railway_station,,1,0,1,6e-06,31
en.wikipedia.org/wiki/Patna–Mughalsarai_section,,1,0,1,6e-06,31
en.wikipedia.org/wiki/Buxar_railway_station,,1,0,1,6e-06,31
en.wikipedia.org/wiki/Ara_Junction_railway_station,,1,0,1,6e-06,31
en.wikipedia.org/wiki/Patna–Gaya_line,,1,0,1,6e-06,31
en.wikipedia.org/wiki/Asansol–Patna_section,,1,0,1,6e-06,31
en.wikipedia.org/wiki/Bakhtiyarpur_Junction_railway_station,,1,0,1,6e-06,31
en.wikipedia.org/wiki/Bakhtiyarpur–Tilaiya_line,,1,0,1,6e-06,31
en.wikipedia.org/wiki/Barh_railway_station,,1,0,1,6e-06,31
en.wikipedia.org/wiki/Mokama_Junction_railway_station,,1,0,1,6e-06,31
en.wikipedia.org/wiki/Mokama–Barauni_section,,1,0,1,6e-06,31
en.wikipedia.org/wiki/Gaya–Kiul_line,,1,0,1,6e-06,31
en.wikipedia.org/wiki/Kiul_Junction_railway_station,,1,0,1,6e-06,31
en.wikipedia.org/wiki/Sahibganj_loop,,1,0,1,6e-06,31
en.wikipedia.org/wiki/Jamui_railway_station,,1,0,1,6e-06,31
en.wikipedia.org/wiki/Jhajha_railway_station,,1,0,1,6e-06,31
en.wikipedia.org/wiki/Jasidih_Junction_railway_station,,1,0,1,6e-06,31
en.wikipedia.org/wiki/Jasidih–Dumka–Rampurhat_line,,1,0,1,6e-06,31
en.wikipedia.org/wiki/Madhupur–Giridih–Koderma_line,,1,0,1,6e-06,31
en.wikipedia.org/wiki/Madhupur_Junction_railway_station,,1,0,1,6e-06,31
en.wikipedia.org/wiki/Chittaranjan_railway_station,,1,0,1,6e-06,31
en.wikipedia.org/wiki/Barddhaman_Junction_railway_station,,1,0,1,6e-06,31
en.wikipedia.org/wiki/Howrah–Bardhaman_chord,,1,0,1,6e-06,31
en.wikipedia.org/wiki/Howrah_Junction_railway_station,,1,0,1,6e-06,31
en.wikipedia.org/w/index.php?title=Howrah–New_Delhi_main_line&action=edit&section=1,,1,0,1,6e-06,31
en.wikipedia.org/w/index.php?title=Howrah–New_Delhi_main_line&action=edit&section=2,,1,0,1,6e-06,31
en.wikipedia.org/w/index.php?title=Howrah–New_Delhi_main_line&action=edit&section=3,,1,0,1,6e-06,31
en.wikipedia.org/wiki/Stockton_and_Darlington_Railway,,1,0,1,6e-06,31
en.wikipedia.org/wiki/File:First_Train_of_East_Indian_Railway-1854.jpg,,1,0,1,6e-06,31
en.wikipedia.org/wiki/Raniganj,,2,0,2,6e-06,31
"en.wikipedia.org/wiki/Jamalpur,_Munger",,1,0,1,6e-06,31
"en.wikipedia.org/wiki/Ghaziabad,_India",,1,0,1,6e-06,31
en.wikipedia.org/w/index.php?title=Howrah–New_Delhi_main_line&action=edit&section=4,,1,0,1,6e-06,31
en.wikipedia.org/wiki/Sitarampur,,1,0,1,6e-06,31
en.wikipedia.org/w/index.php?title=Howrah–New_Delhi_main_line&action=edit&section=5,,1,0,1,6e-06,31
en.wikipedia.org/w/index.php?title=Howrah–New_Delhi_main_line&action=edit&section=6,,1,0,1,6e-06,31
en.wikipedia.org/wiki/Bengal_Nagpur_Railway,,1,0,1,6e-06,31
en.wikipedia.org/wiki/South_Eastern_Railway_zone,,1,0,1,6e-06,31
en.wikipedia.org/w/index.php?title=Howrah–New_Delhi_main_line&action=edit&section=7,,1,0,1,6e-06,31
en.wikipedia.org/wiki/Howrah–Bardhaman_main_line,,1,0,1,6e-06,31
en.wikipedia.org/w/index.php?title=Howrah–New_Delhi_main_line&action=edit&section=8,,1,0,1,6e-06,31
en.wikipedia.org/wiki/Poorva_Express,,1,0,1,6e-06,31
en.wikipedia.org/w/index.php?title=Howrah–New_Delhi_main_line&action=edit&section=9,,1,0,1,6e-06,31
en.wikipedia.org/wiki/Howrah–New_Delhi_Rajdhani_Express_(via_Patna),,1,0,1,6e-06,31
en.wikipedia.org/wiki/Rajendra_Nagar-New_Delhi_Tejas_Rajdhani_Express,,1,0,1,6e-06,31
en.wikipedia.org/wiki/Sampoorna_Kranti_Express,,1,0,1,6e-06,31
en.wikipedia.org/wiki/Howrah–New_Delhi_Duronto_Express,,1,0,1,6e-06,31
en.wikipedia.org/wiki/Howrah-Amritsar_Express,,1,0,1,6e-06,31
en.wikipedia.org/wiki/High-speed_rail_in_India,,1,0,1,6e-06,31
en.wikipedia.org/wiki/Duronto_Express,,1,0,1,6e-06,31
en.wikipedia.org/w/index.php?title=Howrah–New_Delhi_main_line&action=edit&section=10,,1,0,1,6e-06,31
indiarailinfo.com/train/poorva-express-via-patna-12304-ndls-to-hwh/1254/664/1,,1,0,1,6e-06,31
india9.com/i9show/Howrah-New-Delhi-Rajdhani-Express-51279.htm,,1,0,1,6e-06,31
web.archive.org/web/20080316015721/http://www.irfca.org/~mrinal/chronology.html,,1,0,1,6e-06,31
irfca.org/~mrinal/chronology.html,,1,0,1,6e-06,31
irfca.org/faq/faq-history5.html,,1,0,1,6e-06,31
irfca.org/faq/faq-pway.html,,1,0,1,6e-06,31
indiamike.com/india/indian-railways-f10/train-from-delhi-to-howrah-calcutta-t21355/,,1,0,1,6e-06,31
en.wikipedia.org/wiki/Template:Indian_Railways,,1,0,1,6e-06,31
en.wikipedia.org/wiki/Template_talk:Indian_Railways,,1,0,1,6e-06,31
en.wikipedia.org/wiki/Special:EditPage/Template:Indian_Railways,,1,0,1,6e-06,31
en.wikipedia.org/wiki/Indian_Railways_organisational_structure,,1,0,1,6e-06,31
en.wikipedia.org/wiki/Rail_Bhavan,,1,0,1,6e-06,31
en.wikipedia.org/wiki/Chairperson_of_the_Railway_Board,,1,0,1,6e-06,31
en.wikipedia.org/wiki/Central_Organisation_for_Modernisation_of_Workshops,,1,0,1,6e-06,31
en.wikipedia.org/wiki/Central_Organisation_for_Railway_Electrification,,1,0,1,6e-06,31
en.wikipedia.org/wiki/Centre_for_Railway_Information_Systems,,1,0,1,6e-06,31
en.wikipedia.org/wiki/Commission_of_Railway_Safety,,1,0,1,6e-06,31
en.wikipedia.org/wiki/Dedicated_Freight_Corridor_Corporation_of_India,,1,0,1,6e-06,31
en.wikipedia.org/wiki/High_Speed_Rail_Corporation_of_India_Limited,,1,0,1,6e-06,31
en.wikipedia.org/wiki/Indian_Railway_Stations_Development_Corporation,,1,0,1,6e-06,31
en.wikipedia.org/wiki/Konkan_Railway_Corporation,,1,0,1,6e-06,31
en.wikipedia.org/wiki/Mumbai_Railway_Vikas_Corporation,,1,0,1,6e-06,31
en.wikipedia.org/wiki/National_High_Speed_Rail_Corporation_Limited,,1,0,1,6e-06,31
en.wikipedia.org/wiki/Passenger_Amenities_Committee,,1,0,1,6e-06,31
en.wikipedia.org/wiki/Rail_Land_Development_Authority,,1,0,1,6e-06,31
en.wikipedia.org/wiki/RailTel,,1,0,1,6e-06,31
en.wikipedia.org/wiki/Railway_Recruitment_Control_Board,,1,0,1,6e-06,31
en.wikipedia.org/wiki/Railways_Sports_Promotion_Board,,1,0,1,6e-06,31
en.wikipedia.org/wiki/Research_Design_and_Standards_Organisation,,1,0,1,6e-06,31
en.wikipedia.org/wiki/Zones_and_divisions_of_Indian_Railways,,1,0,1,6e-06,31
en.wikipedia.org/wiki/East_Coast_Railway_zone,,1,0,1,6e-06,31
"en.wikipedia.org/wiki/Metro_Railway,_Kolkata",,1,0,1,6e-06,31
en.wikipedia.org/wiki/North_Western_Railway_zone,,3,0,3,6e-06,31
en.wikipedia.org/wiki/Northeast_Frontier_Railway_zone,,1,0,1,6e-06,31
en.wikipedia.org/wiki/South_Coast_Railway_zone,,1,0,1,6e-06,31
en.wikipedia.org/wiki/South_East_Central_Railway_zone,,1,0,1,6e-06,31
en.wikipedia.org/wiki/South_Western_Railway_zone,,1,0,1,6e-06,31
en.wikipedia.org/wiki/Southern_Railway_zone,,1,0,1,6e-06,31
en.wikipedia.org/wiki/West_Central_Railway_zone,,1,0,1,6e-06,31
en.wikipedia.org/wiki/Category:Rolling_stock_of_India,,1,0,1,6e-06,31
en.wikipedia.org/wiki/Indian_Railways_coaching_stock,,1,0,1,6e-06,31
en.wikipedia.org/wiki/ICF_coach,,1,0,1,6e-06,31
en.wikipedia.org/wiki/LHB_coach,,1,0,1,6e-06,31
en.wikipedia.org/wiki/Tejas-Rajdhani_Express,,1,0,1,6e-06,31
en.wikipedia.org/wiki/Amrit_Bharat_(trainset),,1,0,1,6e-06,31
en.wikipedia.org/wiki/Namo_Bharat_Rapid_Rail,,1,0,1,6e-06,31
en.wikipedia.org/wiki/Multiple_units_of_India,,1,0,1,6e-06,31
en.wikipedia.org/wiki/E5_and_H5_Series_Shinkansen,,1,0,1,6e-06,31
en.wikipedia.org/wiki/Vande_Bharat_(trainset),,1,0,1,6e-06,31
en.wikipedia.org/wiki/Vande_Bharat_(sleeper_trainset),,1,0,1,6e-06,31
en.wikipedia.org/wiki/Wagon_numbering_system_in_India,,1,0,1,6e-06,31
en.wikipedia.org/wiki/Category:Rolling_stock_manufacturers_of_India,,1,0,1,6e-06,31
en.wikipedia.org/wiki/Banaras_Locomotive_Works,,3,0,3,6e-06,31
en.wikipedia.org/wiki/BEML_Limited,,1,0,1,6e-06,31
en.wikipedia.org/wiki/Bharat_Wagon_and_Engineering,,1,0,1,6e-06,31
en.wikipedia.org/wiki/Braithwaite_%26_Co.,,1,0,1,6e-06,31
en.wikipedia.org/wiki/Burn_Standard_Company,,1,0,1,6e-06,31
en.wikipedia.org/wiki/Chittaranjan_Locomotive_Works,,1,0,1,6e-06,31
"en.wikipedia.org/wiki/Diesel_Locomotive_Factory,_Marhowrah",,1,0,1,6e-06,31
"en.wikipedia.org/wiki/Electric_Locomotive_Factory,_Madhepura",,1,0,1,6e-06,31
en.wikipedia.org/wiki/Latur_railway_station,,1,0,1,6e-06,31
"en.wikipedia.org/wiki/Modern_Coach_Factory,_Raebareli",,3,0,3,6e-06,31
en.wikipedia.org/wiki/Patiala_Locomotive_Works,,1,0,1,6e-06,31
"en.wikipedia.org/wiki/Rail_Coach_Factory,_Kapurthala",,3,0,3,6e-06,31
en.wikipedia.org/wiki/Rail_Wheel_Factory,,1,0,1,6e-06,31
"en.wikipedia.org/wiki/Rail_Wheel_Plant,_Bela",,1,0,1,6e-06,31
en.wikipedia.org/wiki/Titagarh_Wagons,,1,0,1,6e-06,31
en.wikipedia.org/wiki/Category:Railway_depots_in_India,,1,0,1,6e-06,31
en.wikipedia.org/wiki/Diesel_locomotive,,1,0,1,6e-06,31
"en.wikipedia.org/wiki/Diesel_Loco_Shed,_Abu_Road",,1,0,1,6e-06,31
"en.wikipedia.org/wiki/Diesel_Loco_Shed,_Alambagh",,1,0,1,6e-06,31
"en.wikipedia.org/wiki/Diesel_Loco_Shed,_Andal",,1,0,1,6e-06,31
"en.wikipedia.org/wiki/Diesel_Loco_Shed,_Bandra",,1,0,1,6e-06,31
"en.wikipedia.org/wiki/Diesel_Loco_Shed,_Bardhaman",,1,0,1,6e-06,31
"en.wikipedia.org/wiki/Diesel_Loco_Shed,_Bhagat_Ki_Kothi",,1,0,1,6e-06,31
"en.wikipedia.org/wiki/Diesel_Loco_Shed,_Bondamunda",,1,0,1,6e-06,31
"en.wikipedia.org/wiki/Diesel_Loco_Shed,_Coonoor",,1,0,1,6e-06,31
"en.wikipedia.org/wiki/Diesel_Loco_Shed,_Ernakulam",,1,0,1,6e-06,31
"en.wikipedia.org/wiki/Diesel_Loco_Shed,_Erode",,1,0,1,6e-06,31
"en.wikipedia.org/wiki/Diesel_Loco_Shed,_Gandhidham",,1,0,1,6e-06,31
"en.wikipedia.org/wiki/Diesel_Loco_Shed,_Golden_Rock",,1,0,1,6e-06,31
"en.wikipedia.org/wiki/Diesel_Loco_Shed,_Gonda",,1,0,1,6e-06,31
"en.wikipedia.org/wiki/Diesel_Loco_Shed,_Gooty",,1,0,1,6e-06,31
"en.wikipedia.org/wiki/Diesel_Loco_Shed,_Guntakal",,1,0,1,6e-06,31
"en.wikipedia.org/wiki/Diesel_Loco_Shed,_Howrah",,1,0,1,6e-06,31
"en.wikipedia.org/wiki/Diesel_Loco_Shed,_Hubli",,1,0,1,6e-06,31
"en.wikipedia.org/wiki/Diesel_Loco_Shed,_Itarsi",,1,0,1,6e-06,31
"en.wikipedia.org/wiki/Diesel_Loco_Shed,_Izzatnagar",,1,0,1,6e-06,31
"en.wikipedia.org/wiki/Diesel_Loco_Shed,_Jamalpur",,1,0,1,6e-06,31
"en.wikipedia.org/wiki/Diesel_Loco_Shed,_Jhansi",,1,0,1,6e-06,31
"en.wikipedia.org/wiki/Diesel_Loco_Shed,_Kalka",,1,0,1,6e-06,31
"en.wikipedia.org/wiki/Diesel_Loco_Shed,_Kalyan",,1,0,1,6e-06,31
"en.wikipedia.org/wiki/Diesel_Loco_Shed,_Kazipet",,1,0,1,6e-06,31
"en.wikipedia.org/wiki/Diesel_Loco_Shed,_Kharagpur",,1,0,1,6e-06,31
"en.wikipedia.org/wiki/Diesel_Loco_Shed,_Krishnarajapuram",,1,0,1,6e-06,31
"en.wikipedia.org/wiki/Diesel_Loco_Shed,_Kurla",,1,0,1,6e-06,31
"en.wikipedia.org/wiki/Diesel_Loco_Shed,_Ludhiana",,1,0,1,6e-06,31
"en.wikipedia.org/wiki/Diesel_Loco_Shed,_Lumding",,1,0,1,6e-06,31
"en.wikipedia.org/wiki/Diesel_Loco_Shed,_Malda_Town",,1,0,1,6e-06,31
"en.wikipedia.org/wiki/Diesel_Loco_Shed,_Maula_Ali",,1,0,1,6e-06,31
"en.wikipedia.org/wiki/Diesel_Loco_Shed,_Mhow",,1,0,1,6e-06,31
"en.wikipedia.org/wiki/Diesel_Loco_Shed,_Motibagh",,1,0,1,6e-06,31
"en.wikipedia.org/wiki/Diesel_Loco_Shed,_Mughalsarai",,1,0,1,6e-06,31
"en.wikipedia.org/wiki/Diesel_Loco_Shed,_New_Guwahati_City",,1,0,1,6e-06,31
"en.wikipedia.org/wiki/Diesel_Loco_Shed,_New_Katni_Junction",,1,0,1,6e-06,31
"en.wikipedia.org/wiki/Diesel_Loco_Shed,_Patratu",,1,0,1,6e-06,31
"en.wikipedia.org/wiki/Diesel_Loco_Shed,_Pratapnagar",,1,0,1,6e-06,31
"en.wikipedia.org/wiki/Diesel_Loco_Shed,_Pune",,1,0,1,6e-06,31
"en.wikipedia.org/wiki/Diesel_Loco_Shed,_Raipur",,1,0,1,6e-06,31
"en.wikipedia.org/wiki/Diesel_Loco_Shed,_Ratlam",,1,0,1,6e-06,31
"en.wikipedia.org/wiki/Diesel_Loco_Shed,_Sabarmati",,1,0,1,6e-06,31
"en.wikipedia.org/wiki/Diesel_Loco_Shed,_Samastipur",,1,0,1,6e-06,31
"en.wikipedia.org/wiki/Diesel_Loco_Shed,_Shakurbasti",,1,0,1,6e-06,31
"en.wikipedia.org/wiki/Diesel_Loco_Shed,_Siliguri",,1,0,1,6e-06,31
"en.wikipedia.org/wiki/Diesel_Loco_Shed,_Tondiarpet",,1,0,1,6e-06,31
"en.wikipedia.org/wiki/Diesel_Loco_Shed,_Tughlakabad",,1,0,1,6e-06,31
"en.wikipedia.org/wiki/Diesel_Loco_Shed,_Vatva",,1,0,1,6e-06,31
"en.wikipedia.org/wiki/Diesel_Loco_Shed,_Vijayawada",,1,0,1,6e-06,31
"en.wikipedia.org/wiki/Diesel_Loco_Shed,_Visakhapatnam",,1,0,1,6e-06,31
en.wikipedia.org/wiki/Electric_locomotive,,1,0,1,6e-06,31
"en.wikipedia.org/wiki/Electric_Loco_Shed,_Ajni",,1,0,1,6e-06,31
"en.wikipedia.org/wiki/Electric_Loco_Shed,_Angul",,1,0,1,6e-06,31
"en.wikipedia.org/wiki/Electric_Loco_Shed,_Arakkonam",,1,0,1,6e-06,31
"en.wikipedia.org/wiki/Electric_Loco_Shed,_Asansol",,1,0,1,6e-06,31
"en.wikipedia.org/wiki/Electric_Loco_Shed,_Barauni",,1,0,1,6e-06,31
"en.wikipedia.org/wiki/Electric_Loco_Shed,_Bhilai",,1,0,1,6e-06,31
"en.wikipedia.org/wiki/Electric_Loco_Shed,_Bhusawal",,1,0,1,6e-06,31
"en.wikipedia.org/wiki/Electric_Loco_Shed,_Bilaspur",,1,0,1,6e-06,31
"en.wikipedia.org/wiki/Electric_Loco_Shed,_Bokaro_Steel_City",,1,0,1,6e-06,31
"en.wikipedia.org/wiki/Electric_Loco_Shed,_Bondamunda",,1,0,1,6e-06,31
"en.wikipedia.org/wiki/Electric_Loco_Shed,_Erode",,1,0,1,6e-06,31
"en.wikipedia.org/wiki/Electric_Loco_Shed,_Ghaziabad",,1,0,1,6e-06,31
"en.wikipedia.org/wiki/Electric_Loco_Shed,_Gomoh",,1,0,1,6e-06,31
"en.wikipedia.org/wiki/Electric_Loco_Shed,_Gorakhpur",,1,0,1,6e-06,31
"en.wikipedia.org/wiki/Electric_Loco_Shed,_Guntakal",,1,0,1,6e-06,31
"en.wikipedia.org/wiki/Electric_Loco_Shed,_Howrah",,1,0,1,6e-06,31
"en.wikipedia.org/wiki/Electric_Loco_Shed,_Ispat_Nagar",,1,0,1,6e-06,31
"en.wikipedia.org/wiki/Electric_Loco_Shed,_Itarsi",,1,0,1,6e-06,31
"en.wikipedia.org/wiki/Electric_Loco_Shed,_Jhansi",,1,0,1,6e-06,31
"en.wikipedia.org/wiki/Electric_Loco_Shed,_Kalyan",,1,0,1,6e-06,31
"en.wikipedia.org/wiki/Electric_Loco_Shed,_Kazipet",,1,0,1,6e-06,31
"en.wikipedia.org/wiki/Electric_Loco_Shed,_Khanalampura",,1,0,1,6e-06,31
"en.wikipedia.org/wiki/Electric_Loco_Shed,_Lallaguda",,1,0,1,6e-06,31
"en.wikipedia.org/wiki/Electric_Loco_Shed,_Ludhiana",,1,0,1,6e-06,31
"en.wikipedia.org/wiki/Electric_Loco_Shed,_Mughalsarai",,1,0,1,6e-06,31
"en.wikipedia.org/wiki/Electric_Loco_Shed,_Nagpur",,1,0,1,6e-06,31
"en.wikipedia.org/wiki/Electric_Loco_Shed,_New_Katni_Junction",,1,0,1,6e-06,31
"en.wikipedia.org/wiki/Electric_Loco_Shed,_Rourkela",,1,0,1,6e-06,31
"en.wikipedia.org/wiki/Electric_Loco_Shed,_Royapuram",,1,0,1,6e-06,31
"en.wikipedia.org/wiki/Electric_Loco_Shed,_Saharanpur",,1,0,1,6e-06,31
"en.wikipedia.org/wiki/Electric_Loco_Shed,_Saiyedpur_Bhitri",,1,0,1,6e-06,31
"en.wikipedia.org/wiki/Electric_Loco_Shed,_Tatanagar",,1,0,1,6e-06,31
"en.wikipedia.org/wiki/Electric_Loco_Shed,_Tuglakabad",,1,0,1,6e-06,31
"en.wikipedia.org/wiki/Electric_Loco_Shed,_Vadodara",,1,0,1,6e-06,31
"en.wikipedia.org/wiki/Electric_Loco_Shed,_Valsad",,1,0,1,6e-06,31
"en.wikipedia.org/wiki/Electric_Loco_Shed,_Vijayawada",,1,0,1,6e-06,31
"en.wikipedia.org/wiki/Electric_Loco_Shed,_Visakhapatnam",,1,0,1,6e-06,31
en.wikipedia.org/wiki/Nilgiri_Mountain_Railway,,1,0,1,6e-06,31
en.wikipedia.org/wiki/Rewari_Railway_Heritage_Museum,,1,0,1,6e-06,31
en.wikipedia.org/wiki/Multiple_Unit,,1,0,1,6e-06,31
en.wikipedia.org/wiki/Diesel_Multiple_Unit,,1,0,1,6e-06,31
"en.wikipedia.org/w/index.php?title=DMU_Car_Shed,_Bangalore&action=edit&redlink=1",,1,0,1,6e-06,31
"en.wikipedia.org/w/index.php?title=DEMU_Car_Shed,_Budgam&action=edit&redlink=1",,1,0,1,6e-06,31
"en.wikipedia.org/w/index.php?title=DEMU_Car_Shed,_Gondia&action=edit&redlink=1",,1,0,1,6e-06,31
"en.wikipedia.org/w/index.php?title=DEMU_Car_Shed,_Jalandhar&action=edit&redlink=1",,1,0,1,6e-06,31
"en.wikipedia.org/w/index.php?title=DEMU_Car_Shed,_Jamalpur&action=edit&redlink=1",,1,0,1,6e-06,31
"en.wikipedia.org/w/index.php?title=DMU_Car_Shed,_Motibagh&action=edit&redlink=1",,1,0,1,6e-06,31
"en.wikipedia.org/w/index.php?title=DMU_Car_Shed,_Maula_Ali&action=edit&redlink=1",,1,0,1,6e-06,31
"en.wikipedia.org/w/index.php?title=DEMU_Car_Shed,_Shakurbasti&action=edit&redlink=1",,1,0,1,6e-06,31
"en.wikipedia.org/w/index.php?title=DEMU_Car_Shed,_Vijayawada&action=edit&redlink=1",,1,0,1,6e-06,31
en.wikipedia.org/wiki/Electric_Multiple_Unit,,1,0,1,6e-06,31
"en.wikipedia.org/w/index.php?title=EMU_Car_Shed,_Avadi&action=edit&redlink=1",,1,0,1,6e-06,31
"en.wikipedia.org/w/index.php?title=EMU_Car_Shed,_Bandel&action=edit&redlink=1",,1,0,1,6e-06,31
"en.wikipedia.org/w/index.php?title=EMU_Car_Shed,_Barasat&action=edit&redlink=1",,1,0,1,6e-06,31
"en.wikipedia.org/w/index.php?title=EMU_Car_Shed,_Ghaziabad&action=edit&redlink=1",,1,0,1,6e-06,31
"en.wikipedia.org/w/index.php?title=EMU_Car_Shed,_Howrah&action=edit&redlink=1",,1,0,1,6e-06,31
"en.wikipedia.org/w/index.php?title=EMU_Car_Shed,_Kalwa&action=edit&redlink=1",,1,0,1,6e-06,31
"en.wikipedia.org/w/index.php?title=EMU_Car_Shed,_Kandivali&action=edit&redlink=1",,1,0,1,6e-06,31
"en.wikipedia.org/w/index.php?title=EMU_Car_Shed,_Kharagpur&action=edit&redlink=1",,1,0,1,6e-06,31
"en.wikipedia.org/w/index.php?title=EMU_Car_Shed,_Kurla&action=edit&redlink=1",,1,0,1,6e-06,31
"en.wikipedia.org/w/index.php?title=EMU_Car_Shed,_Maula_Ali&action=edit&redlink=1",,1,0,1,6e-06,31
"en.wikipedia.org/w/index.php?title=EMU_Car_Shed,_Mumbai_Central&action=edit&redlink=1",,1,0,1,6e-06,31
"en.wikipedia.org/w/index.php?title=EMU_Car_Shed,_Narkeldanga&action=edit&redlink=1",,1,0,1,6e-06,31
"en.wikipedia.org/w/index.php?title=EMU_Car_Shed,_Panskura&action=edit&redlink=1",,1,0,1,6e-06,31
"en.wikipedia.org/w/index.php?title=EMU_Car_Shed,_Ranaghat&action=edit&redlink=1",,1,0,1,6e-06,31
"en.wikipedia.org/w/index.php?title=EMU_Car_Shed,_Saharanpur&action=edit&redlink=1",,1,0,1,6e-06,31
"en.wikipedia.org/w/index.php?title=EMU_Car_Shed,_Sanpada&action=edit&redlink=1",,1,0,1,6e-06,31
"en.wikipedia.org/w/index.php?title=EMU_Car_Shed,_Sonarpur&action=edit&redlink=1",,1,0,1,6e-06,31
"en.wikipedia.org/w/index.php?title=EMU_Car_Shed,_Tambaram&action=edit&redlink=1",,1,0,1,6e-06,31
"en.wikipedia.org/w/index.php?title=EMU_Car_Shed,_Tikiapara&action=edit&redlink=1",,1,0,1,6e-06,31
"en.wikipedia.org/w/index.php?title=EMU_Car_Shed,_Velachery&action=edit&redlink=1",,1,0,1,6e-06,31
"en.wikipedia.org/w/index.php?title=EMU_Car_Shed,_Virar&action=edit&redlink=1",,1,0,1,6e-06,31
en.wikipedia.org/wiki/MEMU,,3,0,3,6e-06,31
"en.wikipedia.org/w/index.php?title=MEMU_Car_Shed,_Asansol&action=edit&redlink=1",,1,0,1,6e-06,31
"en.wikipedia.org/w/index.php?title=MEMU_Car_Shed,_Bhilai&action=edit&redlink=1",,1,0,1,6e-06,31
"en.wikipedia.org/w/index.php?title=MEMU_Car_Shed,_Kanpur&action=edit&redlink=1",,1,0,1,6e-06,31
en.wikipedia.org/wiki/Kollam_MEMU_Shed,,1,0,1,6e-06,31
"en.wikipedia.org/w/index.php?title=MEMU_Car_Shed,_Palakkad&action=edit&redlink=1",,1,0,1,6e-06,31
"en.wikipedia.org/w/index.php?title=MEMU_Car_Shed,_Rajahmundry&action=edit&redlink=1",,1,0,1,6e-06,31
"en.wikipedia.org/w/index.php?title=MEMU_Car_Shed,_Vadodara&action=edit&redlink=1",,1,0,1,6e-06,31
en.wikipedia.org/wiki/List_of_Kolkata_Metro_depots_and_yards,,1,0,1,6e-06,31
en.wikipedia.org/wiki/Noapara_depot,,1,0,1,6e-06,31
en.wikipedia.org/wiki/Tollygunge_depot,,1,0,1,6e-06,31
en.wikipedia.org/wiki/New_Garia_depot,,1,0,1,6e-06,31
en.wikipedia.org/wiki/Central_Park_depot,,1,0,1,6e-06,31
en.wikipedia.org/wiki/Joka_depot,,1,0,1,6e-06,31
en.wikipedia.org/wiki/Category:Main_railway_lines_of_India,,1,0,1,6e-06,31
en.wikipedia.org/wiki/Chennai_Central–Bangalore_City_line,,1,0,1,6e-06,31
en.wikipedia.org/wiki/Howrah–Nagpur–Mumbai_line,,1,0,1,6e-06,31
en.wikipedia.org/wiki/Howrah–Chennai_main_line,,1,0,1,6e-06,31
en.wikipedia.org/wiki/Mumbai–Chennai_line,,1,0,1,6e-06,31
en.wikipedia.org/wiki/New_Delhi–Chennai_main_line,,3,0,3,6e-06,31
en.wikipedia.org/wiki/New_Delhi–Mumbai_main_line,,3,0,3,6e-06,31
en.wikipedia.org/wiki/Mountain_railways_of_India,,1,0,1,6e-06,31
en.wikipedia.org/wiki/Darjeeling_Himalayan_Railway,,1,0,1,6e-06,31
en.wikipedia.org/wiki/Kalka-Shimla_Railway,,1,0,1,6e-06,31
en.wikipedia.org/wiki/Category:Named_passenger_trains_of_India,,1,0,1,6e-06,31
en.wikipedia.org/wiki/Amrit_Bharat_Express,,1,0,1,6e-06,31
en.wikipedia.org/wiki/Gatimaan_Express,,1,0,1,6e-06,31
en.wikipedia.org/wiki/Tejas_Express,,1,0,1,6e-06,31
en.wikipedia.org/wiki/Rajdhani_Express,,1,0,1,6e-06,31
en.wikipedia.org/wiki/Vande_Bharat_Express,,1,0,1,6e-06,31
en.wikipedia.org/wiki/AC_Express_(Indian_Railways),,1,0,1,6e-06,31
en.wikipedia.org/wiki/Double_Decker_Express,,1,0,1,6e-06,31
en.wikipedia.org/wiki/Humsafar_Express,,1,0,1,6e-06,31
en.wikipedia.org/wiki/Uday_Express,,1,0,1,6e-06,31
en.wikipedia.org/wiki/Express_trains_in_India,,1,0,1,6e-06,31
en.wikipedia.org/wiki/Antyodaya_Express,,1,0,1,6e-06,31
en.wikipedia.org/wiki/Garib_Rath_Express,,1,0,1,6e-06,31
en.wikipedia.org/wiki/Intercity_Express_(Indian_Railways),,1,0,1,6e-06,31
en.wikipedia.org/wiki/Jan_Sadharan_Express,,1,0,1,6e-06,31
en.wikipedia.org/wiki/Jan_Shatabdi_Express,,1,0,1,6e-06,31
en.wikipedia.org/wiki/Mahamana_Express,,1,0,1,6e-06,31
en.wikipedia.org/wiki/Sampark_Kranti_Express,,1,0,1,6e-06,31
en.wikipedia.org/wiki/Suvidha_Express,,1,0,1,6e-06,31
en.wikipedia.org/wiki/Rajya_Rani_Express,,1,0,1,6e-06,31
en.wikipedia.org/wiki/Yuva_Express,,1,0,1,6e-06,31
en.wikipedia.org/wiki/Luxury_rail_trains_in_India,,1,0,1,6e-06,31
en.wikipedia.org/wiki/Deccan_Odyssey,,1,0,1,6e-06,31
en.wikipedia.org/wiki/Fairy_Queen_(locomotive),,1,0,1,6e-06,31
en.wikipedia.org/wiki/Golden_Chariot,,1,0,1,6e-06,31
en.wikipedia.org/wiki/Mahaparinirvan_Express,,1,0,1,6e-06,31
en.wikipedia.org/wiki/Maharajas%27_Express,,1,0,1,6e-06,31
en.wikipedia.org/wiki/Palace_on_Wheels,,1,0,1,6e-06,31
en.wikipedia.org/wiki/Ramayana_Express,,1,0,1,6e-06,31
en.wikipedia.org/wiki/Royal_Orient,,1,0,1,6e-06,31
en.wikipedia.org/wiki/Royal_Rajasthan_on_Wheels,,1,0,1,6e-06,31
en.wikipedia.org/wiki/Village_on_Wheels,,1,0,1,6e-06,31
en.wikipedia.org/wiki/Lifeline_Express,,1,0,1,6e-06,31
en.wikipedia.org/wiki/Red_Ribbon_Express,,1,0,1,6e-06,31
en.wikipedia.org/wiki/Science_Express,,1,0,1,6e-06,31
en.wikipedia.org/wiki/Slow_and_fast_passenger_trains_in_India,,1,0,1,6e-06,31
en.wikipedia.org/wiki/Category:Railway_stations_in_India,,1,0,1,6e-06,31
en.wikipedia.org/wiki/Categorization_of_Indian_Railway_stations_by_commercial_importance,,1,0,1,6e-06,31
en.wikipedia.org/wiki/List_of_railway_stations_in_Delhi,,1,0,1,6e-06,31
en.wikipedia.org/wiki/Category:Railway_stations_in_Kolkata,,1,0,1,6e-06,31
en.wikipedia.org/wiki/Sealdah_railway_station,,1,0,1,6e-06,31
en.wikipedia.org/wiki/Railway_stations_in_Mumbai,,1,0,1,6e-06,31
en.wikipedia.org/wiki/Kalyan_Junction_railway_station,,1,0,1,6e-06,31
en.wikipedia.org/wiki/Mumbai_CSMT,,1,0,1,6e-06,31
en.wikipedia.org/wiki/Panvel_railway_station,,1,0,1,6e-06,31
en.wikipedia.org/wiki/Thane_railway_station,,1,0,1,6e-06,31
en.wikipedia.org/wiki/Ahmedabad_Junction_railway_station,,1,0,1,6e-06,31
en.wikipedia.org/wiki/KSR_Bengaluru_railway_station,,1,0,1,6e-06,31
en.wikipedia.org/wiki/Pune_Junction_railway_station,,1,0,1,6e-06,31
en.wikipedia.org/wiki/Surat_railway_station,,1,0,1,6e-06,31
en.wikipedia.org/wiki/Vijayawada_Junction_railway_station,,1,0,1,6e-06,31
en.wikipedia.org/wiki/Visakhapatnam_Junction_railway_station,,1,0,1,6e-06,31
en.wikipedia.org/wiki/Category:Railway_junction_stations_in_India,,1,0,1,6e-06,31
en.wikipedia.org/wiki/Category:Rapid_transit_stations_in_India,,1,0,1,6e-06,31
en.wikipedia.org/wiki/Centralised_Training_Institutes_of_the_Indian_Railways,,1,0,1,6e-06,31
en.wikipedia.org/wiki/Indian_Railways_Institute_of_Civil_Engineering,,1,0,1,6e-06,31
en.wikipedia.org/wiki/Indian_Railways_Institute_of_Electrical_Engineering,,1,0,1,6e-06,31
en.wikipedia.org/wiki/Indian_Railways_Institute_of_Mechanical_and_Electrical_Engineering,,1,0,1,6e-06,31
en.wikipedia.org/wiki/Indian_Railways_Institute_of_Signal_Engineering_and_Telecommunications,,1,0,1,6e-06,31
en.wikipedia.org/wiki/Indian_Railways_Track_Machine_Training_Centre,,1,0,1,6e-06,31
en.wikipedia.org/wiki/National_Academy_of_Indian_Railways,,1,0,1,6e-06,31
en.wikipedia.org/wiki/National_Rail_and_Transportation_Institute,,1,0,1,6e-06,31
en.wikipedia.org/wiki/Jagjivan_Ram_Railway_Protection_Force_Academy,,1,0,1,6e-06,31
en.wikipedia.org/wiki/Category:Trade_unions_in_Indian_Railways,,1,0,1,6e-06,31
en.wikipedia.org/wiki/All_India_Railwaymen%27s_Federation,,1,0,1,6e-06,31
en.wikipedia.org/wiki/All_India_Station_Masters%27_Association,,1,0,1,6e-06,31
en.wikipedia.org/wiki/Konkan_Railway_Corporation_Employees_Union,,1,0,1,6e-06,31
en.wikipedia.org/wiki/List_of_railway_accidents_and_incidents_in_India,,1,0,1,6e-06,31
en.wikipedia.org/wiki/Anti-collision_device,,1,0,1,6e-06,31
en.wikipedia.org/wiki/Kavach_(train_protection_system),,1,0,1,6e-06,31
en.wikipedia.org/wiki/Future_of_rail_transport_in_India,,1,0,1,6e-06,31
en.wikipedia.org/wiki/Diamond_Quadrilateral,,1,0,1,6e-06,31
en.wikipedia.org/wiki/Last_vehicle_board,,1,0,1,6e-06,31
en.wikipedia.org/wiki/National_Train_Enquiry_System,,1,0,1,6e-06,31
en.wikipedia.org/wiki/RailRadar,,1,0,1,6e-06,31
en.wikipedia.org/wiki/Train_Warning_System_(India),,1,0,1,6e-06,31
en.wikipedia.org/wiki/Category:Indian_Railways,,1,0,1,6e-06,31
en.wikipedia.org/wiki/Template:Railways_in_Eastern_India,,1,0,1,6e-06,31
en.wikipedia.org/wiki/Template_talk:Railways_in_Eastern_India,,1,0,1,6e-06,31
en.wikipedia.org/wiki/Special:EditPage/Template:Railways_in_Eastern_India,,1,0,1,6e-06,31
en.wikipedia.org/wiki/Barauni–Guwahati_line,,1,0,1,6e-06,31
en.wikipedia.org/wiki/Howrah–New_Jalpaiguri_line,,1,0,1,6e-06,31
en.wikipedia.org/wiki/Howrah–Prayagraj–Mumbai_line,,1,0,1,6e-06,31
"en.wikipedia.org/wiki/Barauni–Gorakhpur,_Raxaul_and_Jainagar_lines",,3,0,3,6e-06,31
en.wikipedia.org/wiki/Barkakana–Son_Nagar_line,,1,0,1,6e-06,31
en.wikipedia.org/wiki/Barsoi–New_Farakka_section,,1,0,1,6e-06,31
en.wikipedia.org/wiki/Barsoi–Radhikapur_branch_line,,1,0,1,6e-06,31
en.wikipedia.org/wiki/Dumka–Bhagalpur_line,,1,0,1,6e-06,31
en.wikipedia.org/wiki/Gaya–Pandit_Deen_Dayal_Upadhyaya_Junction_section,,1,0,1,6e-06,31
en.wikipedia.org/wiki/Hatia–Rourkela_line,,1,0,1,6e-06,31
en.wikipedia.org/wiki/Jharsuguda–Vizianagaram_line,,1,0,1,6e-06,31
en.wikipedia.org/wiki/Katihar–Siliguri_line,,1,0,1,6e-06,31
en.wikipedia.org/wiki/Kharagpur–Puri_line,,1,0,1,6e-06,31
en.wikipedia.org/wiki/Khurda_Road–Visakhapatnam_section,,1,0,1,6e-06,31
en.wikipedia.org/wiki/Kothavalasa–Kirandul_line,,1,0,1,6e-06,31
en.wikipedia.org/wiki/New_Jalpaiguri–Alipurduar–Samuktala_Road_line,,1,0,1,6e-06,31
en.wikipedia.org/wiki/New_Jalpaiguri–New_Bongaigaon_section,,1,0,1,6e-06,31
en.wikipedia.org/wiki/Tatanagar–Bilaspur_section,,1,0,1,6e-06,31
en.wikipedia.org/wiki/Barauni–Katihar_section,,1,0,1,6e-06,31
en.wikipedia.org/wiki/Barauni–Samastipur_section,,1,0,1,6e-06,31
en.wikipedia.org/wiki/Fatuha–Tilaiya_line,,1,0,1,6e-06,31
en.wikipedia.org/wiki/Jogbani–Katihar_line,,1,0,1,6e-06,31
en.wikipedia.org/wiki/Mansi–Saharsa_line,,1,0,1,6e-06,31
"en.wikipedia.org/wiki/Muzaffarpur–Gorakhpur_line_(via_Hajipur,_Raxaul_and_Sitamarhi)",,1,0,1,6e-06,31
en.wikipedia.org/wiki/Muzaffarpur–Gorakhpur_main_line,,1,0,1,6e-06,31
en.wikipedia.org/wiki/Muzaffarpur–Sitamarhi_section,,1,0,1,6e-06,31
en.wikipedia.org/wiki/Muzaffarpur–Hajipur_section,,1,0,1,6e-06,31
en.wikipedia.org/wiki/Narkatiaganj–Bhikhna_Thori_branch_line,,1,0,1,6e-06,31
en.wikipedia.org/wiki/Neora–Daniyawan–Bihar_Sharif–Sheikhpura_line,,1,0,1,6e-06,31
en.wikipedia.org/wiki/Patna–Sonepur–Hajipur_section,,1,0,1,6e-06,31
en.wikipedia.org/wiki/Saharsa–Purnia_line,,1,0,1,6e-06,31
en.wikipedia.org/wiki/Saharsa–Forbesganj_line,,1,0,1,6e-06,31
en.wikipedia.org/wiki/Samastipur–Muzaffarpur_section,,1,0,1,6e-06,31
en.wikipedia.org/wiki/Barkakana–Netaji_S.C.Bose_Gomoh_line,,1,0,1,6e-06,31
en.wikipedia.org/wiki/Barkakana–Muri–Chandil_line,,1,0,1,6e-06,31
en.wikipedia.org/wiki/Dhanbad–Chandrapura_line,,1,0,1,6e-06,31
en.wikipedia.org/wiki/Railways_in_Jharia_Coalfield,,1,0,1,6e-06,31
en.wikipedia.org/wiki/Koderma–Hazaribagh–Barkakana–Ranchi_line,,1,0,1,6e-06,31
en.wikipedia.org/wiki/Netaji_S.C.Bose_Gomoh–Hatia_line,,1,0,1,6e-06,31
en.wikipedia.org/wiki/Khurda_Road–Bolangir_line,,1,0,1,6e-06,31
en.wikipedia.org/wiki/Cuttack–Sambalpur_line,,1,0,1,6e-06,31
en.wikipedia.org/wiki/Ahmadpur–Katwa_line,,1,0,1,6e-06,31
en.wikipedia.org/wiki/Alipurduar–Bamanhat_branch_line,,1,0,1,6e-06,31
en.wikipedia.org/wiki/Andal–Sainthia_branch_line,,1,0,1,6e-06,31
en.wikipedia.org/wiki/Andal–Sitarampur_loop_line,,1,0,1,6e-06,31
en.wikipedia.org/wiki/Bandel–Katwa_line,,1,0,1,6e-06,31
en.wikipedia.org/wiki/Bankura–Masagram_line,,1,0,1,6e-06,31
en.wikipedia.org/wiki/Bardhaman–Katwa_line,,1,0,1,6e-06,31
en.wikipedia.org/wiki/Barharwa–Azimganj–Katwa_loop,,1,0,1,6e-06,31
en.wikipedia.org/wiki/Eklakhi–Balurghat_branch_line,,1,0,1,6e-06,31
en.wikipedia.org/wiki/Haldibari–New_Jalpaiguri_line,,1,0,1,6e-06,31
en.wikipedia.org/wiki/Howrah–Barddhaman_main_line,,1,0,1,6e-06,31
en.wikipedia.org/wiki/Howrah–Kharagpur_line,,1,0,1,6e-06,31
en.wikipedia.org/wiki/Kharagpur–Bankura–Adra_line,,1,0,1,6e-06,31
en.wikipedia.org/wiki/New_Mal–Changrabandha–New_Cooch_Behar_line,,1,0,1,6e-06,31
en.wikipedia.org/wiki/Santragachi–Amta_branch_line,,1,0,1,6e-06,31
en.wikipedia.org/wiki/Sealdah_Main_and_North_section,,1,0,1,6e-06,31
en.wikipedia.org/wiki/Calcutta_Chord_link_line,,1,0,1,6e-06,31
en.wikipedia.org/wiki/Kolkata_Circular_Railway,,1,0,1,6e-06,31
en.wikipedia.org/wiki/Sealdah–Bangaon_line,,1,0,1,6e-06,31
en.wikipedia.org/wiki/Sealdah–Ranaghat–Gede_line,,1,0,1,6e-06,31
en.wikipedia.org/wiki/Ranaghat–Krishnanagar_City–Lalgola_line,,1,0,1,6e-06,31
en.wikipedia.org/wiki/Sealdah_South_section,,1,0,1,6e-06,31
en.wikipedia.org/wiki/Sheoraphuli–Bishnupur_branch_line,,1,0,1,6e-06,31
en.wikipedia.org/wiki/Ahmedpur–Katwa_Railway,,1,0,1,6e-06,31
en.wikipedia.org/wiki/Bankura–Damodar_Railway,,1,0,1,6e-06,31
en.wikipedia.org/wiki/Barasat–Basirhat_Light_Railway,,1,0,1,6e-06,31
en.wikipedia.org/wiki/Burdwan–Katwa_Railway,,1,0,1,6e-06,31
en.wikipedia.org/wiki/Bakhtiarpur–Bihar_Light_Railway,,1,0,1,6e-06,31
en.wikipedia.org/wiki/Futwah–Islampur_Light_Railway,,1,0,1,6e-06,31
en.wikipedia.org/wiki/Bengal_Provincial_Railway,,1,0,1,6e-06,31
en.wikipedia.org/wiki/East_Coast_State_Railway,,1,0,1,6e-06,31
en.wikipedia.org/wiki/Kalighat_Falta_Railway,,1,0,1,6e-06,31
en.wikipedia.org/wiki/Mayurbhanj_State_Railway,,1,0,1,6e-06,31
en.wikipedia.org/wiki/Dehri_Rohtas_Light_Railway,,1,0,1,6e-06,31
en.wikipedia.org/wiki/Patna–Digha_Ghat_line,,1,0,1,6e-06,31
en.wikipedia.org/wiki/Parlakimedi_Light_Railway,,1,0,1,6e-06,31
en.wikipedia.org/wiki/Asansol_railway_division,,1,0,1,6e-06,31
en.wikipedia.org/wiki/Howrah_railway_division,,1,0,1,6e-06,31
en.wikipedia.org/wiki/Malda_railway_division,,1,0,1,6e-06,31
en.wikipedia.org/wiki/Sealdah_railway_division,,1,0,1,6e-06,31
en.wikipedia.org/wiki/Samastipur_railway_division,,1,0,1,6e-06,31
en.wikipedia.org/wiki/Sonpur_railway_division,,1,0,1,6e-06,31
en.wikipedia.org/wiki/Sambalpur_railway_division,,1,0,1,6e-06,31
en.wikipedia.org/wiki/Khurda_Road_railway_division,,1,0,1,6e-06,31
en.wikipedia.org/wiki/Waltair_railway_division,,1,0,1,6e-06,31
en.wikipedia.org/wiki/Katihar_railway_division,,1,0,1,6e-06,31
en.wikipedia.org/wiki/Alipurduar_railway_division,,1,0,1,6e-06,31
en.wikipedia.org/wiki/Adra_railway_division,,1,0,1,6e-06,31
en.wikipedia.org/wiki/Chakradharpur_railway_division,,1,0,1,6e-06,31
en.wikipedia.org/wiki/Kharagpur_railway_division,,1,0,1,6e-06,31
en.wikipedia.org/wiki/Ranchi_railway_division,,1,0,1,6e-06,31
"en.wikipedia.org/wiki/Braithwaite,_Burn_%26_Jessop_Construction_Company",,1,0,1,6e-06,31
en.wikipedia.org/wiki/Burn_Standard_Company_Limited,,2,0,2,6e-06,31
"en.wikipedia.org/wiki/Carriage_Repair_Workshop,_Harnaut",,1,0,1,6e-06,31
en.wikipedia.org/wiki/Haldibari_railway_station,,1,0,1,6e-06,31
en.wikipedia.org/wiki/Chilahati_railway_station,,1,0,1,6e-06,31
en.wikipedia.org/wiki/Singhabad_railway_station,,1,0,1,6e-06,31
en.wikipedia.org/wiki/Rohanpur_railway_station,,1,0,1,6e-06,31
en.wikipedia.org/wiki/Radhikapur_railway_station,,1,0,1,6e-06,31
en.wikipedia.org/wiki/Biral_railway_station,,1,0,1,6e-06,31
en.wikipedia.org/wiki/Gede_railway_station,,1,0,1,6e-06,31
en.wikipedia.org/wiki/Darshana_railway_station,,1,0,1,6e-06,31
en.wikipedia.org/wiki/Petrapole,,1,0,1,6e-06,31
en.wikipedia.org/wiki/Benapole,,1,0,1,6e-06,31
en.wikipedia.org/wiki/Mahisasan_railway_station,,1,0,1,6e-06,31
en.wikipedia.org/wiki/Changrabandha_railway_station,,1,0,1,6e-06,31
en.wikipedia.org/wiki/Burimari_railway_station,,1,0,1,6e-06,31
en.wikipedia.org/wiki/New_Gitaldaha_railway_station,,1,0,1,6e-06,31
en.wikipedia.org/wiki/Mogalhat_railway_station,,1,0,1,6e-06,31
en.wikipedia.org/wiki/Raxaul_Junction_railway_station,,1,0,1,6e-06,31
en.wikipedia.org/wiki/Bairgania,,1,0,1,6e-06,31
en.wikipedia.org/wiki/Jaynagar_railway_station,,1,0,1,6e-06,31
en.wikipedia.org/wiki/Jogbani_railway_station,,1,0,1,6e-06,31
en.wikipedia.org/wiki/Laukaha_Bazar_railway_station,,1,0,1,6e-06,31
en.wikipedia.org/wiki/Thakurganj_railway_station,,1,0,1,6e-06,31
en.wikipedia.org/wiki/Martin%27s_Light_Railways,,1,0,1,6e-06,31
en.wikipedia.org/wiki/Bholu_(mascot),,3,0,3,6e-06,31
en.wikipedia.org/wiki/Template:Railways_in_Northern_India,,3,0,3,6e-06,31
en.wikipedia.org/wiki/Template_talk:Railways_in_Northern_India,,3,0,3,6e-06,31
en.wikipedia.org/wiki/Special:EditPage/Template:Railways_in_Northern_India,,3,0,3,6e-06,31
en.wikipedia.org/wiki/Jaipur–Ahmedabad_line,,3,0,3,6e-06,31
en.wikipedia.org/wiki/Agra–Bhopal_section,,4,0,4,7e-06,31
en.wikipedia.org/wiki/Ahmedabad–Udaipur_line,,3,0,3,6e-06,31
en.wikipedia.org/wiki/Allahabad–Mau–Gorakhpur_main_line,,3,0,3,6e-06,31
en.wikipedia.org/wiki/Ambala–Attari_line,,3,0,3,6e-06,31
en.wikipedia.org/wiki/Amritsar–Khem_Karan_line,,3,0,3,6e-06,31
en.wikipedia.org/wiki/Amritsar–Pathankot_line,,3,0,3,6e-06,31
en.wikipedia.org/wiki/Aunrihar–Jaunpur_line,,3,0,3,6e-06,31
en.wikipedia.org/wiki/Barauni–Gorakhpur_line,,3,0,3,6e-06,31
en.wikipedia.org/wiki/Bathinda–Rewari_line,,3,0,3,6e-06,31
en.wikipedia.org/wiki/Bathinda–Rajpura_line,,3,0,3,6e-06,31
en.wikipedia.org/wiki/Bikaner–Rewari_line,,3,0,3,6e-06,31
en.wikipedia.org/wiki/Bhanupli–Leh_line,,4,0,4,7e-06,31
en.wikipedia.org/wiki/Chandigarh–Sahnewal_line,,3,0,3,6e-06,31
en.wikipedia.org/wiki/Delhi–Fazilka_line,,3,0,3,6e-06,31
en.wikipedia.org/wiki/Delhi–Kalka_line,,3,0,3,6e-06,31
en.wikipedia.org/wiki/Delhi–Meerut–Saharanpur_line,,3,0,3,6e-06,31
en.wikipedia.org/wiki/Delhi–Moradabad_line,,3,0,3,6e-06,31
en.wikipedia.org/wiki/Jalandhar–Firozpur_line,,3,0,3,6e-06,31
en.wikipedia.org/wiki/Jalandhar–Jammu_line,,3,0,3,6e-06,31
en.wikipedia.org/wiki/Jammu–Baramulla_line,,3,0,3,6e-06,31
en.wikipedia.org/wiki/Jodhpur–Bathinda_line,,3,0,3,6e-06,31
en.wikipedia.org/wiki/Jodhpur–Jaisalmer_line,,3,0,3,6e-06,31
en.wikipedia.org/wiki/Laksar–Dehradun_line,,3,0,3,6e-06,31
en.wikipedia.org/wiki/Lucknow–Gorakhpur_line,,3,0,3,6e-06,31
en.wikipedia.org/wiki/Lucknow–Moradabad_line,,3,0,3,6e-06,31
en.wikipedia.org/wiki/Ludhiana–Fazilka_line,,3,0,3,6e-06,31
en.wikipedia.org/wiki/Ludhiana–Jakhal_line,,3,0,3,6e-06,31
en.wikipedia.org/wiki/Marwar_Junction–Munabao_line,,3,0,3,6e-06,31
en.wikipedia.org/wiki/Mathura–Vadodara_section,,3,0,3,6e-06,31
en.wikipedia.org/wiki/Mau–Ghazipur–Dildarnagar_main_line,,3,0,3,6e-06,31
en.wikipedia.org/wiki/Merta_Road–Rewari_line,,3,0,3,6e-06,31
en.wikipedia.org/wiki/Moradabad–Ambala_line,,3,0,3,6e-06,31
en.wikipedia.org/wiki/Rewari–Rohtak_line,,3,0,3,6e-06,31
en.wikipedia.org/wiki/Shri_Ganganagar–Sadulpur_line,,3,0,3,6e-06,31
en.wikipedia.org/wiki/Suratgarh–Bathinda_line,,3,0,3,6e-06,31
en.wikipedia.org/wiki/Varanasi–Chhapra_line,,3,0,3,6e-06,31
en.wikipedia.org/wiki/Varanasi–Lucknow_line,,3,0,3,6e-06,31
en.wikipedia.org/wiki/Varanasi–Rae_Bareli–Lucknow_line,,3,0,3,6e-06,31
en.wikipedia.org/wiki/Varanasi–Sultanpur–Lucknow_line,,3,0,3,6e-06,31
en.wikipedia.org/wiki/Grey_Line_(Delhi_Metro),,3,0,3,6e-06,31
en.wikipedia.org/wiki/Red_Line_(Delhi_Metro),,3,0,3,6e-06,31
en.wikipedia.org/wiki/Kalka–Shimla_Railway,,3,0,3,6e-06,31
en.wikipedia.org/wiki/Patiala_State_Monorail_Trainways,,3,0,3,6e-06,31
en.wikipedia.org/wiki/Jammu–Sialkot_line,,3,0,3,6e-06,31
en.wikipedia.org/wiki/Kangra_Valley_Railway,,3,0,3,6e-06,31
en.wikipedia.org/wiki/Rajputana–Malwa_Railway,,3,0,3,6e-06,31
en.wikipedia.org/wiki/Tirhut_Railway,,3,0,3,6e-06,31
en.wikipedia.org/wiki/Oudh_and_Tirhut_Railway,,3,0,3,6e-06,31
en.wikipedia.org/wiki/Oudh_and_Rohilkhand_Railway,,3,0,3,6e-06,31
en.wikipedia.org/wiki/Lucknow–Bareilly_Railway,,3,0,3,6e-06,31
en.wikipedia.org/wiki/Bengal_and_North_Western_Railway,,3,0,3,6e-06,31
en.wikipedia.org/wiki/Rohilkund_and_Kumaon_Railway,,3,0,3,6e-06,31
en.wikipedia.org/wiki/Mashrak–Thawe_Extension_Railway,,3,0,3,6e-06,31
en.wikipedia.org/wiki/Lucknow–Sitapur–Seramow_Provincial_State_Railway,,3,0,3,6e-06,31
en.wikipedia.org/wiki/Bareilly–Pilibheet_Provincial_State_Railway,,3,0,3,6e-06,31
en.wikipedia.org/wiki/Segowlie–Raxaul_Railway,,3,0,3,6e-06,31
en.wikipedia.org/wiki/1974_railway_strike_in_India,,3,0,3,6e-06,31
en.wikipedia.org/wiki/Category:5_ft_6_in_gauge_railways_in_India,,1,0,1,6e-06,31
en.wikipedia.org/wiki/Category:Rail_transport_in_Jharkhand,,1,0,1,6e-06,31
en.wikipedia.org/wiki/Category:Rail_transport_in_Bihar,,1,0,1,6e-06,31
en.wikipedia.org/wiki/Category:Rail_transport_in_Uttar_Pradesh,,3,0,3,6e-06,31
en.wikipedia.org/wiki/Category:Rail_transport_in_Delhi,,1,0,1,6e-06,31
en.m.wikipedia.org/w/index.php?title=Howrah–New_Delhi_main_line&mobileaction=toggle_view_mobile,,1,0,1,6e-06,31
upload.wikimedia.org/wikipedia/commons/thumb/4/47/BSicon_hbKRZWae.svg/40px-BSicon_hbKRZWae.svg.png,,1,0,1,6e-06,31
upload.wikimedia.org/wikipedia/commons/thumb/a/ae/BSicon_GRZq.svg/20px-BSicon_GRZq.svg.png,,1,0,1,6e-06,31
upload.wikimedia.org/wikipedia/commons/thumb/d/dc/BSicon_ABZgr%2Br.svg/20px-BSicon_ABZgr%2Br.svg.png,,1,0,1,6e-06,31
upload.wikimedia.org/wikipedia/commons/thumb/9/93/BSicon_LKRW%2Bl.svg/20px-BSicon_LKRW%2Bl.svg.png,,1,0,1,6e-06,31
upload.wikimedia.org/wikipedia/commons/thumb/2/2e/BSicon_KRWgr.svg/20px-BSicon_KRWgr.svg.png,,1,0,1,6e-06,31
upload.wikimedia.org/wikipedia/commons/thumb/1/12/BSicon_ABZg%2Br.svg/20px-BSicon_ABZg%2Br.svg.png,,2,0,2,6e-06,31
upload.wikimedia.org/wikipedia/commons/thumb/b/ba/BSicon_ABZgl%2Bl.svg/20px-BSicon_ABZgl%2Bl.svg.png,,1,0,1,6e-06,31
upload.wikimedia.org/wikipedia/commons/thumb/a/a5/BSicon_CONTfq.svg/20px-BSicon_CONTfq.svg.png,,2,0,2,6e-06,31
upload.wikimedia.org/wikipedia/commons/thumb/9/9f/BSicon_ABZgl.svg/20px-BSicon_ABZgl.svg.png,,2,0,2,6e-06,31
upload.wikimedia.org/wikipedia/commons/thumb/8/86/BSicon_LKRWl.svg/20px-BSicon_LKRWl.svg.png,,1,0,1,6e-06,31
upload.wikimedia.org/wikipedia/commons/thumb/8/8a/BSicon_KRWg%2Br.svg/20px-BSicon_KRWg%2Br.svg.png,,1,0,1,6e-06,31
en.wikipedia.org/wiki/B.Tech,,5,0,5,7e-06,31
en.wikipedia.org/w/index.php?title=Special:CreateAccount&returnto=Jaswantnagar,,1,0,1,7e-06,31
en.wikipedia.org/w/index.php?title=Special:UserLogin&returnto=Jaswantnagar,,1,0,1,7e-06,31
zh-min-nan.wikipedia.org/wiki/Jaswantnagar,,1,0,1,7e-06,31
ceb.wikipedia.org/wiki/Jaswantnagar,,1,0,1,7e-06,31
es.wikipedia.org/wiki/Jaswantnagar,,1,0,1,7e-06,31
hi.wikipedia.org/wiki/जसवंतनगर,,1,0,1,7e-06,31
bpy.wikipedia.org/wiki/যশৱন্তনগর,,1,0,1,7e-06,31
it.wikipedia.org/wiki/Jaswantnagar,,1,0,1,7e-06,31
mg.wikipedia.org/wiki/Jaswantnagar,,1,0,1,7e-06,31
ms.wikipedia.org/wiki/Jaswantnagar,,1,0,1,7e-06,31
nl.wikipedia.org/wiki/Jaswantnagar,,1,0,1,7e-06,31
new.wikipedia.org/wiki/जस्वन्तनगर,,1,0,1,7e-06,31
pl.wikipedia.org/wiki/Jaswantnagar,,1,0,1,7e-06,31
pt.wikipedia.org/wiki/Jaswantnagar,,1,0,1,7e-06,31
sco.wikipedia.org/wiki/Jaswantnagar,,1,0,1,7e-06,31
sv.wikipedia.org/wiki/Jaswantnagar,,1,0,1,7e-06,31
ur.wikipedia.org/wiki/جسونتنگر,,1,0,1,7e-06,31
vi.wikipedia.org/wiki/Jaswantnagar,,1,0,1,7e-06,31
zh.wikipedia.org/wiki/贾斯万特纳加尔,,1,0,1,7e-06,31
wikidata.org/wiki/Special:EntityPage/Q2441652,,1,0,1,7e-06,31
en.wikipedia.org/wiki/Talk:Jaswantnagar,,1,0,1,7e-06,31
en.wikipedia.org/w/index.php?title=Jaswantnagar&action=edit,,1,0,1,7e-06,31
en.wikipedia.org/w/index.php?title=Jaswantnagar&action=history,,1,0,1,7e-06,31
en.wikipedia.org/wiki/Special:WhatLinksHere/Jaswantnagar,,1,0,1,7e-06,31
en.wikipedia.org/wiki/Special:RecentChangesLinked/Jaswantnagar,,1,0,1,7e-06,31
en.wikipedia.org/w/index.php?title=Jaswantnagar&oldid=1129689685,,1,0,1,7e-06,31
en.wikipedia.org/w/index.php?title=Jaswantnagar&action=info,,1,0,1,7e-06,31
en.wikipedia.org/w/index.php?title=Jaswantnagar&printable=yes,,1,0,1,7e-06,31
en.wikipedia.org/wiki/Jaswantnagar_(Vidhan_Sabha_constituency),,3,0,3,7e-06,31
en.wikipedia.org/wiki/Dimple_Yadav,,3,0,3,7e-06,31
en.wikipedia.org/w/index.php?title=Jaswantnagar&action=edit&section=1,,1,0,1,7e-06,31
en.wikipedia.org/w/index.php?title=Jaswantnagar&action=edit&section=2,,1,0,1,7e-06,31
en.wikipedia.org/wiki/Template:Etawah-geo-stub,,3,0,3,7e-06,31
en.wikipedia.org/wiki/Template_talk:Etawah-geo-stub,,3,0,3,7e-06,31
en.wikipedia.org/wiki/Special:EditPage/Template:Etawah-geo-stub,,3,0,3,7e-06,31
en.wikipedia.org/wiki/Category:Cities_and_towns_in_Etawah_district,,1,0,1,7e-06,31
en.wikipedia.org/wiki/Category:Etawah_district_geography_stubs,,3,0,3,7e-06,31
en.m.wikipedia.org/w/index.php?title=Jaswantnagar&mobileaction=toggle_view_mobile,,1,0,1,7e-06,31
en.wikipedia.org/w/index.php?title=Special:CreateAccount&returnto=Kakadeo,,1,0,1,6e-06,31
en.wikipedia.org/w/index.php?title=Special:UserLogin&returnto=Kakadeo,,1,0,1,6e-06,31
wikidata.org/wiki/Special:EntityPage/Q6349130,,1,0,1,6e-06,31
en.wikipedia.org/wiki/Talk:Kakadeo,,1,0,1,6e-06,31
en.wikipedia.org/w/index.php?title=Kakadeo&action=edit,,1,0,1,6e-06,31
en.wikipedia.org/w/index.php?title=Kakadeo&action=history,,1,0,1,6e-06,31
en.wikipedia.org/wiki/Special:WhatLinksHere/Kakadeo,,1,0,1,6e-06,31
en.wikipedia.org/wiki/Special:RecentChangesLinked/Kakadeo,,1,0,1,6e-06,31
en.wikipedia.org/w/index.php?title=Kakadeo&oldid=1308645058,,1,0,1,6e-06,31
en.wikipedia.org/w/index.php?title=Kakadeo&action=info,,1,0,1,6e-06,31
en.wikipedia.org/w/index.php?title=Special:DownloadAsPdf&page=Kakadeo&action=show-download-screen,,1,0,1,6e-06,31
en.wikipedia.org/w/index.php?title=Kakadeo&printable=yes,,1,0,1,6e-06,31
geohack.toolforge.org/geohack.php?pagename=Kakadeo&params=26.478928_N_80.291111_E_type:landmark,,1,0,1,6e-06,31
en.wikipedia.org/wiki/Special:EditPage/Kakadeo,,1,0,1,6e-06,31
"google.com/search?as_eq=wikipedia&q=""Kakadeo""",,1,0,1,6e-06,31
"google.com/search?tbm=nws&q=""Kakadeo""+-wikipedia&tbs=ar:1",,1,0,1,6e-06,31
"google.com/search?&q=""Kakadeo""&tbs=bkt:s&tbm=bks",,1,0,1,6e-06,31
"google.com/search?tbs=bks:1&q=""Kakadeo""+-wikipedia",,1,0,1,6e-06,31
"scholar.google.com/scholar?q=""Kakadeo""",,1,0,1,6e-06,31
"jstor.org/action/doBasicSearch?Query=""Kakadeo""&acc=on&wc=on",,1,0,1,6e-06,31
en.wikipedia.org/wiki/Chandela_dynasty,,1,0,1,6e-06,31
en.wikipedia.org/wiki/Secondary_School_Certificate,,1,0,1,6e-06,31
en.wikipedia.org/w/index.php?title=Kakadeo&action=edit&section=1,,1,0,1,6e-06,31
en.m.wikipedia.org/w/index.php?title=Kakadeo&mobileaction=toggle_view_mobile,,1,0,1,6e-06,31
en.wikipedia.org/w/index.php?title=Special:CreateAccount&returnto=Kaimganj,,1,0,1,6e-06,31
en.wikipedia.org/w/index.php?title=Special:UserLogin&returnto=Kaimganj,,1,0,1,6e-06,31
zh-min-nan.wikipedia.org/wiki/Kaimganj,,1,0,1,6e-06,31
bh.wikipedia.org/wiki/कायमगंज,,1,0,1,6e-06,31
ceb.wikipedia.org/wiki/Kaimganj,,1,0,1,6e-06,31
es.wikipedia.org/wiki/Kaimganj,,1,0,1,6e-06,31
fa.wikipedia.org/wiki/قائم‌گنج,,1,0,1,6e-06,31
hi.wikipedia.org/wiki/कायमगंज,,1,0,1,6e-06,31
bpy.wikipedia.org/wiki/কাইমগঞ্জ,,1,0,1,6e-06,31
it.wikipedia.org/wiki/Kaimganj,,1,0,1,6e-06,31
mg.wikipedia.org/wiki/Kaimganj,,1,0,1,6e-06,31
ms.wikipedia.org/wiki/Kaimganj,,1,0,1,6e-06,31
nl.wikipedia.org/wiki/Kaimganj,,1,0,1,6e-06,31
new.wikipedia.org/wiki/कैम्गञ्ज,,1,0,1,6e-06,31
pl.wikipedia.org/wiki/Kaimganj,,1,0,1,6e-06,31
sv.wikipedia.org/wiki/Kaimganj,,1,0,1,6e-06,31
ur.wikipedia.org/wiki/قائم_گنج,,1,0,1,6e-06,31
vi.wikipedia.org/wiki/Kaimganj,,1,0,1,6e-06,31
zh.wikipedia.org/wiki/盖姆根杰,,1,0,1,6e-06,31
wikidata.org/wiki/Special:EntityPage/Q2543754,,1,0,1,6e-06,31
en.wikipedia.org/wiki/Talk:Kaimganj,,1,0,1,6e-06,31
en.wikipedia.org/w/index.php?title=Kaimganj&action=edit,,1,0,1,6e-06,31
en.wikipedia.org/w/index.php?title=Kaimganj&action=history,,1,0,1,6e-06,31
en.wikipedia.org/wiki/Special:WhatLinksHere/Kaimganj,,1,0,1,6e-06,31
en.wikipedia.org/wiki/Special:RecentChangesLinked/Kaimganj,,1,0,1,6e-06,31
en.wikipedia.org/w/index.php?title=Kaimganj&oldid=1286381762,,1,0,1,6e-06,31
en.wikipedia.org/w/index.php?title=Kaimganj&action=info,,1,0,1,6e-06,31
en.wikipedia.org/w/index.php?title=Special:DownloadAsPdf&page=Kaimganj&action=show-download-screen,,1,0,1,6e-06,31
en.wikipedia.org/w/index.php?title=Kaimganj&printable=yes,,1,0,1,6e-06,31
en.wikipedia.org/w/index.php?title=Kaimganj&action=edit&section=1,,1,0,1,6e-06,31
en.wikipedia.org/wiki/Administrator_of_the_Government,,1,0,1,6e-06,31
en.wikipedia.org/wiki/Market_place,,1,0,1,6e-06,31
en.wikipedia.org/wiki/Charaka,,1,0,1,6e-06,31
en.wikipedia.org/wiki/Rahimuddin_Khan,,1,0,1,6e-06,31
en.wikipedia.org/wiki/Balochistan_(Pakistan),,1,0,1,6e-06,31
en.wikipedia.org/wiki/Governor_of_Balochistan,,1,0,1,6e-06,31
en.wikipedia.org/wiki/Gulam_Rabbani_Taban,,1,0,1,6e-06,31
en.wikipedia.org/wiki/Syed_Abdul_Salam_Shah,,1,0,1,6e-06,31
en.wikipedia.org/w/index.php?title=Syed_Kabir_Shah&action=edit&redlink=1,,1,0,1,6e-06,31
en.wikipedia.org/w/index.php?title=Khair_Shah&action=edit&redlink=1,,1,0,1,6e-06,31
en.wikipedia.org/w/index.php?title=Lohiya&action=edit&redlink=1,,1,0,1,6e-06,31
en.wikipedia.org/w/index.php?title=National_socialistic_party&action=edit&redlink=1,,1,0,1,6e-06,31
en.wikipedia.org/w/index.php?title=Lal_Topi&action=edit&redlink=1,,1,0,1,6e-06,31
en.wikipedia.org/w/index.php?title=Kaimganj&action=edit&section=2,,1,0,1,6e-06,31
en.wikipedia.org/w/index.php?title=Kaimganj&action=edit&section=3,,1,0,1,6e-06,31
geohack.toolforge.org/geohack.php?pagename=Kaimganj&params=27.57_N_79.35_E_,,1,0,1,6e-06,31
en.wikipedia.org/w/index.php?title=Kaimganj&action=edit&section=4,,1,0,1,6e-06,31
en.wikipedia.org/w/index.php?title=Kaimganj&action=edit&section=5,,1,0,1,6e-06,31
en.wikipedia.org/wiki/Chewing_tobacco,,1,0,1,6e-06,31
en.wikipedia.org/wiki/Sugar_mill,,1,0,1,6e-06,31
en.wikipedia.org/wiki/Nicotine,,1,0,1,6e-06,31
en.wikipedia.org/w/index.php?title=Kaimganj&action=edit&section=6,,1,0,1,6e-06,31
en.wikipedia.org/w/index.php?title=Kaimganj&action=edit&section=7,,1,0,1,6e-06,31
en.wikipedia.org/wiki/Durrani,,1,0,1,6e-06,31
en.wikipedia.org/wiki/Nadir_Shah,,1,0,1,6e-06,31
en.wikipedia.org/w/index.php?title=Ali_Muhammad_(governor)&action=edit&redlink=1,,1,0,1,6e-06,31
en.wikipedia.org/wiki/Wajir,,1,0,1,6e-06,31
en.wikipedia.org/wiki/Qaim_Khan,,1,0,1,6e-06,31
en.wikipedia.org/wiki/Qadirganj,,1,0,1,6e-06,31
en.wikipedia.org/w/index.php?title=Kaimganj&action=edit&section=8,,1,0,1,6e-06,31
en.wikipedia.org/wiki/Gangwar_(surname),,1,0,1,6e-06,31
en.wikipedia.org/wiki/Katiyar,,1,0,1,6e-06,31
en.wikipedia.org/wiki/Aliganj,,1,0,1,6e-06,31
en.wikipedia.org/wiki/Third_battle_of_Panipat,,1,0,1,6e-06,31
en.wikipedia.org/w/index.php?title=Kaimganj&action=edit&section=9,,1,0,1,6e-06,31
en.wikipedia.org/w/index.php?title=Kaimganj&action=edit&section=10,,1,0,1,6e-06,31
en.wikipedia.org/wiki/Siyaram_Gangwar,,1,0,1,6e-06,31
en.wikipedia.org/w/index.php?title=Kaimganj&action=edit&section=11,,1,0,1,6e-06,31
books.google.com/books?id=uzNnwUasQ3wC&q=qaimganj+zakir&pg=PA11,,1,0,1,6e-06,31
en.wikipedia.org/wiki/Special:BookSources/9788176480567,,1,0,1,6e-06,31
researchguru.net/volume/Volume%2012/Issue%201/RG104.pdf,,1,0,1,6e-06,31
search.worldcat.org/issn/2349-266X,,1,0,1,6e-06,31
censusindia.gov.in/PopulationFinder/View_Village_Population.aspx?pcaid=1046&category=M.B,,1,0,1,6e-06,31
thehindu.com/thehindu/mp/2002/09/30/stories/2002093000550200.htm,,1,0,1,6e-06,31
fallingrain.com/world/IN/36/Kaimganj.html,,1,0,1,6e-06,31
web.archive.org/web/20131125161431/http://www.cpvnkaimganj.org/kcpvn2.php,,1,0,1,6e-06,31
cpvnkaimganj.org/kcpvn2.php,,1,0,1,6e-06,31
web.archive.org/web/20131219224515/http://pratapiti.com/index.html,,1,0,1,6e-06,31
pratapiti.com/index.html,,1,0,1,6e-06,31
en.m.wikipedia.org/w/index.php?title=Kaimganj&mobileaction=toggle_view_mobile,,1,0,1,6e-06,31
en.wikipedia.org/w/index.php?title=Special:CreateAccount&returnto=Kali+River+(Uttar+Pradesh),,1,0,1,6e-06,31
en.wikipedia.org/w/index.php?title=Special:UserLogin&returnto=Kali+River+(Uttar+Pradesh),,1,0,1,6e-06,31
azb.wikipedia.org/wiki/کالی_چایی(اوتار_پرادش),,1,0,1,6e-06,31
ca.wikipedia.org/wiki/Kali_Nadi_Occidental,,1,0,1,6e-06,31
hi.wikipedia.org/wiki/काली_नदी_(उत्तर_प्रदेश),,1,0,1,6e-06,31
mr.wikipedia.org/wiki/काळी_नदी_(उत्तर_प्रदेश),,1,0,1,6e-06,31
wikidata.org/wiki/Special:EntityPage/Q6352440,,1,0,1,6e-06,31
en.wikipedia.org/wiki/Talk:Kali_River_(Uttar_Pradesh),,1,0,1,6e-06,31
en.wikipedia.org/w/index.php?title=Kali_River_(Uttar_Pradesh)&action=edit,,1,0,1,6e-06,31
en.wikipedia.org/w/index.php?title=Kali_River_(Uttar_Pradesh)&action=history,,1,0,1,6e-06,31
en.wikipedia.org/wiki/Special:WhatLinksHere/Kali_River_(Uttar_Pradesh),,1,0,1,6e-06,31
en.wikipedia.org/wiki/Special:RecentChangesLinked/Kali_River_(Uttar_Pradesh),,1,0,1,6e-06,31
en.wikipedia.org/w/index.php?title=Kali_River_(Uttar_Pradesh)&oldid=1307764196,,1,0,1,6e-06,31
en.wikipedia.org/w/index.php?title=Kali_River_(Uttar_Pradesh)&action=info,,1,0,1,6e-06,31
en.wikipedia.org/w/index.php?title=Kali_River_(Uttar_Pradesh)&printable=yes,,1,0,1,6e-06,31
en.wikipedia.org/wiki/Kali_River_(disambiguation),,1,0,1,6e-06,31
en.wikipedia.org/wiki/File:Kali_Nadi_(Bulandshahr).jpg,,1,0,1,6e-06,31
en.wikipedia.org/wiki/Barnava,,1,0,1,6e-06,31
en.wikipedia.org/wiki/Ganga_River,,1,0,1,6e-06,31
en.wikipedia.org/w/index.php?title=Kali_River_(Uttar_Pradesh)&action=edit&section=1,,1,0,1,6e-06,31
en.wikipedia.org/w/index.php?title=Kali_River_(Uttar_Pradesh)&action=edit&section=2,,1,0,1,6e-06,31
jstor.org/stable/44141794,,1,0,1,6e-06,31
archive.org/details/bulandshahrorsk00growgoog/page/n24/mode/2up?q=river,,1,0,1,6e-06,31
civilsocietyonline.com/Archive/aug11/aug1110.htm,,1,0,1,6e-06,31
web.archive.org/web/20130419000516/http://www.civilsocietyonline.com/Archive/aug11/aug1110.htm,,1,0,1,6e-06,31
books.google.com/books?id=ZKs1gBhJSWIC&pg=PA349,,1,0,1,6e-06,31
ganga-river-project.com/04_resultats/documents/Fasep_NGRBA_Inception%20Report_rev1.pdf,,1,0,1,6e-06,31
en.m.wikipedia.org/w/index.php?title=Kali_River_(Uttar_Pradesh)&mobileaction=toggle_view_mobile,,1,0,1,6e-06,31
meta.wikimedia.org/wiki/Special:MyLanguage/Wikimedia_movement,,1,0,1,7e-06,31
wiktionary.org/,,1,0,1,7e-06,31
wikiquote.org/,,1,0,1,7e-06,31
wikibooks.org/,,1,0,1,7e-06,31
commons.wikimedia.org/,,2,0,2,7e-06,31
wikisource.org/,,1,0,1,7e-06,31
wikiversity.org/,,1,0,1,7e-06,31
wikispecies.org/,,1,0,1,7e-06,31
wikidata.org/,,1,0,1,7e-06,31
wikifunctions.org/,,1,0,1,7e-06,31
wikivoyage.org/,,1,0,1,7e-06,31
wikinews.org/,,1,0,1,7e-06,31
meta.wikimedia.org/,,1,0,1,7e-06,31
wikimediafoundation.org/about/contact/,,1,0,1,7e-06,31
wikimedia.org/portal/wikimedia.org/assets/js/index-7a7f1bc88c.js,,1,0,1,7e-06,31
wikimedia.org/portal/wikimedia.org/assets/img/wikimedia_logo.png,,1,0,1,7e-06,31
wikimedia.org/portal/wikimedia.org/assets/img/welcome-image.svg,,1,0,1,7e-06,31
wikimedia.org/portal/wikimedia.org/assets/img/Wikipedia-logo_sister.svg,,1,0,1,7e-06,31
wikimedia.org/portal/wikimedia.org/assets/img/Wiktionary-logo_sister.svg,,1,0,1,7e-06,31
wikimedia.org/portal/wikimedia.org/assets/img/Wikiquote-logo_sister.svg,,1,0,1,7e-06,31
wikimedia.org/portal/wikimedia.org/assets/img/Wikibooks-logo_sister.svg,,1,0,1,7e-06,31
wikimedia.org/portal/wikimedia.org/assets/img/Commons-logo_sister.svg,,1,0,1,7e-06,31
wikimedia.org/portal/wikimedia.org/assets/img/Wikisource-logo_sister.svg,,1,0,1,7e-06,31
wikimedia.org/portal/wikimedia.org/assets/img/Wikiversity-logo_sister.svg,,1,0,1,7e-06,31
wikimedia.org/portal/wikimedia.org/assets/img/Wikispecies-logo_sister.svg,,1,0,1,7e-06,31
wikimedia.org/portal/wikimedia.org/assets/img/Wikidata-logo_sister.svg,,1,0,1,7e-06,31
wikimedia.org/portal/wikimedia.org/assets/img/Wikifunctions-logo_sister.svg,,1,0,1,7e-06,31
wikimedia.org/portal/wikimedia.org/assets/img/MediaWiki-logo_sister.svg,,1,0,1,7e-06,31
wikimedia.org/portal/wikimedia.org/assets/img/Wikivoyage-logo_sister.svg,,1,0,1,7e-06,31
wikimedia.org/portal/wikimedia.org/assets/img/Wikinews-logo_sister.svg,,1,0,1,7e-06,31
wikimedia.org/portal/wikimedia.org/assets/img/Meta-Wiki-logo_sister.svg,,1,0,1,7e-06,31
wikimedia.org/portal/wikimedia.org/assets/img/puzzle-globe.svg,,1,0,1,7e-06,31
wikimediafoundation.org/who-we-are/,,1,0,1,7e-06,31
wikimediafoundation.org/who-we-are/people/,,1,0,1,7e-06,31
wikimediafoundation.org/role/board/,,1,0,1,7e-06,31
wikimediafoundation.org/role/executive/,,1,0,1,7e-06,31
wikimediafoundation.org/role/staff,,1,0,1,7e-06,31
wikimediafoundation.org/who-we-are/reports/,,1,0,1,7e-06,31
wikimediafoundation.org/who-we-are/annualreport/,,1,0,1,7e-06,31
wikimediafoundation.org/who-we-are/financial-reports/,,1,0,1,7e-06,31
wikimediafoundation.org/who-we-are/transparency/,,1,0,1,7e-06,31
wikimediafoundation.org/jobs/,,1,0,1,7e-06,31
wikimediafoundation.org/who-we-are/frequently-asked-questions/,,1,0,1,7e-06,31
wikimediafoundation.org/what-we-do/,,1,0,1,7e-06,31
wikimediafoundation.org/what-we-do/wikimedia-projects,,1,0,1,7e-06,31
wikimediafoundation.org/technology,,1,0,1,7e-06,31
wikimediafoundation.org/public-policy,,1,0,1,7e-06,31
wikimediafoundation.org/what-we-do/open-the-knowledge/,,1,0,1,7e-06,31
wikimediafoundation.org/give/,,1,0,1,7e-06,31
wikimediafoundation.org/give/give-monthly/,,1,0,1,7e-06,31
wikimediafoundation.org/news/2024/11/25/7-reasons-you-should-donate-to-wikipedia/,,1,0,1,7e-06,31
wikimediafoundation.org/give/legacy-planned-giving/,,1,0,1,7e-06,31
wikimediafoundation.org/give/manage-your-donation/,,1,0,1,7e-06,31
wikimediafoundation.org/participate/,,1,0,1,7e-06,31
wikimediafoundation.org/public-policy/,,1,0,1,7e-06,31
wikimediafoundation.org/news/,,1,0,1,7e-06,31
wikimediafoundation.org/news/category/wikimedia-foundation/,,1,0,1,7e-06,31
wikimediafoundation.org/news/category/public-policy/,,1,0,1,7e-06,31
wikimediafoundation.org/ar/,,1,0,1,7e-06,31
wikimediafoundation.org/fr/,,1,0,1,7e-06,31
wikimediafoundation.org/pt/,,1,0,1,7e-06,31
donate.wikimedia.org/?wmf_medium=wmfSite&wmf_campaign=navButton&uselang=en&wmf_source=10,,1,0,1,7e-06,31
wikimediafoundation.org/wikipedia-experiments/,,1,0,1,7e-06,31
wikimediafoundation.org/news/category/community/,,1,0,1,7e-06,31
wikimediafoundation.org/news/2025/08/05/wikimania-2025-celebrates-humans/,,1,0,1,7e-06,31
wikimediafoundation.org/news/2025/07/09/china-block-wikimedia-wipo/,,1,0,1,7e-06,31
wikimediafoundation.org/news/2025/06/27/the-wikipedia-test/,,1,0,1,7e-06,31
wikimediafoundation.org/news/category/technology/,,1,0,1,7e-06,31
wikimediafoundation.org/news/2025/04/30/our-new-ai-strategy-puts-wikipedias-humans-first/,,1,0,1,7e-06,31
wikimediafoundation.org/news/2025/04/08/redemption-the-winners-of-wiki-loves-monuments-2024/,,1,0,1,7e-06,31
wikimediafoundation.org/news/2025/02/12/wikipedia-recognized-as-a-digital-public-good/,,1,0,1,7e-06,31
wikimediafoundation.org/privacy-policy/,,1,0,1,7e-06,31
commons.wikimedia.org/wiki/File:Mayree_Clark.jpg,,1,0,1,7e-06,31
commons.wikimedia.org/wiki/File:Royal_Courts_of_Justice_2019.jpg,,1,0,1,7e-06,31
commons.wikimedia.org/wiki/File:WIkimania_2025_Theme.jpg,,1,0,1,7e-06,31
commons.wikimedia.org/wiki/File:Redentor_Over_Clouds_1.jpg,,1,0,1,7e-06,31
commons.wikimedia.org/wiki/File:DpgBadge.svg,,1,0,1,7e-06,31
commons.wikimedia.org/wiki/File:WikiSG_Headshots_Taufik.jpg,,1,0,1,7e-06,31
commons.wikimedia.org/wiki/File:Siobhan_Leachman_at_BioBlitzWBN_1.jpg,,1,0,1,7e-06,31
commons.wikimedia.org/wiki/File:Armine_Aghayan-Flisch.jpg,,1,0,1,7e-06,31
commons.wikimedia.org/wiki/File:Le_Burex_de_WikiCiv.jpg,,1,0,1,7e-06,31
commons.wikimedia.org/wiki/File:The_Photographer_User_in_Humboldt_Peak.jpg,,1,0,1,7e-06,31
commons.wikimedia.org/wiki/File:Equipo_de_Wikipedistas_en_El_Salvador.jpg,,1,0,1,7e-06,31
commons.wikimedia.org/wiki/File:Monica_Bonilla.jpg,,1,0,1,7e-06,31
"commons.wikimedia.org/wiki/File:Wikisource_Conference_2025,_Day_3,_Denpasar;_February_2025_(086).jpg",,1,0,1,7e-06,31
commons.wikimedia.org/wiki/File:Wikiar2022_0034_(cropped).jpg,,1,0,1,7e-06,31
commons.wikimedia.org/wiki/File:Nkem_Osuigwe_3.jpg,,1,0,1,7e-06,31
commons.wikimedia.org/wiki/File:Ananya_Mondal_-_WLM.jpg,,1,0,1,7e-06,31
commons.wikimedia.org/wiki/File:Netha_Hussain-070A3987.jpg,,1,0,1,7e-06,31
commons.wikimedia.org/wiki/File:Rosie_at_Wikimania_2023_6.jpg,,1,0,1,7e-06,31
commons.wikimedia.org/wiki/File:Andrew_Lih.jpg,,1,0,1,7e-06,31
creativecommons.org/licenses/by/2.0/,,1,0,1,7e-06,31
instagram.com/wikimediafoundation/,,1,0,1,7e-06,31
facebook.com/wikimediafoundation/,,1,0,1,7e-06,31
linkedin.com/company/wikimedia-foundation,,1,0,1,7e-06,31
tiktok.com/@wikipedia,,1,0,1,7e-06,31
linkedin.com/company/wikipedia-the-free-encyclopedia/,,1,0,1,7e-06,31
instagram.com/wikipedia/,,1,0,1,7e-06,31
facebook.com/wikipedia,,1,0,1,7e-06,31
youtube.com/@wikipedia,,1,0,1,7e-06,31
wikimediafoundation.org/contact/,,1,0,1,7e-06,31
wikimediafoundation.org/who-we-are/press/,,1,0,1,7e-06,31
wikimediafoundation.org/research/,,1,0,1,7e-06,31
wikimediafoundation.org/the-wikipedia-library/,,1,0,1,7e-06,31
store.wikimedia.org/,,1,0,1,7e-06,31
foundation.wikimedia.org/wiki/Special:MyLanguage/Policy:General_disclaimer,,1,0,1,7e-06,31
wikimediafoundation.org/accessibility-statement/,,1,0,1,7e-06,31
wikimediafoundation.org/wp-content/plugins/hm-mega-menu-block/build/view.js?ver=8795d8d7cb03f34c22ae,,1,0,1,7e-06,31
wikimediafoundation.org/wp-includes/js/dist/i18n.min.js?ver=5e580eb46a90c2b997e6,,1,0,1,7e-06,31
wikimediafoundation.org/wp-includes/js/jquery/ui/datepicker.min.js?ver=1.13.3,,1,0,1,7e-06,31
api.mapbox.com/mapbox-gl-js/v3.2.0/mapbox-gl.js?ver=3.2.0,,1,0,1,7e-06,31
wikimediafoundation.org/wp-content/uploads/2025/07/logo-horizontal.svg,,1,0,1,7e-06,31
wikimediafoundation.org/wp-content/uploads/2025/08/Endowment-Board-Member.jpg?w=300,,1,0,1,7e-06,31
wikimediafoundation.org/wp-content/uploads/2024/05/Mayree_Clark.jpg?w=300,,1,0,1,7e-06,31
wikimediafoundation.org/wp-content/uploads/2025/07/1024px-Royal_Courts_of_Justice_2019-1.jpg?w=300,,1,0,1,7e-06,31
wikimediafoundation.org/wp-content/uploads/2025/07/Cover-image_800x600_UPDATED.png,,1,0,1,7e-06,31
wikimediafoundation.org/wp-content/uploads/2025/07/wiki-globe.svg,,1,0,1,7e-06,31
wikimediafoundation.org/wp-content/uploads/2025/07/wiki-friendship.svg,,1,0,1,7e-06,31
wikimediafoundation.org/wp-content/uploads/2025/07/wiki-collaboration.svg,,1,0,1,7e-06,31
wikimediafoundation.org/wp-content/uploads/2025/07/wiki-global.svg,,1,0,1,7e-06,31
wikimediafoundation.org/wp-content/uploads/2025/07/wiki-mobile.svg,,1,0,1,7e-06,31
wikimediafoundation.org/wp-content/uploads/2025/08/1024px-WIkimania_2025_Theme-1.jpg?w=300,,1,0,1,7e-06,31
wikimediafoundation.org/wp-content/uploads/2025/06/The-Wikipedia-Test-Header-1.gif?w=300,,1,0,1,7e-06,31
wikimediafoundation.org/wp-content/uploads/2025/04/Wikipedia-AI-Strategy-Announcement.png?w=300,,1,0,1,7e-06,31
wikimediafoundation.org/wp-content/uploads/2025/04/1024px-Redentor_Over_Clouds_1.jpg?w=300,,1,0,1,7e-06,31
wikimediafoundation.org/wp-content/uploads/2025/02/DpgBadge.png?w=300,,1,0,1,7e-06,31
wikimediafoundation.org/wp-content/uploads/2025/07/1024px-WikiSG_Headshots_Taufik.jpg,,1,0,1,7e-06,31
wikimediafoundation.org/wp-content/uploads/2025/07/1024px-Siobhan_Leachman_at_BioBlitzWBN_1.jpg,,1,0,1,7e-06,31
wikimediafoundation.org/wp-content/uploads/2025/07/1024px-Armine_Aghayan-Flisch.jpg,,1,0,1,7e-06,31
wikimediafoundation.org/wp-content/uploads/2025/07/1024px-Le_Burex_de_WikiCiv.jpg,,1,0,1,7e-06,31
wikimediafoundation.org/wp-content/uploads/2025/07/1024px-The_Photographer_User_in_Humboldt_Peak.jpg,,1,0,1,7e-06,31
wikimediafoundation.org/wp-content/uploads/2025/07/1024px-Equipo_de_Wikipedistas_en_El_Salvador.jpg,,1,0,1,7e-06,31
wikimediafoundation.org/wp-content/uploads/2025/07/512px-Monica_Bonilla.jpg,,1,0,1,7e-06,31
wikimediafoundation.org/wp-content/uploads/2025/07/512px-Wikiar2022_0034_cropped.jpg,,1,0,1,7e-06,31
wikimediafoundation.org/wp-content/uploads/2025/07/1024px-Nkem_Osuigwe_3.jpg,,1,0,1,7e-06,31
wikimediafoundation.org/wp-content/uploads/2025/07/1024px-Ananya_Mondal_-_WLM.jpg,,1,0,1,7e-06,31
wikimediafoundation.org/wp-content/uploads/2025/07/1024px-Netha_Hussain-070A3987.jpg,,1,0,1,7e-06,31
wikimediafoundation.org/wp-content/uploads/2025/07/512px-Rosie_at_Wikimania_2023_6.jpg,,1,0,1,7e-06,31
wikimediafoundation.org/wp-content/uploads/2025/07/1024px-Andrew_Lih.jpg,,1,0,1,7e-06,31
wikimediafoundation.org/wp-content/uploads/2024/05/Mayree_Clark.jpg?w=63,,1,0,1,7e-06,31
wikimediafoundation.org/wp-content/uploads/2025/07/1024px-Royal_Courts_of_Justice_2019-1.jpg?w=63,,1,0,1,7e-06,31
wikimediafoundation.org/wp-content/uploads/2025/08/1024px-WIkimania_2025_Theme-1.jpg?w=63,,1,0,1,7e-06,31
wikimediafoundation.org/wp-content/uploads/2025/06/The-Wikipedia-Test-Header-1.gif?w=63,,1,0,1,7e-06,31
wikimediafoundation.org/wp-content/uploads/2025/04/Wikipedia-AI-Strategy-Announcement.png?w=63,,1,0,1,7e-06,31
wikimediafoundation.org/wp-content/uploads/2025/04/1024px-Redentor_Over_Clouds_1.jpg?w=63,,1,0,1,7e-06,31
wikimediafoundation.org/wp-content/uploads/2025/02/DpgBadge.png?w=63,,1,0,1,7e-06,31
wikimediafoundation.org/wp-content/uploads/2025/07/Cover-image_800x600_UPDATED.png?w=63,,1,0,1,7e-06,31
wikimediafoundation.org/wp-content/uploads/2025/07/wiki-globe.svg?w=63,,1,0,1,7e-06,31
wikimediafoundation.org/wp-content/uploads/2025/07/wiki-friendship.svg?w=63,,1,0,1,7e-06,31
wikimediafoundation.org/wp-content/uploads/2025/07/wiki-collaboration.svg?w=63,,1,0,1,7e-06,31
wikimediafoundation.org/wp-content/uploads/2025/07/wiki-global.svg?w=63,,1,0,1,7e-06,31
wikimediafoundation.org/wp-content/uploads/2025/07/wiki-mobile.svg?w=63,,1,0,1,7e-06,31
wikimediafoundation.org/wp-content/uploads/2025/07/1024px-WikiSG_Headshots_Taufik.jpg?w=63,,1,0,1,7e-06,31
wikimediafoundation.org/wp-content/uploads/2025/07/1024px-Siobhan_Leachman_at_BioBlitzWBN_1.jpg?w=63,,1,0,1,7e-06,31
wikimediafoundation.org/wp-content/uploads/2025/07/1024px-Armine_Aghayan-Flisch.jpg?w=63,,1,0,1,7e-06,31
wikimediafoundation.org/wp-content/uploads/2025/07/1024px-Le_Burex_de_WikiCiv.jpg?w=63,,1,0,1,7e-06,31
wikimediafoundation.org/wp-content/uploads/2025/07/512px-Monica_Bonilla.jpg?w=63,,1,0,1,7e-06,31
wikimediafoundation.org/wp-content/uploads/2025/07/512px-Wikiar2022_0034_cropped.jpg?w=63,,1,0,1,7e-06,31
wikimediafoundation.org/wp-content/uploads/2025/07/1024px-Nkem_Osuigwe_3.jpg?w=63,,1,0,1,7e-06,31
wikimediafoundation.org/wp-content/uploads/2025/07/1024px-Ananya_Mondal_-_WLM.jpg?w=63,,1,0,1,7e-06,31
wikimediafoundation.org/wp-content/uploads/2025/07/1024px-Netha_Hussain-070A3987.jpg?w=63,,1,0,1,7e-06,31
wikimediafoundation.org/wp-content/uploads/2025/07/512px-Rosie_at_Wikimania_2023_6.jpg?w=63,,1,0,1,7e-06,31
wikimediafoundation.org/wp-content/uploads/2025/07/1024px-Andrew_Lih.jpg?w=63,,1,0,1,7e-06,31
wikimediafoundation.org/wp-content/themes/shiro/assets/src/images/logo-stacked-reverse.svg,,1,0,1,7e-06,31
wikimediafoundation.org/wp-content/themes/shiro/assets/src/images/Wikipedia-logo-stacked-reverse.svg,,1,0,1,7e-06,31
wikimediafoundation.org/wp-includes/css/dist/block-library/style.min.css?m=1754500264g,,1,0,1,7e-06,31
api.mapbox.com/mapbox-gl-js/v3.2.0/mapbox-gl.css?ver=6.8.2,,1,0,1,7e-06,31
siteimproveanalytics.com/js/siteanalyze_66356571.js,,1,0,1,7e-06,31
lux.collections.yale.edu/assets/index-rqJKn1ro.js,,1,0,1,7e-06,31
googletagmanager.com/ns.html?id=GTM-KRW2Z3K,,1,0,1,7e-06,31
cdn.jsdelivr.net/npm/bootstrap-icons@1.10.3/font/bootstrap-icons.css,,1,0,1,7e-06,31
fonts.googleapis.com/css2?family=Inter:wght@100;200;300;500;700&display=swap,,1,0,1,7e-06,31
lux.collections.yale.edu/assets/index-DGMB5utd.css,,1,0,1,7e-06,31
stats.wikimedia.org/assets-v2/main.css,,1,0,1,2.4e-05,31
viaf.org/en/viaf/126123809,,1,0,1,1.2e-05,31
en.wikipedia.org/wiki/Etawah_District,,5,0,5,7e-06,31
en.wikipedia.org/w/index.php?title=Special:CreateAccount&returnto=Wikipedia%3AGeneral+disclaimer,,1,0,1,7e-06,31
en.wikipedia.org/w/index.php?title=Special:UserLogin&returnto=Wikipedia%3AGeneral+disclaimer,,1,0,1,7e-06,31
af.wikipedia.org/wiki/Wikipedia:General_disclaimer,,1,0,1,7e-06,31
als.wikipedia.org/wiki/Wikipedia:Impressum,,1,0,1,7e-06,31
an.wikipedia.org/wiki/Wikipedia:Alvertencias_chenerals,,1,0,1,7e-06,31
arc.wikipedia.org/wiki/ܘܝܩܝܦܕܝܐ:General_disclaimer,,1,0,1,7e-06,31
as.wikipedia.org/wiki/ৱিকিপিডিয়া:সাধাৰণ_দায়লুপ্তি,,1,0,1,7e-06,31
ast.wikipedia.org/wiki/Wikipedia:Llimitación_xeneral_de_responsabilidá,,1,0,1,7e-06,31
gn.wikipedia.org/wiki/Vikipetã:Arigua_rehegua,,1,0,1,7e-06,31
az.wikipedia.org/wiki/Vikipediya:Məsuliyyətdən_imtina,,1,0,1,7e-06,31
azb.wikipedia.org/wiki/ویکی‌پدیا:گئنل_یالانلاما,,1,0,1,7e-06,31
bm.wikipedia.org/wiki/Wikipedia:Avertissements_généraux,,1,0,1,7e-06,31
zh-min-nan.wikipedia.org/wiki/Wikipedia:Bián-chek_seng-bêng,,1,0,1,7e-06,31
ba.wikipedia.org/wiki/Википедия:Яуаплылыҡтан_баш_тартыу,,1,0,1,7e-06,31
be.wikipedia.org/wiki/Вікіпедыя:Адмова_ад_адказнасці,,1,0,1,7e-06,31
be-tarask.wikipedia.org/wiki/Вікіпэдыя:Адмова_ад_адказнасьці,,1,0,1,7e-06,31
bcl.wikipedia.org/wiki/Wikipedia:Pankagabsan_na_pagsayuma,,1,0,1,7e-06,31
bg.wikipedia.org/wiki/Уикипедия:Предупреждение,,1,0,1,7e-06,31
bar.wikipedia.org/wiki/Wikipedia:Impressum,,1,0,1,7e-06,31
bo.wikipedia.org/wiki/Wikipedia:General_disclaimer,,1,0,1,7e-06,31
bs.wikipedia.org/wiki/Wikipedia:Odricanje_odgovornosti,,1,0,1,7e-06,31
bxr.wikipedia.org/wiki/Википеэди:Ниитэ_татагалзал,,1,0,1,7e-06,31
ca.wikipedia.org/wiki/Viquipèdia:Avís_d%27exempció_de_responsabilitat,,1,0,1,7e-06,31
ceb.wikipedia.org/wiki/Wikipedia:Mga_pagpasabot,,1,0,1,7e-06,31
cs.wikipedia.org/wiki/Wikipedie:Vyloučení_odpovědnosti,,1,0,1,7e-06,31
ny.wikipedia.org/wiki/Wikipedia:General_disclaimer,,1,0,1,7e-06,31
sn.wikipedia.org/wiki/Wikipedia:General_disclaimer,,1,0,1,7e-06,31
cy.wikipedia.org/wiki/Wicipedia:Gwadiad_Cyffredinol,,1,0,1,7e-06,31
da.wikipedia.org/wiki/Wikipedia:Generelle_forbehold,,1,0,1,7e-06,31
nv.wikipedia.org/wiki/Wikiibíídiiya:General_disclaimer,,1,0,1,7e-06,31
et.wikipedia.org/wiki/Vikipeedia:Üldine_lahtiütlus,,1,0,1,7e-06,31
el.wikipedia.org/wiki/Βικιπαίδεια:Αποποίηση_ευθυνών,,1,0,1,7e-06,31
eml.wikipedia.org/wiki/Wikipedia:Avertèinsi_generèli,,1,0,1,7e-06,31
eo.wikipedia.org/wiki/Vikipedio:Malgarantio,,1,0,1,7e-06,31
ext.wikipedia.org/wiki/Güiquipedia:Arrayu_de_responsabiliá,,1,0,1,7e-06,31
eu.wikipedia.org/wiki/Wikipedia:Erantzukizunen_mugaketa_orokorra,,1,0,1,7e-06,31
ee.wikipedia.org/wiki/Wikipedia:General_disclaimer,,1,0,1,7e-06,31
fa.wikipedia.org/wiki/ویکی‌پدیا:تکذیب‌نامهٔ_عمومی,,1,0,1,7e-06,31
fo.wikipedia.org/wiki/Wikipedia:General_disclaimer,,1,0,1,7e-06,31
fur.wikipedia.org/wiki/Vichipedie:General_disclaimer,,1,0,1,7e-06,31
ga.wikipedia.org/wiki/Vicipéid:Séanadh_ginearálta,,1,0,1,7e-06,31
gd.wikipedia.org/wiki/Uicipeid:General_disclaimer,,1,0,1,7e-06,31
gl.wikipedia.org/wiki/Wikipedia:Advertencia_xeral,,1,0,1,7e-06,31
inh.wikipedia.org/wiki/Википеди:Бехктокхам_тӀацаэцар,,1,0,1,7e-06,31
gan.wikipedia.org/wiki/Wikipedia:免責聲明,,1,0,1,7e-06,31
gu.wikipedia.org/wiki/વિકિપીડિયા:General_disclaimer,,1,0,1,7e-06,31
haw.wikipedia.org/wiki/Wikipedia:Nā_a‘o_‘ana_laulā,,1,0,1,7e-06,31
hy.wikipedia.org/wiki/Վիքիպեդիա:Ընդհանուր_հրաժարագիր,,1,0,1,7e-06,31
hr.wikipedia.org/wiki/Wikipedija:Opće_odricanje_od_odgovornosti,,1,0,1,7e-06,31
gor.wikipedia.org/wiki/Wikipedia:Momāhu_umum,,1,0,1,7e-06,31
ig.wikipedia.org/wiki/Wikipedia:General_disclaimer,,1,0,1,7e-06,31
ilo.wikipedia.org/wiki/Wikipedia:Sapasap_a_renunsia,,1,0,1,7e-06,31
id.wikipedia.org/wiki/Wikipedia:Penyangkalan_umum,,1,0,1,7e-06,31
ia.wikipedia.org/wiki/Wikipedia:Declaration_general_de_non-responsabilitate,,1,0,1,7e-06,31
os.wikipedia.org/wiki/Википеди:Бæрн,,1,0,1,7e-06,31
xh.wikipedia.org/wiki/Wikipedia:General_disclaimer,,1,0,1,7e-06,31
zu.wikipedia.org/wiki/Wikipedia:General_disclaimer,,1,0,1,7e-06,31
is.wikipedia.org/wiki/Wikipedia:Almennur_fyrirvari,,1,0,1,7e-06,31
he.wikipedia.org/wiki/ויקיפדיה:הבהרות_משפטיות,,1,0,1,7e-06,31
jv.wikipedia.org/wiki/Wikipédia:Sélakan_umum,,1,0,1,7e-06,31
kn.wikipedia.org/wiki/ವಿಕಿಪೀಡಿಯ:General_disclaimer,,1,0,1,7e-06,31
ka.wikipedia.org/wiki/ვიკიპედია:პასუხისმგებლობის_უარყოფა,,1,0,1,7e-06,31
ks.wikipedia.org/wiki/وِکیٖپیٖڈیا:عَوٲمی_اِظہارِ_لا_تولُقی,,1,0,1,7e-06,31
kw.wikipedia.org/wiki/Wikipedia:General_disclaimer,,1,0,1,7e-06,31
sw.wikipedia.org/wiki/Wikipedia:Kanusho_kwa_jumla,,1,0,1,7e-06,31
ht.wikipedia.org/wiki/Wikipedya:Avètisman_jeneral,,1,0,1,7e-06,31
ku.wikipedia.org/wiki/Wîkîpediya:Ferexetname,,1,0,1,7e-06,31
ky.wikipedia.org/wiki/Википедия:Жоопкерчиликтен_баш_тартуу,,1,0,1,7e-06,31
lo.wikipedia.org/wiki/ວິກິພີເດຍ:ຂໍ້ປະຕິເສດຄວາມຮັບຜິດຊອບ,,1,0,1,7e-06,31
la.wikipedia.org/wiki/Vicipaedia:Repudiationes,,1,0,1,7e-06,31
lv.wikipedia.org/wiki/Vikipēdija:Saistību_atrunas,,1,0,1,7e-06,31
lb.wikipedia.org/wiki/Wikipedia:General_disclaimer,,1,0,1,7e-06,31
lt.wikipedia.org/wiki/Vikipedija:Jokių_garantijų,,1,0,1,7e-06,31
lij.wikipedia.org/wiki/Wikipedia:Avertense_generâli,,1,0,1,7e-06,31
li.wikipedia.org/wiki/Wikipedia:Algemein_aafwiezing_aansjpraokelikheid,,1,0,1,7e-06,31
ln.wikipedia.org/wiki/Wikipedia:Boyanoli_ndelo,,1,0,1,7e-06,31
hu.wikipedia.org/wiki/Wikipédia:Jogi_nyilatkozat,,1,0,1,7e-06,31
mk.wikipedia.org/wiki/Википедија:Одрекување_од_одговорност,,1,0,1,7e-06,31
mt.wikipedia.org/wiki/Wikipedija:Ċaħda_ġenerali,,1,0,1,7e-06,31
xmf.wikipedia.org/wiki/ვიკიპედია:გამამინჯალაშ_ვარაფა,,1,0,1,7e-06,31
arz.wikipedia.org/wiki/ويكيبيديا:تنازل_عن_مسئوليه_عمومى,,1,0,1,7e-06,31
mzn.wikipedia.org/wiki/پروژه:تکذیب‌نومهٔ_همه‌گونی,,1,0,1,7e-06,31
ms.wikipedia.org/wiki/Wikipedia:Penafian_umum,,1,0,1,7e-06,31
cdo.wikipedia.org/wiki/Wikipedia:Mò̤_hô-cáik_sĭng-mìng,,1,0,1,7e-06,31
mwl.wikipedia.org/wiki/Biquipédia:Abiso_legal,,1,0,1,7e-06,31
mn.wikipedia.org/wiki/Википедиа:Ерөнхий_татгалзал,,1,0,1,7e-06,31
my.wikipedia.org/wiki/ဝီကီပီးဒီးယား:အထွေထွေ_သတိပြုဖွယ်,,1,0,1,7e-06,31
nl.wikipedia.org/wiki/Wikipedia:Algemeen_voorbehoud,,1,0,1,7e-06,31
nds-nl.wikipedia.org/wiki/Wikipedia:Vöärbehold,,1,0,1,7e-06,31
ne.wikipedia.org/wiki/विकिपिडिया:सामान्य_अस्वीकारोक्ति,,1,0,1,7e-06,31
ja.wikipedia.org/wiki/Wikipedia:免責事項,,1,0,1,7e-06,31
frr.wikipedia.org/wiki/Wikipedia:Impressum,,1,0,1,7e-06,31
nn.wikipedia.org/wiki/Wikipedia:Atterhald,,1,0,1,7e-06,31
oc.wikipedia.org/wiki/Wikipèdia:Avertiments_generals,,1,0,1,7e-06,31
or.wikipedia.org/wiki/ଉଇକିପିଡ଼ିଆ:ଆମେ_ଦାୟୀ_ନୋହୁଁ,,1,0,1,7e-06,31
uz.wikipedia.org/wiki/Vikipediya:Masʼuliyatdan_voz_kechish,,1,0,1,7e-06,31
pa.wikipedia.org/wiki/ਵਿਕੀਪੀਡੀਆ:ਆਮ_ਅਸਵੀਕਾਰਤਾ,,1,0,1,7e-06,31
pfl.wikipedia.org/wiki/Wikipedia:Impressum,,1,0,1,7e-06,31
ps.wikipedia.org/wiki/ويکيپېډيا:ټولگړې_واگ_اخيستنې,,1,0,1,7e-06,31
km.wikipedia.org/wiki/វិគីភីឌា:ការបដិសេធ_ទូទៅ,,1,0,1,7e-06,31
nds.wikipedia.org/wiki/Wikipedia:Impressum,,1,0,1,7e-06,31
pl.wikipedia.org/wiki/Wikipedia:Korzystasz_z_Wikipedii_tylko_na_własną_odpowiedzialność,,1,0,1,7e-06,31
ro.wikipedia.org/wiki/Wikipedia:Avertisment_general,,1,0,1,7e-06,31
qu.wikipedia.org/wiki/Wikipidiya:General_disclaimer,,1,0,1,7e-06,31
ru.wikipedia.org/wiki/Википедия:Отказ_от_ответственности,,1,0,1,7e-06,31
sah.wikipedia.org/wiki/Бикипиэдьийэ:Бүк_охсунуу,,1,0,1,7e-06,31
sm.wikipedia.org/wiki/Wikipedia:General_disclaimer,,1,0,1,7e-06,31
sa.wikipedia.org/wiki/विकिपीडिया:General_disclaimer,,1,0,1,7e-06,31
sc.wikipedia.org/wiki/Wikipedia:Abbertimentos_generales,,1,0,1,7e-06,31
sco.wikipedia.org/wiki/Wikipedia:General_disclamation,,1,0,1,7e-06,31
sq.wikipedia.org/wiki/Wikipedia:Shfajësimet_e_përgjithshme,,1,0,1,7e-06,31
si.wikipedia.org/wiki/විකිපීඩියා:පොදු_වියාචනය,,1,0,1,7e-06,31
simple.wikipedia.org/wiki/Wikipedia:General_disclaimer,,1,0,1,7e-06,31
sd.wikipedia.org/wiki/وڪيپيڊيا:عام_غيرجوابدارينامو,,1,0,1,7e-06,31
sk.wikipedia.org/wiki/Wikipédia:Vylúčenie_zodpovednosti,,1,0,1,7e-06,31
sl.wikipedia.org/wiki/Wikipedija:Splošno_zanikanje_odgovornosti,,1,0,1,7e-06,31
so.wikipedia.org/wiki/Wikipedia:Masuul_la%27aan_guud,,1,0,1,7e-06,31
ckb.wikipedia.org/wiki/ویکیپیدیا:بەرپرسنەبوون,,1,0,1,7e-06,31
sr.wikipedia.org/wiki/Википедија:Одрицање_одговорности,,1,0,1,7e-06,31
sh.wikipedia.org/wiki/Wikipedija:Opće_odricanje_odgovornosti,,1,0,1,7e-06,31
su.wikipedia.org/wiki/Wikipedia:Bantahan_umum,,1,0,1,7e-06,31
fi.wikipedia.org/wiki/Wikipedia:Vastuuvapaus,,1,0,1,7e-06,31
sv.wikipedia.org/wiki/Wikipedia:Allmänt_förbehåll,,1,0,1,7e-06,31
tl.wikipedia.org/wiki/Wikipedia:Pangkalahatang_paalala,,1,0,1,7e-06,31
roa-tara.wikipedia.org/wiki/Wikipedia:General_disclaimer,,1,0,1,7e-06,31
tt.wikipedia.org/wiki/Википедия:Җаваплылыктан_баш_тарту,,1,0,1,7e-06,31
te.wikipedia.org/wiki/వికీపీడియా:మమ్మల్ని_కలవండి,,1,0,1,7e-06,31
th.wikipedia.org/wiki/วิกิพีเดีย:ข้อปฏิเสธความรับผิดชอบ,,1,0,1,7e-06,31
tg.wikipedia.org/wiki/Википедиа:Такзибномаи_умумӣ,,1,0,1,7e-06,31
tcy.wikipedia.org/wiki/ವಿಕಿಪೀಡಿಯ:ಸಾಮಾನ್ಯೊ_ಹಕ್ಕ್‌_ನಿರಾಕರಣೆಲು,,1,0,1,7e-06,31
tr.wikipedia.org/wiki/Vikipedi:Genel_sorumluluk_reddi,,1,0,1,7e-06,31
tk.wikipedia.org/wiki/Wikipediýa:General_disclaimer,,1,0,1,7e-06,31
udm.wikipedia.org/wiki/Википедия:Кыл_кутэмлэсь_куштӥськон,,1,0,1,7e-06,31
uk.wikipedia.org/wiki/Вікіпедія:Відмова_від_відповідальності,,1,0,1,7e-06,31
ug.wikipedia.org/wiki/Wikipedia:General_disclaimer,,1,0,1,7e-06,31
vi.wikipedia.org/wiki/Wikipedia:Phủ_nhận_chung,,1,0,1,7e-06,31
vo.wikipedia.org/wiki/Vükiped:General_disclaimer,,1,0,1,7e-06,31
fiu-vro.wikipedia.org/wiki/Wikipedia:Hoiatuisi,,1,0,1,7e-06,31
vls.wikipedia.org/wiki/Wikipedia:Aansprakelekeid,,1,0,1,7e-06,31
war.wikipedia.org/wiki/Wikipedia:General_disclaimer,,1,0,1,7e-06,31
wuu.wikipedia.org/wiki/Wikipedia:免责声明,,1,0,1,7e-06,31
yi.wikipedia.org/wiki/װיקיפּעדיע:קלארשטעלונג,,1,0,1,7e-06,31
zh-yue.wikipedia.org/wiki/Wikipedia:一般免責聲明,,1,0,1,7e-06,31
zh.wikipedia.org/wiki/Wikipedia:免责声明,,1,0,1,7e-06,31
syl.wikipedia.org/wiki/ꠃꠁꠇꠤꠙꠤꠒꠤꠀ:ꠡꠣꠗꠣꠞꠘ_ꠖꠣꠄꠝꠥꠇ꠆ꠔꠤ,,1,0,1,7e-06,31
wikidata.org/wiki/Special:EntityPage/Q4980478,,1,0,1,7e-06,31
en.wikipedia.org/wiki/Wikipedia_talk:General_disclaimer,,1,0,1,7e-06,31
en.wikipedia.org/w/index.php?title=Wikipedia:General_disclaimer&action=edit,,1,0,1,7e-06,31
en.wikipedia.org/w/index.php?title=Wikipedia:General_disclaimer&action=history,,1,0,1,7e-06,31
en.wikipedia.org/wiki/Special:WhatLinksHere/Wikipedia:General_disclaimer,,1,0,1,7e-06,31
en.wikipedia.org/wiki/Special:RecentChangesLinked/Wikipedia:General_disclaimer,,1,0,1,7e-06,31
en.wikipedia.org/w/index.php?title=Wikipedia:General_disclaimer&oldid=1295893532,,1,0,1,7e-06,31
en.wikipedia.org/w/index.php?title=Wikipedia:General_disclaimer&action=info,,1,0,1,7e-06,31
en.wikipedia.org/w/index.php?title=Wikipedia:General_disclaimer&printable=yes,,1,0,1,7e-06,31
mediawiki.org/wiki/Project:General_disclaimer,,1,0,1,7e-06,31
meta.wikimedia.org/wiki/Meta:General_disclaimer,,1,0,1,7e-06,31
wikisource.org/wiki/Wikisource:General_disclaimer,,1,0,1,7e-06,31
species.wikimedia.org/wiki/Wikispecies:General_disclaimer,,1,0,1,7e-06,31
en.wikibooks.org/wiki/Wikibooks:General_disclaimer,,1,0,1,7e-06,31
wikidata.org/wiki/Wikidata:General_disclaimer,,1,0,1,7e-06,31
wikifunctions.org/wiki/Wikifunctions:General_disclaimer,,1,0,1,7e-06,31
en.wikinews.org/wiki/Wikinews:General_disclaimer,,1,0,1,7e-06,31
en.wikiquote.org/wiki/Wikiquote:General_disclaimer,,1,0,1,7e-06,31
en.wikisource.org/wiki/Wikisource:General_disclaimer,,1,0,1,7e-06,31
en.wikiversity.org/wiki/Wikiversity:General_disclaimer,,1,0,1,7e-06,31
en.wikivoyage.org/wiki/Wikivoyage:Disclaimer,,1,0,1,7e-06,31
en.wiktionary.org/wiki/Wiktionary:General_disclaimer,,1,0,1,7e-06,31
en.wikipedia.org/wiki/Wikipedia:GENERAL,,1,0,1,7e-06,31
en.wikipedia.org/wiki/Wikipedia:5D,,1,0,1,7e-06,31
en.wikipedia.org/wiki/Wikipedia:GENDIS,,1,0,1,7e-06,31
en.wikipedia.org/wiki/Wikipedia:Content_disclaimer,,1,0,1,7e-06,31
en.wikipedia.org/wiki/Wikipedia:Legal_disclaimer,,1,0,1,7e-06,31
en.wikipedia.org/wiki/Wikipedia:Medical_disclaimer,,1,0,1,7e-06,31
en.wikipedia.org/wiki/Wikipedia:Risk_disclaimer,,1,0,1,7e-06,31
en.wikipedia.org/wiki/Wikipedia:Survey_disclaimer,,1,0,1,7e-06,31
en.wikipedia.org/wiki/Wikipedia:Non-Wikipedia_disclaimers,,1,0,1,7e-06,31
en.wikipedia.org/wiki/Wikipedia:Text_of_the_GNU_Free_Documentation_License,,1,0,1,7e-06,31
en.wikipedia.org/wiki/Personality_rights,,1,0,1,7e-06,31
foundation.wikimedia.org/wiki/Policy:General_disclaimer,,1,0,1,7e-06,31
en.wikipedia.org/wiki/Category:Wikipedia_disclaimers,,1,0,1,7e-06,31
en.wikipedia.org/wiki/Category:Wikipedia_fully_protected_project_pages,,1,0,1,7e-06,31
en.m.wikipedia.org/w/index.php?title=Wikipedia:General_disclaimer&mobileaction=toggle_view_mobile,,1,0,1,7e-06,31
hi.wikipedia.org/wiki/उत्तर_प्रदेश_आयुर्विज्ञान_विश्वविद्यालय,,1,0,1,6e-06,31
ml.wikipedia.org/wiki/ഉത്തർപ്രദേശ്_യൂണിവേഴ്സിറ്റി_ഓഫ്_മെഡിക്കൽ_സയൻസസ്,,1,0,1,6e-06,31
ne.wikipedia.org/wiki/उत्तर_प्रदेश_आयुर्विज्ञान_विश्वविद्यालय,,1,0,1,6e-06,31
wikidata.org/wiki/Special:EntityPage/Q23808450,,1,0,1,6e-06,31
en.wikipedia.org/wiki/Talk:Uttar_Pradesh_University_of_Medical_Sciences,,1,0,1,6e-06,31
en.wikipedia.org/w/index.php?title=Uttar_Pradesh_University_of_Medical_Sciences&action=edit,,1,0,1,6e-06,31
en.wikipedia.org/w/index.php?title=Uttar_Pradesh_University_of_Medical_Sciences&action=history,,1,0,1,6e-06,31
en.wikipedia.org/wiki/Special:WhatLinksHere/Uttar_Pradesh_University_of_Medical_Sciences,,1,0,1,6e-06,31
en.wikipedia.org/wiki/Special:RecentChangesLinked/Uttar_Pradesh_University_of_Medical_Sciences,,1,0,1,6e-06,31
en.wikipedia.org/w/index.php?title=Uttar_Pradesh_University_of_Medical_Sciences&oldid=1306703506,,1,0,1,6e-06,31
en.wikipedia.org/w/index.php?title=Uttar_Pradesh_University_of_Medical_Sciences&action=info,,1,0,1,6e-06,31
en.wikipedia.org/w/index.php?title=Uttar_Pradesh_University_of_Medical_Sciences&printable=yes,,1,0,1,6e-06,31
en.wikipedia.org/wiki/File:UPUMS_logo.png,,1,0,1,6e-06,31
"en.wikipedia.org/wiki/Saifai,_Etawah",,1,0,1,6e-06,31
en.wikipedia.org/wiki/National_Accreditation_Board_for_Testing_and_Calibration_Laboratories,,1,0,1,6e-06,31
upums.ac.in/,,1,0,1,6e-06,31
en.wikipedia.org/wiki/Special:Map/13/26.9608041/78.9606463/en,,1,0,1,6e-06,31
en.wikipedia.org/wiki/Saifai_village,,1,0,1,6e-06,31
en.wikipedia.org/wiki/File:UPUMS_Saifai_Hospital_Block.jpg,,1,0,1,6e-06,31
en.wikipedia.org/wiki/Ramakant_Yadav_(neurologist),,1,0,1,6e-06,31
en.wikipedia.org/wiki/T._Prabhakar,,1,0,1,6e-06,31
en.wikipedia.org/wiki/Uttar_Pradesh_Technical_University,,3,0,3,6e-06,31
youtube.com/watch?v=m1T5zBIdLic&t=333,,1,0,1,6e-06,31
search.wdoms.org/home/SchoolDetail/F0002311,,1,0,1,6e-06,31
jagran.com/uttar-pradesh/etawah-mch-course-started-in-medical-university-21169372.html,,1,0,1,6e-06,31
panjikaran2023.com/360/pareekshanam/upums2023/registration/UPUMS%20Prospectus.pdf,,1,0,1,6e-06,31
upums.ac.in/undergraduate,,1,0,1,6e-06,31
nirfindia.org/Rankings/2023/PharmacyRanking.html,,1,0,1,6e-06,31
cdn.tcsion.com/per/g06/pub/32742/ASM/WebPortal/2/Exam.html,,1,0,1,6e-06,31
upums.ac.in/overview,,1,0,1,6e-06,31
iitk.ac.in/new/joins-forces-with-upums-for-advancing-healthcare,,1,0,1,6e-06,31
amarujala.com/uttar-pradesh/etawah/kulpati-etawah-news-knp676245045,,1,0,1,6e-06,31
amarujala.com/uttar-pradesh/etawah/saifai-medical-university-vice-chancellor-etawah-news,,1,0,1,6e-06,31
m.jagran.com/uttar-pradesh/etawah-civic-18028373.html,,1,0,1,6e-06,31
m.jagran.com/uttar-pradesh/etawah-14235727.html,,1,0,1,6e-06,31
bhaskar.com/,,1,0,1,6e-06,31
kanpuruniversity.org/affiliated_colleges2.asp?dname=ETAWAH&dcode=EW,,2,0,2,6e-06,31
upums.ac.in/StaticPages/CollegeofDentistry.aspx,,1,0,1,6e-06,31
upums.ac.in/StaticPages/CollegeofParamedical.aspx,,1,0,1,6e-06,31
upums.ac.in/StaticPages/AboutNursing.aspx,,1,0,1,6e-06,31
web.archive.org/web/20190130142353/http://www.upums.ac.in/StaticPages/CollegeofPharmacy.aspx,,2,0,2,6e-06,31
pib.gov.in/pib.gov.in/Pressreleaseshare.aspx?PRID=1695599,,1,0,1,6e-06,31
en.wikipedia.org/wiki/Category:Uttar_Pradesh_University_of_Medical_Sciences,,1,0,1,6e-06,31
en.wikipedia.org/wiki/Category:Medical_and_health_sciences_universities_in_India,,1,0,1,6e-06,31
en.wikipedia.org/wiki/Category:Pharmacy_colleges_in_Uttar_Pradesh,,1,0,1,6e-06,31
en.wikipedia.org/wiki/Category:Nursing_schools_in_India,,1,0,1,6e-06,31
en.wikipedia.org/wiki/Category:Universities_and_colleges_in_Saifai,,1,0,1,6e-06,31
en.wikipedia.org/wiki/Category:2005_establishments_in_Uttar_Pradesh,,1,0,1,6e-06,31
en.wikipedia.org/wiki/Category:Public_medical_universities,,1,0,1,6e-06,31
upload.wikimedia.org/wikipedia/en/thumb/6/6f/UPUMS_logo.png/250px-UPUMS_logo.png,,1,0,1,6e-06,31
en.wikipedia.org/w/index.php?title=Special:CreateAccount&returnto=Unnao+Lok+Sabha+constituency,,1,0,1,6e-06,31
en.wikipedia.org/w/index.php?title=Special:UserLogin&returnto=Unnao+Lok+Sabha+constituency,,1,0,1,6e-06,31
bn.wikipedia.org/wiki/উন্নাও_লোকসভা_কেন্দ্র,,1,0,1,6e-06,31
hi.wikipedia.org/wiki/उन्नाव_लोक_सभा_निर्वाचन_क्षेत्र,,1,0,1,6e-06,31
mr.wikipedia.org/wiki/उन्नाव_लोकसभा_मतदारसंघ,,1,0,1,6e-06,31
pa.wikipedia.org/wiki/ਉਨਾਓ_ਲੋਕ_ਸਭਾ_ਹਲਕਾ,,1,0,1,6e-06,31
ta.wikipedia.org/wiki/உன்னாவு_மக்களவைத்_தொகுதி,,1,0,1,6e-06,31
te.wikipedia.org/wiki/ఉన్నావ్_లోక్‌సభ_నియోజకవర్గం,,1,0,1,6e-06,31
wikidata.org/wiki/Special:EntityPage/Q7897148,,1,0,1,6e-06,31
en.wikipedia.org/wiki/Talk:Unnao_Lok_Sabha_constituency,,1,0,1,6e-06,31
en.wikipedia.org/w/index.php?title=Unnao_Lok_Sabha_constituency&action=edit,,1,0,1,6e-06,31
en.wikipedia.org/w/index.php?title=Unnao_Lok_Sabha_constituency&action=history,,1,0,1,6e-06,31
en.wikipedia.org/wiki/Special:WhatLinksHere/Unnao_Lok_Sabha_constituency,,1,0,1,6e-06,31
en.wikipedia.org/wiki/Special:RecentChangesLinked/Unnao_Lok_Sabha_constituency,,1,0,1,6e-06,31
en.wikipedia.org/w/index.php?title=Unnao_Lok_Sabha_constituency&oldid=1309650059,,1,0,1,6e-06,31
en.wikipedia.org/w/index.php?title=Unnao_Lok_Sabha_constituency&action=info,,1,0,1,6e-06,31
en.wikipedia.org/w/index.php?title=Unnao_Lok_Sabha_constituency&printable=yes,,1,0,1,6e-06,31
geohack.toolforge.org/geohack.php?pagename=Unnao_Lok_Sabha_constituency&params=26.59_N_80.52_E_,,1,0,1,6e-06,31
"en.wikipedia.org/wiki/File:Sakshi_Maharaj,_2020.jpg",,1,0,1,6e-06,31
en.wikipedia.org/wiki/Sakshi_Maharaj,,1,0,1,6e-06,31
en.wikipedia.org/w/index.php?title=Unnao_Lok_Sabha_constituency&action=edit&section=1,,1,0,1,6e-06,31
en.wikipedia.org/w/index.php?title=Unnao_Lok_Sabha_constituency&action=edit&section=2,,1,0,1,6e-06,31
en.wikipedia.org/wiki/Vishwambhar_Dayal_Tripathi,,1,0,1,6e-06,31
en.wikipedia.org/wiki/Krishna_Dev_Tripathi,,1,0,1,6e-06,31
en.wikipedia.org/wiki/Raghavendra_Singh,,1,0,1,6e-06,31
en.wikipedia.org/wiki/Ziaur_Rahman_Ansari,,1,0,1,6e-06,31
en.wikipedia.org/wiki/Anwar_Ahmad,,1,0,1,6e-06,31
en.wikipedia.org/wiki/Devi_Bux_Singh,,1,0,1,6e-06,31
en.wikipedia.org/wiki/Deepak_Kumar_(politician),,1,0,1,6e-06,31
en.wikipedia.org/w/index.php?title=Unnao_Lok_Sabha_constituency&action=edit&section=3,,1,0,1,6e-06,31
en.wikipedia.org/w/index.php?title=Unnao_Lok_Sabha_constituency&action=edit&section=4,,1,0,1,6e-06,31
en.wikipedia.org/w/index.php?title=Unnao_Lok_Sabha_constituency&action=edit&section=5,,1,0,1,6e-06,31
en.wikipedia.org/w/index.php?title=Unnao_Lok_Sabha_constituency&action=edit&section=6,,1,0,1,6e-06,31
en.wikipedia.org/w/index.php?title=Unnao_Lok_Sabha_constituency&action=edit&section=7,,1,0,1,6e-06,31
en.wikipedia.org/w/index.php?title=Unnao_Lok_Sabha_constituency&action=edit&section=8,,1,0,1,6e-06,31
en.wikipedia.org/wiki/2004_Indian_general_elections,,3,0,3,6e-06,31
en.wikipedia.org/w/index.php?title=Unnao_Lok_Sabha_constituency&action=edit&section=9,,1,0,1,6e-06,31
en.wikipedia.org/w/index.php?title=Unnao_Lok_Sabha_constituency&action=edit&section=10,,1,0,1,6e-06,31
164.100.47.194/loksabha/members/MemberBioprofile.aspx?mpsno=3586,,1,0,1,6e-06,31
oneindia.com/unnao-lok-sabha-election-result-449/,,1,0,1,6e-06,31
news18.com/lok-sabha-elections-2019/uttar-pradesh/unnao-election-result-s24p33/,,1,0,1,6e-06,31
results.eci.gov.in/PcResultGenJune2024/candidateswise-S2433.htm,,1,0,1,6e-06,31
en.m.wikipedia.org/w/index.php?title=Unnao_Lok_Sabha_constituency&mobileaction=toggle_view_mobile,,1,0,1,6e-06,31
en.wikipedia.org/w/index.php?title=Special:CreateAccount&returnto=Tirwa%2C+Kannauj,,1,0,1,6e-06,31
en.wikipedia.org/w/index.php?title=Special:UserLogin&returnto=Tirwa%2C+Kannauj,,1,0,1,6e-06,31
zh-min-nan.wikipedia.org/wiki/Tirwaganj,,1,0,1,6e-06,31
es.wikipedia.org/wiki/Tirwaganj,,1,0,1,6e-06,31
"hi.wikipedia.org/wiki/तिर्वा,_कन्नौज",,1,0,1,6e-06,31
bpy.wikipedia.org/wiki/তিরৱাগঞ্জ,,1,0,1,6e-06,31
it.wikipedia.org/wiki/Tirwaganj,,1,0,1,6e-06,31
mg.wikipedia.org/wiki/Tirwaganj,,1,0,1,6e-06,31
ms.wikipedia.org/wiki/Tirwaganj,,1,0,1,6e-06,31
nl.wikipedia.org/wiki/Tirwaganj,,1,0,1,6e-06,31
pnb.wikipedia.org/wiki/ترواگنج,,1,0,1,6e-06,31
pl.wikipedia.org/wiki/Tirwaganj,,1,0,1,6e-06,31
pt.wikipedia.org/wiki/Tirwaganj,,1,0,1,6e-06,31
ru.wikipedia.org/wiki/Тирвагандж,,1,0,1,6e-06,31
ur.wikipedia.org/wiki/ترواگنج,,1,0,1,6e-06,31
vi.wikipedia.org/wiki/Tirwaganj,,1,0,1,6e-06,31
zh.wikipedia.org/wiki/蒂尔瓦甘杰,,1,0,1,6e-06,31
wikidata.org/wiki/Special:EntityPage/Q2717199,,1,0,1,6e-06,31
"en.wikipedia.org/wiki/Talk:Tirwa,_Kannauj",,1,0,1,6e-06,31
"en.wikipedia.org/w/index.php?title=Tirwa,_Kannauj&action=edit",,1,0,1,6e-06,31
"en.wikipedia.org/w/index.php?title=Tirwa,_Kannauj&action=history",,1,0,1,6e-06,31
"en.wikipedia.org/wiki/Special:WhatLinksHere/Tirwa,_Kannauj",,1,0,1,6e-06,31
"en.wikipedia.org/wiki/Special:RecentChangesLinked/Tirwa,_Kannauj",,1,0,1,6e-06,31
"en.wikipedia.org/w/index.php?title=Tirwa,_Kannauj&oldid=1267265818",,1,0,1,6e-06,31
"en.wikipedia.org/w/index.php?title=Tirwa,_Kannauj&action=info",,1,0,1,6e-06,31
"en.wikipedia.org/w/index.php?title=Tirwa,_Kannauj&printable=yes",,1,0,1,6e-06,31
en.wikipedia.org/wiki/Lakh-Bahosi_bird_sanctuary,,1,0,1,6e-06,31
"en.wikipedia.org/wiki/National_Highway_91A_(India,_old_numbering)",,1,0,1,6e-06,31
"en.wikipedia.org/w/index.php?title=Tirwa,_Kannauj&action=edit&section=1",,1,0,1,6e-06,31
"en.wikipedia.org/w/index.php?title=Tirwa,_Kannauj&action=edit&section=2",,1,0,1,6e-06,31
"en.wikipedia.org/w/index.php?title=Tirwa,_Kannauj&action=edit&section=3",,1,0,1,6e-06,31
web.archive.org/web/20101024211219/http://kannauj.nic.in/visit.htm,,1,0,1,6e-06,31
kannauj.nic.in/visit.htm,,1,0,1,6e-06,31
jagran.com/uttar-pradesh/kannauj-12674517.html,,1,0,1,6e-06,31
en.wikipedia.org/wiki/Template:Kannauj-geo-stub,,1,0,1,6e-06,31
en.wikipedia.org/wiki/Template_talk:Kannauj-geo-stub,,1,0,1,6e-06,31
en.wikipedia.org/wiki/Special:EditPage/Template:Kannauj-geo-stub,,1,0,1,6e-06,31
"en.m.wikipedia.org/w/index.php?title=Tirwa,_Kannauj&mobileaction=toggle_view_mobile",,1,0,1,6e-06,31
en.wikipedia.org/w/index.php?title=Special:CreateAccount&returnto=The+Mall%2C+Kanpur,,1,0,1,6e-06,31
en.wikipedia.org/w/index.php?title=Special:UserLogin&returnto=The+Mall%2C+Kanpur,,1,0,1,6e-06,31
wikidata.org/wiki/Special:EntityPage/Q24951833,,1,0,1,6e-06,31
"en.wikipedia.org/wiki/Talk:The_Mall,_Kanpur",,1,0,1,6e-06,31
"en.wikipedia.org/w/index.php?title=The_Mall,_Kanpur&action=edit",,1,0,1,6e-06,31
"en.wikipedia.org/w/index.php?title=The_Mall,_Kanpur&action=history",,1,0,1,6e-06,31
"en.wikipedia.org/wiki/Special:WhatLinksHere/The_Mall,_Kanpur",,1,0,1,6e-06,31
"en.wikipedia.org/wiki/Special:RecentChangesLinked/The_Mall,_Kanpur",,1,0,1,6e-06,31
"en.wikipedia.org/w/index.php?title=The_Mall,_Kanpur&oldid=1300719648",,1,0,1,6e-06,31
"en.wikipedia.org/w/index.php?title=The_Mall,_Kanpur&action=info",,1,0,1,6e-06,31
"en.wikipedia.org/w/index.php?title=The_Mall,_Kanpur&printable=yes",,1,0,1,6e-06,31
"en.wikipedia.org/wiki/Special:EditPage/The_Mall,_Kanpur",,1,0,1,6e-06,31
"google.com/search?as_eq=wikipedia&q=""The+Mall%2C+Kanpur""",,1,0,1,6e-06,31
"google.com/search?tbm=nws&q=""The+Mall%2C+Kanpur""+-wikipedia&tbs=ar:1",,1,0,1,6e-06,31
"google.com/search?&q=""The+Mall%2C+Kanpur""&tbs=bkt:s&tbm=bks",,1,0,1,6e-06,31
"google.com/search?tbs=bks:1&q=""The+Mall%2C+Kanpur""+-wikipedia",,1,0,1,6e-06,31
"scholar.google.com/scholar?q=""The+Mall%2C+Kanpur""",,1,0,1,6e-06,31
"jstor.org/action/doBasicSearch?Query=""The+Mall%2C+Kanpur""&acc=on&wc=on",,1,0,1,6e-06,31
en.wikipedia.org/wiki/Central_business_district,,1,0,1,6e-06,31
"en.wikipedia.org/w/index.php?title=The_Mall,_Kanpur&action=edit&section=1",,1,0,1,6e-06,31
"en.wikipedia.org/wiki/Meston_Road,_Kanpur",,1,0,1,6e-06,31
en.wikipedia.org/wiki/Ursula_Horsman_Memorial_Hospital,,1,0,1,6e-06,31
en.wikipedia.org/wiki/Standard_Chartered_Bank,,1,0,1,6e-06,31
"en.wikipedia.org/wiki/Birhana_Road,_Kanpur",,1,0,1,6e-06,31
"en.wikipedia.org/w/index.php?title=The_Mall,_Kanpur&action=edit&section=2",,1,0,1,6e-06,31
en.wikipedia.org/wiki/Society_for_the_Propagation_of_the_Gospel_in_Foreign_Parts,,1,0,1,6e-06,31
"en.wikipedia.org/w/index.php?title=The_Mall,_Kanpur&action=edit&section=3",,1,0,1,6e-06,31
en.wikipedia.org/wiki/Naveen_Market,,1,0,1,6e-06,31
en.wikipedia.org/wiki/Som_Dutt_Plaza,,1,0,1,6e-06,31
"en.wikipedia.org/w/index.php?title=The_Mall,_Kanpur&action=edit&section=4",,1,0,1,6e-06,31
"en.wikipedia.org/wiki/Latouche_Road,_Kanpur",,1,0,1,6e-06,31
"en.wikipedia.org/w/index.php?title=The_Mall,_Kanpur&action=edit&section=5",,1,0,1,6e-06,31
kanpurashish.blogspot.com/2011/03/blog-post.html,,1,0,1,6e-06,31
web.archive.org/web/20110713182723/http://www.lal-imli.com/feedback.html,,1,0,1,6e-06,31
lal-imli.com/feedback.html,,1,0,1,6e-06,31
flickr.com/photos/66541995@N00/23476681884/sizes/l,,1,0,1,6e-06,31
customerhelplinenumber.com/pin-code-208001-list-of-post-office-kanpur-uttar-pradesh.html,,1,0,1,6e-06,31
web.archive.org/web/20100724004521/https://www.licindia.in/address_id_p&g.htm,,1,0,1,6e-06,31
licindia.in/address_id_p&g.htm,,1,0,1,6e-06,31
books.google.com/books?id=RcQBAAAAMAAJ&q=mall+road+kanpur+entry+indian,,1,0,1,6e-06,31
timesofindia.indiatimes.com/city/I-never-thought-of-leaving-Kanpur/articleshow/381196.cms,,1,0,1,6e-06,31
web.archive.org/web/20150616030127/http://cccknp.ac.in/contactus.html,,1,0,1,6e-06,31
cccknp.ac.in/contactus.html,,1,0,1,6e-06,31
books.google.com/books?id=PcRZBgAAQBAJ&q=Ursula+Horsman&pg=PT32,,1,0,1,6e-06,31
stcatherineshospital.org.in/,,1,0,1,6e-06,31
en.wikipedia.org/wiki/Category:Articles_needing_additional_references_from_May_2016,,1,0,1,6e-06,31
"en.m.wikipedia.org/w/index.php?title=The_Mall,_Kanpur&mobileaction=toggle_view_mobile",,1,0,1,6e-06,31
en.wikipedia.org/w/index.php?title=Special:UserLogin&returnto=Template+talk%3AKanpur+division+topics,,1,0,1,7e-06,31
en.wikipedia.org/w/index.php?title=Template_talk:Kanpur_division_topics&action=edit,,1,0,1,7e-06,31
en.wikipedia.org/w/index.php?title=Template_talk:Kanpur_division_topics&action=edit&section=new,,1,0,1,7e-06,31
en.wikipedia.org/w/index.php?title=Template_talk:Kanpur_division_topics&action=history,,1,0,1,7e-06,31
en.wikipedia.org/wiki/Special:WhatLinksHere/Template_talk:Kanpur_division_topics,,1,0,1,7e-06,31
en.wikipedia.org/wiki/Special:RecentChangesLinked/Template_talk:Kanpur_division_topics,,1,0,1,7e-06,31
en.wikipedia.org/w/index.php?title=Template_talk:Kanpur_division_topics&oldid=1232504467,,1,0,1,7e-06,31
en.wikipedia.org/w/index.php?title=Template_talk:Kanpur_division_topics&action=info,,1,0,1,7e-06,31
en.wikipedia.org/w/index.php?title=Template_talk:BRICS_Universities_League&action=edit,,1,0,1,7e-06,31
en.wikipedia.org/w/index.php?title=Template_talk:BRICS_Universities_League&action=edit&section=new,,1,0,1,7e-06,31
en.wikipedia.org/w/index.php?title=Template_talk:BRICS_Universities_League&action=history,,1,0,1,7e-06,31
en.wikipedia.org/wiki/Special:WhatLinksHere/Template_talk:BRICS_Universities_League,,1,0,1,7e-06,31
en.wikipedia.org/wiki/Special:RecentChangesLinked/Template_talk:BRICS_Universities_League,,1,0,1,7e-06,31
en.wikipedia.org/w/index.php?title=Template_talk:BRICS_Universities_League&oldid=1261982205,,1,0,1,7e-06,31
en.wikipedia.org/w/index.php?title=Template_talk:BRICS_Universities_League&action=info,,1,0,1,7e-06,31
en.wikipedia.org/wiki/File:WikiProject_Russia.svg,,1,0,1,7e-06,31
en.wikipedia.org/wiki/Wikipedia:WikiProject_Russia,,1,0,1,7e-06,31
en.wikipedia.org/wiki/Portal:Russia,,1,0,1,7e-06,31
en.wikipedia.org/wiki/Wikipedia_talk:WikiProject_Russia,,1,0,1,7e-06,31
en.wikipedia.org/wiki/File:TempleofHeaven-HallofPrayer.jpg,,1,0,1,7e-06,31
en.wikipedia.org/wiki/Wikipedia:WikiProject_China,,1,0,1,7e-06,31
en.wikipedia.org/wiki/Portal:China,,1,0,1,7e-06,31
en.wikipedia.org/wiki/Wikipedia_talk:WikiProject_China,,1,0,1,7e-06,31
en.wikipedia.org/wiki/Category:Template-Class_Russia_pages,,1,0,1,7e-06,31
en.wikipedia.org/wiki/Category:NA-importance_Russia_pages,,1,0,1,7e-06,31
en.wikipedia.org/wiki/Category:WikiProject_Russia_articles_with_no_associated_task_force,,1,0,1,7e-06,31
en.wikipedia.org/wiki/Category:WikiProject_Russia_articles,,1,0,1,7e-06,31
en.wikipedia.org/wiki/Category:Template-Class_China-related_pages,,1,0,1,7e-06,31
en.wikipedia.org/wiki/Category:NA-importance_China-related_pages,,1,0,1,7e-06,31
en.wikipedia.org/wiki/Category:WikiProject_China_articles,,1,0,1,7e-06,31
en.wikipedia.org/w/index.php?title=Special:UserLogin&returnto=Template%3AVaranasi+division+topics,,1,0,1,7e-06,31
ur.wikipedia.org/wiki/سانچہ:وارانسی_ڈویژن_کے_موضوعات,,1,0,1,7e-06,31
wikidata.org/wiki/Special:EntityPage/Q22718242,,1,0,1,7e-06,31
en.wikipedia.org/wiki/Template_talk:Varanasi_division_topics,,1,0,1,7e-06,31
en.wikipedia.org/w/index.php?title=Template:Varanasi_division_topics&action=edit,,1,0,1,7e-06,31
en.wikipedia.org/w/index.php?title=Template:Varanasi_division_topics&action=history,,1,0,1,7e-06,31
en.wikipedia.org/wiki/Special:WhatLinksHere/Template:Varanasi_division_topics,,1,0,1,7e-06,31
en.wikipedia.org/wiki/Special:RecentChangesLinked/Template:Varanasi_division_topics,,1,0,1,7e-06,31
en.wikipedia.org/w/index.php?title=Template:Varanasi_division_topics&oldid=1157889050,,1,0,1,7e-06,31
en.wikipedia.org/w/index.php?title=Template:Varanasi_division_topics&action=info,,1,0,1,7e-06,31
en.wikipedia.org/wiki/Special:EditPage/Template:Varanasi_division_topics,,1,0,1,7e-06,31
en.wikipedia.org/wiki/Varanasi_Nagar_Nigam,,1,0,1,7e-06,31
en.wikipedia.org/wiki/Jaunpur_Sultanate,,2,0,2,7e-06,31
en.wikipedia.org/wiki/Kerakat,,1,0,1,7e-06,31
en.wikipedia.org/wiki/Jaunpur_Junction,,1,0,1,7e-06,31
"en.wikipedia.org/wiki/Shahi_Bridge,_Jaunpur",,1,0,1,7e-06,31
en.wikipedia.org/wiki/Chandauli_(Lok_Sabha_constituency),,1,0,1,7e-06,31
en.wikipedia.org/wiki/Ghazipur_(Lok_Sabha_constituency),,1,0,1,7e-06,31
en.wikipedia.org/wiki/Jaunpur_(Lok_Sabha_constituency),,1,0,1,7e-06,31
en.wikipedia.org/wiki/Machhlishahr_(Lok_Sabha_constituency),,1,0,1,7e-06,31
en.wikipedia.org/wiki/Template:Chandauli_district,,1,0,1,7e-06,31
en.wikipedia.org/wiki/Template:Ghazipur_district,,1,0,1,7e-06,31
en.wikipedia.org/wiki/Template:Jaunpur_district,,1,0,1,7e-06,31
en.wikipedia.org/wiki/Template:Varanasi_district,,1,0,1,7e-06,31
en.wikipedia.org/wiki/Category:Villages_in_Chandauli_district,,1,0,1,7e-06,31
en.wikipedia.org/wiki/Category:Villages_in_Ghazipur_district,,1,0,1,7e-06,31
en.wikipedia.org/wiki/Category:Villages_in_Jaunpur_district,,1,0,1,7e-06,31
en.wikipedia.org/wiki/Category:Villages_in_Varanasi_district,,1,0,1,7e-06,31
en.wikipedia.org/wiki/Category:People_from_Chandauli,,1,0,1,7e-06,31
en.wikipedia.org/wiki/Category:People_from_Ghazipur,,1,0,1,7e-06,31
en.wikipedia.org/wiki/Category:People_from_Jaunpur_district,,1,0,1,7e-06,31
en.wikipedia.org/wiki/Category:People_from_Varanasi,,1,0,1,7e-06,31
templatetransclusioncheck.toolforge.org/?lang=en&name=Template:Varanasi_division_topics,,1,0,1,7e-06,31
en.wikipedia.org/wiki/Special:PrefixIndex/Template:Varanasi_division_topics/,,1,0,1,7e-06,31
en.wikipedia.org/wiki/Category:Varanasi_division,,1,0,1,7e-06,31
en.wikipedia.org/wiki/Category:Uttar_Pradesh_topics_templates,,18,0,18,8e-06,31
en.wikipedia.org/w/index.php?title=Special:UserLogin&returnto=Template%3ASaharanpur+division+topics,,1,0,1,7e-06,31
bn.wikipedia.org/wiki/টেমপ্লেট:শাহারানপুর_বিভাগ,,1,0,1,7e-06,31
wikidata.org/wiki/Special:EntityPage/Q22751528,,1,0,1,7e-06,31
en.wikipedia.org/wiki/Template_talk:Saharanpur_division_topics,,1,0,1,7e-06,31
en.wikipedia.org/w/index.php?title=Template:Saharanpur_division_topics&action=edit,,1,0,1,7e-06,31
en.wikipedia.org/w/index.php?title=Template:Saharanpur_division_topics&action=history,,1,0,1,7e-06,31
en.wikipedia.org/wiki/Special:WhatLinksHere/Template:Saharanpur_division_topics,,1,0,1,7e-06,31
en.wikipedia.org/wiki/Special:RecentChangesLinked/Template:Saharanpur_division_topics,,1,0,1,7e-06,31
en.wikipedia.org/w/index.php?title=Template:Saharanpur_division_topics&oldid=1225012581,,1,0,1,7e-06,31
en.wikipedia.org/w/index.php?title=Template:Saharanpur_division_topics&action=info,,1,0,1,7e-06,31
en.wikipedia.org/wiki/Special:EditPage/Template:Saharanpur_division_topics,,1,0,1,7e-06,31
"en.wikipedia.org/wiki/National_Highway_58_(India,_old_numbering)",,1,0,1,7e-06,31
en.wikipedia.org/wiki/Template:Shamli_district,,1,0,1,7e-06,31
en.wikipedia.org/wiki/Template:Muzaffarnagar_district,,1,0,1,7e-06,31
en.wikipedia.org/wiki/Template:Saharanpur_district,,1,0,1,7e-06,31
en.wikipedia.org/wiki/Category:Villages_in_Muzaffarnagar_district,,1,0,1,7e-06,31
en.wikipedia.org/wiki/Category:Villages_in_Saharanpur_district,,1,0,1,7e-06,31
en.wikipedia.org/wiki/Category:Villages_in_Shamli_district,,1,0,1,7e-06,31
en.wikipedia.org/wiki/Category:People_from_Muzaffarnagar,,1,0,1,7e-06,31
en.wikipedia.org/wiki/Category:People_from_Saharanpur,,1,0,1,7e-06,31
en.wikipedia.org/wiki/Category:People_from_Shamli,,1,0,1,7e-06,31
templatetransclusioncheck.toolforge.org/?lang=en&name=Template:Saharanpur_division_topics,,1,0,1,7e-06,31
en.wikipedia.org/wiki/Special:PrefixIndex/Template:Saharanpur_division_topics/,,1,0,1,7e-06,31
en.wikipedia.org/wiki/Category:Divisions_of_Uttar_Pradesh,,14,0,14,7e-06,31
en.wikipedia.org/w/index.php?title=Special:UserLogin&returnto=Template%3AMirzapur+Division+topics,,1,0,1,7e-06,31
wikidata.org/wiki/Special:EntityPage/Q22768249,,1,0,1,7e-06,31
en.wikipedia.org/wiki/Template_talk:Mirzapur_Division_topics,,1,0,1,7e-06,31
en.wikipedia.org/w/index.php?title=Template:Mirzapur_Division_topics&action=edit,,1,0,1,7e-06,31
en.wikipedia.org/w/index.php?title=Template:Mirzapur_Division_topics&action=history,,1,0,1,7e-06,31
en.wikipedia.org/wiki/Special:WhatLinksHere/Template:Mirzapur_Division_topics,,1,0,1,7e-06,31
en.wikipedia.org/wiki/Special:RecentChangesLinked/Template:Mirzapur_Division_topics,,1,0,1,7e-06,31
en.wikipedia.org/w/index.php?title=Template:Mirzapur_Division_topics&oldid=1178541127,,1,0,1,7e-06,31
en.wikipedia.org/w/index.php?title=Template:Mirzapur_Division_topics&action=info,,1,0,1,7e-06,31
en.wikipedia.org/wiki/Special:EditPage/Template:Mirzapur_Division_topics,,1,0,1,7e-06,31
en.wikipedia.org/wiki/Govind_Ballabh_Pant_Sagar,,1,0,1,7e-06,31
en.wikipedia.org/wiki/National_Highway_76_(India),,3,0,3,7e-06,31
en.wikipedia.org/wiki/Mayurpur_Airport,,1,0,1,7e-06,31
en.wikipedia.org/wiki/Singrauli_Coalfield,,1,0,1,7e-06,31
en.wikipedia.org/wiki/Mirzapur_(Lok_Sabha_constituency),,1,0,1,7e-06,31
en.wikipedia.org/wiki/Bhadohi_(Lok_Sabha_constituency),,1,0,1,7e-06,31
en.wikipedia.org/wiki/Robertsganj_(Lok_Sabha_constituency),,1,0,1,7e-06,31
en.wikipedia.org/wiki/Template:Mirzapur_district,,1,0,1,7e-06,31
en.wikipedia.org/wiki/Template:Bhadohi_district,,1,0,1,7e-06,31
en.wikipedia.org/wiki/Template:Sonbhadra_district,,1,0,1,7e-06,31
en.wikipedia.org/wiki/Category:Villages_in_Mirzapur_district,,1,0,1,7e-06,31
en.wikipedia.org/wiki/Category:Villages_in_Bhadohi_district,,1,0,1,7e-06,31
en.wikipedia.org/wiki/Category:People_from_Mirzapur,,1,0,1,7e-06,31
en.wikipedia.org/wiki/Category:People_from_Bhadohi_district,,1,0,1,7e-06,31
templatetransclusioncheck.toolforge.org/?lang=en&name=Template:Mirzapur_Division_topics,,1,0,1,7e-06,31
en.wikipedia.org/wiki/Special:PrefixIndex/Template:Mirzapur_Division_topics/,,1,0,1,7e-06,31
en.wikipedia.org/w/index.php?title=Special:CreateAccount&returnto=Template%3AMeerut+division+topics,,1,0,1,7e-06,31
en.wikipedia.org/w/index.php?title=Special:UserLogin&returnto=Template%3AMeerut+division+topics,,1,0,1,7e-06,31
bn.wikipedia.org/wiki/টেমপ্লেট:মিরাট_বিভাগের_বিষয়,,1,0,1,7e-06,31
ml.wikipedia.org/wiki/ഫലകം:Meerut_division_topics,,1,0,1,7e-06,31
wikidata.org/wiki/Special:EntityPage/Q22759148,,1,0,1,7e-06,31
en.wikipedia.org/w/index.php?title=Template:Meerut_division_topics&action=edit,,1,0,1,7e-06,31
en.wikipedia.org/w/index.php?title=Template:Meerut_division_topics&action=history,,1,0,1,7e-06,31
en.wikipedia.org/wiki/Special:WhatLinksHere/Template:Meerut_division_topics,,1,0,1,7e-06,31
en.wikipedia.org/wiki/Special:RecentChangesLinked/Template:Meerut_division_topics,,1,0,1,7e-06,31
en.wikipedia.org/w/index.php?title=Template:Meerut_division_topics&oldid=1178588569,,1,0,1,7e-06,31
en.wikipedia.org/w/index.php?title=Template:Meerut_division_topics&action=info,,1,0,1,7e-06,31
templatetransclusioncheck.toolforge.org/?lang=en&name=Template:Meerut_division_topics,,1,0,1,7e-06,31
en.wikipedia.org/wiki/Special:PrefixIndex/Template:Meerut_division_topics/,,1,0,1,7e-06,31
en.wikipedia.org/wiki/Category:Meerut_division,,1,0,1,7e-06,31
en.m.wikipedia.org/w/index.php?title=Template:Meerut_division_topics&mobileaction=toggle_view_mobile,,1,0,1,7e-06,31
en.wikipedia.org/w/index.php?title=Special:UserLogin&returnto=Template%3AMoradabad+division+topics,,1,0,1,7e-06,31
wikidata.org/wiki/Special:EntityPage/Q22718837,,1,0,1,7e-06,31
en.wikipedia.org/wiki/Template_talk:Moradabad_division_topics,,1,0,1,7e-06,31
en.wikipedia.org/w/index.php?title=Template:Moradabad_division_topics&action=edit,,1,0,1,7e-06,31
en.wikipedia.org/w/index.php?title=Template:Moradabad_division_topics&action=history,,1,0,1,7e-06,31
en.wikipedia.org/wiki/Special:WhatLinksHere/Template:Moradabad_division_topics,,1,0,1,7e-06,31
en.wikipedia.org/wiki/Special:RecentChangesLinked/Template:Moradabad_division_topics,,1,0,1,7e-06,31
en.wikipedia.org/w/index.php?title=Template:Moradabad_division_topics&oldid=1178736778,,1,0,1,7e-06,31
en.wikipedia.org/w/index.php?title=Template:Moradabad_division_topics&action=info,,1,0,1,7e-06,31
en.wikipedia.org/wiki/Special:EditPage/Template:Moradabad_division_topics,,1,0,1,7e-06,31
en.wikipedia.org/wiki/National_Highway_93_(India),,8,0,8,7e-06,31
en.wikipedia.org/wiki/Bijnor_(Lok_Sabha_constituency),,1,0,1,7e-06,31
en.wikipedia.org/wiki/Amroha_(Lok_Sabha_constituency),,1,0,1,7e-06,31
en.wikipedia.org/wiki/Moradabad_(Lok_Sabha_constituency),,1,0,1,7e-06,31
en.wikipedia.org/wiki/Sambhal_(Lok_Sabha_constituency),,1,0,1,7e-06,31
en.wikipedia.org/wiki/Rampur_(Lok_Sabha_constituency),,1,0,1,7e-06,31
en.wikipedia.org/wiki/Nagina_(Lok_Sabha_constituency),,1,0,1,7e-06,31
en.wikipedia.org/wiki/Template:Amroha_district,,1,0,1,7e-06,31
en.wikipedia.org/wiki/Template:Bijnor_district,,1,0,1,7e-06,31
en.wikipedia.org/wiki/Template:Moradabad_district,,1,0,1,7e-06,31
en.wikipedia.org/wiki/Template:Sambhal_district,,1,0,1,7e-06,31
en.wikipedia.org/wiki/Template:Rampur_district,,1,0,1,7e-06,31
en.wikipedia.org/wiki/Category:Villages_in_Bijnor_district,,1,0,1,7e-06,31
en.wikipedia.org/wiki/Category:Villages_in_Moradabad_district,,1,0,1,7e-06,31
en.wikipedia.org/wiki/Category:Villages_in_Sambhal_district,,1,0,1,7e-06,31
en.wikipedia.org/wiki/Category:People_from_Bijnor,,1,0,1,7e-06,31
en.wikipedia.org/wiki/Category:People_from_Moradabad,,1,0,1,7e-06,31
"en.wikipedia.org/wiki/Category:People_from_Rampur,_Uttar_Pradesh",,1,0,1,7e-06,31
templatetransclusioncheck.toolforge.org/?lang=en&name=Template:Moradabad_division_topics,,1,0,1,7e-06,31
en.wikipedia.org/wiki/Special:PrefixIndex/Template:Moradabad_division_topics/,,1,0,1,7e-06,31
en.wikipedia.org/w/index.php?title=Special:CreateAccount&returnto=Template%3ALucknow+division+topics,,1,0,1,6e-06,31
en.wikipedia.org/w/index.php?title=Special:UserLogin&returnto=Template%3ALucknow+division+topics,,1,0,1,6e-06,31
ur.wikipedia.org/wiki/سانچہ:لکھنؤ_ڈویژن_کے_موضوعات,,1,0,1,6e-06,31
wikidata.org/wiki/Special:EntityPage/Q22744292,,1,0,1,6e-06,31
en.wikipedia.org/w/index.php?title=Template:Lucknow_division_topics&action=edit,,1,0,1,6e-06,31
en.wikipedia.org/w/index.php?title=Template:Lucknow_division_topics&action=history,,1,0,1,6e-06,31
en.wikipedia.org/wiki/Special:WhatLinksHere/Template:Lucknow_division_topics,,1,0,1,6e-06,31
en.wikipedia.org/wiki/Special:RecentChangesLinked/Template:Lucknow_division_topics,,1,0,1,6e-06,31
en.wikipedia.org/w/index.php?title=Template:Lucknow_division_topics&oldid=1157888109,,1,0,1,6e-06,31
en.wikipedia.org/w/index.php?title=Template:Lucknow_division_topics&action=info,,1,0,1,6e-06,31
templatetransclusioncheck.toolforge.org/?lang=en&name=Template:Lucknow_division_topics,,1,0,1,6e-06,31
en.wikipedia.org/wiki/Special:PrefixIndex/Template:Lucknow_division_topics/,,1,0,1,6e-06,31
en.wikipedia.org/wiki/Category:Lucknow_division,,1,0,1,6e-06,31
en.wikipedia.org/wiki/Category:Lucknow_templates,,1,0,1,6e-06,31
en.wikipedia.org/w/index.php?title=Special:CreateAccount&returnto=Template%3AKanpur+Nagar+district,,1,0,1,6e-06,31
en.wikipedia.org/w/index.php?title=Special:UserLogin&returnto=Template%3AKanpur+Nagar+district,,1,0,1,6e-06,31
hi.wikipedia.org/wiki/साँचा:कानपुर_नगर_जिला,,1,0,1,6e-06,31
wikidata.org/wiki/Special:EntityPage/Q22717791,,1,0,1,6e-06,31
en.wikipedia.org/w/index.php?title=Template:Kanpur_Nagar_district&action=edit,,1,0,1,6e-06,31
en.wikipedia.org/w/index.php?title=Template:Kanpur_Nagar_district&action=history,,1,0,1,6e-06,31
en.wikipedia.org/wiki/Special:WhatLinksHere/Template:Kanpur_Nagar_district,,1,0,1,6e-06,31
en.wikipedia.org/wiki/Special:RecentChangesLinked/Template:Kanpur_Nagar_district,,1,0,1,6e-06,31
en.wikipedia.org/w/index.php?title=Template:Kanpur_Nagar_district&oldid=1178746326,,1,0,1,6e-06,31
en.wikipedia.org/w/index.php?title=Template:Kanpur_Nagar_district&action=info,,1,0,1,6e-06,31
templatetransclusioncheck.toolforge.org/?lang=en&name=Template:Kanpur_Nagar_district,,1,0,1,6e-06,31
en.wikipedia.org/wiki/Special:PrefixIndex/Template:Kanpur_Nagar_district/,,1,0,1,6e-06,31
en.wikipedia.org/wiki/Category:Uttar_Pradesh_district_templates,,6,0,6,7e-06,31
en.m.wikipedia.org/w/index.php?title=Template:Kanpur_Nagar_district&mobileaction=toggle_view_mobile,,1,0,1,6e-06,31
en.wikipedia.org/w/index.php?title=Special:CreateAccount&returnto=Template%3AKanpur+division+topics,,1,0,1,6e-06,31
en.wikipedia.org/w/index.php?title=Special:UserLogin&returnto=Template%3AKanpur+division+topics,,1,0,1,6e-06,31
bn.wikipedia.org/wiki/টেমপ্লেট:কানপুর_বিভাগের_প্রসঙ্গ,,1,0,1,6e-06,31
ml.wikipedia.org/wiki/ഫലകം:Kanpur_division_topics,,1,0,1,6e-06,31
wikidata.org/wiki/Special:EntityPage/Q22717808,,1,0,1,6e-06,31
en.wikipedia.org/w/index.php?title=Template:Kanpur_division_topics&action=edit,,1,0,1,6e-06,31
en.wikipedia.org/w/index.php?title=Template:Kanpur_division_topics&action=history,,1,0,1,6e-06,31
en.wikipedia.org/wiki/Special:WhatLinksHere/Template:Kanpur_division_topics,,1,0,1,6e-06,31
en.wikipedia.org/wiki/Special:RecentChangesLinked/Template:Kanpur_division_topics,,1,0,1,6e-06,31
en.wikipedia.org/w/index.php?title=Template:Kanpur_division_topics&oldid=1195144761,,1,0,1,6e-06,31
en.wikipedia.org/w/index.php?title=Template:Kanpur_division_topics&action=info,,1,0,1,6e-06,31
templatetransclusioncheck.toolforge.org/?lang=en&name=Template:Kanpur_division_topics,,1,0,1,6e-06,31
en.wikipedia.org/wiki/Special:PrefixIndex/Template:Kanpur_division_topics/,,1,0,1,6e-06,31
en.m.wikipedia.org/w/index.php?title=Template:Kanpur_division_topics&mobileaction=toggle_view_mobile,,1,0,1,6e-06,31
en.wikipedia.org/w/index.php?title=Special:CreateAccount&returnto=Template%3AKanpur+Dehat+district,,1,0,1,6e-06,31
en.wikipedia.org/w/index.php?title=Special:UserLogin&returnto=Template%3AKanpur+Dehat+district,,1,0,1,6e-06,31
fa.wikipedia.org/wiki/الگو:بخش_کانپور_دیهات,,1,0,1,6e-06,31
hi.wikipedia.org/wiki/साँचा:कानपुर_देहात_जिला,,1,0,1,6e-06,31
wikidata.org/wiki/Special:EntityPage/Q22717779,,1,0,1,6e-06,31
en.wikipedia.org/w/index.php?title=Template:Kanpur_Dehat_district&action=edit,,1,0,1,6e-06,31
en.wikipedia.org/w/index.php?title=Template:Kanpur_Dehat_district&action=history,,1,0,1,6e-06,31
en.wikipedia.org/wiki/Special:WhatLinksHere/Template:Kanpur_Dehat_district,,1,0,1,6e-06,31
en.wikipedia.org/wiki/Special:RecentChangesLinked/Template:Kanpur_Dehat_district,,1,0,1,6e-06,31
en.wikipedia.org/w/index.php?title=Template:Kanpur_Dehat_district&oldid=1178738933,,1,0,1,6e-06,31
en.wikipedia.org/w/index.php?title=Template:Kanpur_Dehat_district&action=info,,1,0,1,6e-06,31
templatetransclusioncheck.toolforge.org/?lang=en&name=Template:Kanpur_Dehat_district,,1,0,1,6e-06,31
en.wikipedia.org/wiki/Special:PrefixIndex/Template:Kanpur_Dehat_district/,,1,0,1,6e-06,31
en.m.wikipedia.org/w/index.php?title=Template:Kanpur_Dehat_district&mobileaction=toggle_view_mobile,,1,0,1,6e-06,31
en.wikipedia.org/w/index.php?title=Special:CreateAccount&returnto=Template%3AKannauj+district,,1,0,1,6e-06,31
en.wikipedia.org/w/index.php?title=Special:UserLogin&returnto=Template%3AKannauj+district,,1,0,1,6e-06,31
bn.wikipedia.org/wiki/টেমপ্লেট:কনৌজ_জেলা,,1,0,1,6e-06,31
hi.wikipedia.org/wiki/साँचा:कन्नौज_जिला,,1,0,1,6e-06,31
wikidata.org/wiki/Special:EntityPage/Q22717717,,1,0,1,6e-06,31
en.wikipedia.org/w/index.php?title=Template:Kannauj_district&action=edit,,1,0,1,6e-06,31
en.wikipedia.org/w/index.php?title=Template:Kannauj_district&action=history,,1,0,1,6e-06,31
en.wikipedia.org/wiki/Special:WhatLinksHere/Template:Kannauj_district,,1,0,1,6e-06,31
en.wikipedia.org/wiki/Special:RecentChangesLinked/Template:Kannauj_district,,1,0,1,6e-06,31
en.wikipedia.org/w/index.php?title=Template:Kannauj_district&oldid=1179208530,,1,0,1,6e-06,31
en.wikipedia.org/w/index.php?title=Template:Kannauj_district&action=info,,1,0,1,6e-06,31
templatetransclusioncheck.toolforge.org/?lang=en&name=Template:Kannauj_district,,1,0,1,6e-06,31
en.wikipedia.org/wiki/Special:PrefixIndex/Template:Kannauj_district/,,1,0,1,6e-06,31
en.m.wikipedia.org/w/index.php?title=Template:Kannauj_district&mobileaction=toggle_view_mobile,,1,0,1,6e-06,31
en.wikipedia.org/w/index.php?title=Special:CreateAccount&returnto=Template%3AJhansi+division+topics,,1,0,1,7e-06,31
en.wikipedia.org/w/index.php?title=Special:UserLogin&returnto=Template%3AJhansi+division+topics,,1,0,1,7e-06,31
wikidata.org/wiki/Special:EntityPage/Q22714156,,1,0,1,7e-06,31
en.wikipedia.org/wiki/Template_talk:Jhansi_division_topics,,1,0,1,7e-06,31
en.wikipedia.org/w/index.php?title=Template:Jhansi_division_topics&action=edit,,1,0,1,7e-06,31
en.wikipedia.org/w/index.php?title=Template:Jhansi_division_topics&action=history,,1,0,1,7e-06,31
en.wikipedia.org/wiki/Special:WhatLinksHere/Template:Jhansi_division_topics,,1,0,1,7e-06,31
en.wikipedia.org/wiki/Special:RecentChangesLinked/Template:Jhansi_division_topics,,1,0,1,7e-06,31
en.wikipedia.org/w/index.php?title=Template:Jhansi_division_topics&oldid=1157887714,,1,0,1,7e-06,31
en.wikipedia.org/w/index.php?title=Template:Jhansi_division_topics&action=info,,1,0,1,7e-06,31
en.wikipedia.org/wiki/Special:EditPage/Template:Jhansi_division_topics,,1,0,1,7e-06,31
en.wikipedia.org/wiki/Bundela,,1,0,1,7e-06,31
en.wikipedia.org/wiki/National_Highway_12A_(India),,1,0,1,7e-06,31
en.wikipedia.org/wiki/Jalaun_(Lok_Sabha_constituency),,2,0,2,7e-06,31
en.wikipedia.org/wiki/Jhansi_(Lok_Sabha_constituency),,1,0,1,7e-06,31
en.wikipedia.org/wiki/Template:Jalaun_district,,1,0,1,7e-06,31
en.wikipedia.org/wiki/Template:Jhansi_district,,1,0,1,7e-06,31
"en.wikipedia.org/wiki/Template:Lalitpur_district,_Uttar_Pradesh",,1,0,1,7e-06,31
en.wikipedia.org/wiki/Category:Villages_in_Jalaun_district,,1,0,1,7e-06,31
"en.wikipedia.org/wiki/Category:Villages_in_Lalitpur_district,_India",,1,0,1,7e-06,31
en.wikipedia.org/wiki/Category:People_from_Jalaun,,1,0,1,7e-06,31
en.wikipedia.org/wiki/Category:People_from_Jhansi,,1,0,1,7e-06,31
"en.wikipedia.org/wiki/Category:People_from_Lalitpur,_India",,1,0,1,7e-06,31
templatetransclusioncheck.toolforge.org/?lang=en&name=Template:Jhansi_division_topics,,1,0,1,7e-06,31
en.wikipedia.org/wiki/Special:PrefixIndex/Template:Jhansi_division_topics/,,1,0,1,7e-06,31
en.wikipedia.org/wiki/Category:Jhansi_division,,1,0,1,7e-06,31
en.m.wikipedia.org/w/index.php?title=Template:Jhansi_division_topics&mobileaction=toggle_view_mobile,,1,0,1,7e-06,31
en.wikipedia.org/w/index.php?title=Special:UserLogin&returnto=Template%3AGorakhpur+division+topics,,1,0,1,7e-06,31
bn.wikipedia.org/wiki/টেমপ্লেট:গোরখপুর_বিভাগ_প্রসঙ্গ,,1,0,1,7e-06,31
wikidata.org/wiki/Special:EntityPage/Q22732144,,1,0,1,7e-06,31
en.wikipedia.org/wiki/Template_talk:Gorakhpur_division_topics,,1,0,1,7e-06,31
en.wikipedia.org/w/index.php?title=Template:Gorakhpur_division_topics&action=edit,,1,0,1,7e-06,31
en.wikipedia.org/w/index.php?title=Template:Gorakhpur_division_topics&action=history,,1,0,1,7e-06,31
en.wikipedia.org/wiki/Special:WhatLinksHere/Template:Gorakhpur_division_topics,,1,0,1,7e-06,31
en.wikipedia.org/wiki/Special:RecentChangesLinked/Template:Gorakhpur_division_topics,,1,0,1,7e-06,31
en.wikipedia.org/w/index.php?title=Template:Gorakhpur_division_topics&oldid=1157887609,,1,0,1,7e-06,31
en.wikipedia.org/w/index.php?title=Template:Gorakhpur_division_topics&action=info,,1,0,1,7e-06,31
en.wikipedia.org/wiki/Special:EditPage/Template:Gorakhpur_division_topics,,1,0,1,7e-06,31
en.wikipedia.org/wiki/Parinirvana,,1,0,1,7e-06,31
"en.wikipedia.org/wiki/National_Highway_28_(India,_old_numbering)",,1,0,1,7e-06,31
"en.wikipedia.org/wiki/National_Highway_233B_(India,_old_numbering)",,1,0,1,7e-06,31
en.wikipedia.org/wiki/Deoria_(Lok_Sabha_constituency),,1,0,1,7e-06,31
en.wikipedia.org/wiki/Gorakhpur_(Lok_Sabha_constituency),,1,0,1,7e-06,31
en.wikipedia.org/wiki/Bansgaon_(Lok_Sabha_constituency),,1,0,1,7e-06,31
en.wikipedia.org/wiki/Kushi_Nagar_(Lok_Sabha_constituency),,1,0,1,7e-06,31
en.wikipedia.org/wiki/Template:Deoria_district,,1,0,1,7e-06,31
en.wikipedia.org/wiki/Template:Gorakhpur_district,,1,0,1,7e-06,31
en.wikipedia.org/wiki/Template:Kushinagar_district,,1,0,1,7e-06,31
en.wikipedia.org/wiki/Template:Maharajganj_district,,1,0,1,7e-06,31
en.wikipedia.org/wiki/Category:Villages_in_Deoria_district,,1,0,1,7e-06,31
en.wikipedia.org/wiki/Category:Villages_in_Gorakhpur_district,,1,0,1,7e-06,31
en.wikipedia.org/wiki/Category:Villages_in_Maharajganj_district,,1,0,1,7e-06,31
"en.wikipedia.org/wiki/Category:People_from_Deoria,_Uttar_Pradesh",,1,0,1,7e-06,31
en.wikipedia.org/wiki/Category:People_from_Gorakhpur,,1,0,1,7e-06,31
en.wikipedia.org/wiki/Category:People_from_Kushinagar,,1,0,1,7e-06,31
templatetransclusioncheck.toolforge.org/?lang=en&name=Template:Gorakhpur_division_topics,,1,0,1,7e-06,31
en.wikipedia.org/wiki/Special:PrefixIndex/Template:Gorakhpur_division_topics/,,1,0,1,7e-06,31
en.wikipedia.org/w/index.php?title=Special:CreateAccount&returnto=Template%3AFarrukhabad+district,,1,0,1,6e-06,31
en.wikipedia.org/w/index.php?title=Special:UserLogin&returnto=Template%3AFarrukhabad+district,,1,0,1,6e-06,31
fa.wikipedia.org/wiki/الگو:بخش_فرخ‌آباد,,1,0,1,6e-06,31
hi.wikipedia.org/wiki/साँचा:फ़र्रूख़ाबाद_जिला,,1,0,1,6e-06,31
ur.wikipedia.org/wiki/سانچہ:ضلع_فروخ_آباد,,1,0,1,6e-06,31
wikidata.org/wiki/Special:EntityPage/Q22728758,,1,0,1,6e-06,31
en.wikipedia.org/w/index.php?title=Template:Farrukhabad_district&action=edit,,1,0,1,6e-06,31
en.wikipedia.org/w/index.php?title=Template:Farrukhabad_district&action=history,,1,0,1,6e-06,31
en.wikipedia.org/wiki/Special:WhatLinksHere/Template:Farrukhabad_district,,1,0,1,6e-06,31
en.wikipedia.org/wiki/Special:RecentChangesLinked/Template:Farrukhabad_district,,1,0,1,6e-06,31
en.wikipedia.org/w/index.php?title=Template:Farrukhabad_district&oldid=1179206901,,1,0,1,6e-06,31
en.wikipedia.org/w/index.php?title=Template:Farrukhabad_district&action=info,,1,0,1,6e-06,31
templatetransclusioncheck.toolforge.org/?lang=en&name=Template:Farrukhabad_district,,1,0,1,6e-06,31
en.wikipedia.org/wiki/Special:PrefixIndex/Template:Farrukhabad_district/,,1,0,1,6e-06,31
en.m.wikipedia.org/w/index.php?title=Template:Farrukhabad_district&mobileaction=toggle_view_mobile,,1,0,1,6e-06,31
en.wikipedia.org/w/index.php?title=Special:UserLogin&returnto=Template%3AFaizabad+division+topics,,1,0,1,7e-06,31
ur.wikipedia.org/wiki/سانچہ:فیض_آباد_ڈویژن_کے_موضوعات,,1,0,1,7e-06,31
wikidata.org/wiki/Special:EntityPage/Q22727905,,1,0,1,7e-06,31
en.wikipedia.org/wiki/Template_talk:Faizabad_division_topics,,1,0,1,7e-06,31
en.wikipedia.org/w/index.php?title=Template:Faizabad_division_topics&action=edit,,1,0,1,7e-06,31
en.wikipedia.org/w/index.php?title=Template:Faizabad_division_topics&action=history,,1,0,1,7e-06,31
en.wikipedia.org/wiki/Special:WhatLinksHere/Template:Faizabad_division_topics,,1,0,1,7e-06,31
en.wikipedia.org/wiki/Special:RecentChangesLinked/Template:Faizabad_division_topics,,1,0,1,7e-06,31
en.wikipedia.org/w/index.php?title=Template:Faizabad_division_topics&oldid=1227939912,,1,0,1,7e-06,31
en.wikipedia.org/w/index.php?title=Template:Faizabad_division_topics&action=info,,1,0,1,7e-06,31
en.wikipedia.org/wiki/Special:EditPage/Template:Faizabad_division_topics,,1,0,1,7e-06,31
en.wikipedia.org/wiki/Archaeology_of_Ayodhya,,1,0,1,7e-06,31
en.wikipedia.org/wiki/Vishnu_Hari_inscription,,1,0,1,7e-06,31
en.wikipedia.org/wiki/Ayodhya_dispute,,1,0,1,7e-06,31
en.wikipedia.org/wiki/Ayodhya_firing_incident,,1,0,1,7e-06,31
en.wikipedia.org/wiki/Babri_Masjid,,1,0,1,7e-06,31
en.wikipedia.org/wiki/Ram_Janmabhoomi,,1,0,1,7e-06,31
en.wikipedia.org/wiki/2005_Ram_Janmabhoomi_attack_in_Ayodhya,,1,0,1,7e-06,31
en.wikipedia.org/wiki/Choti_Saryu,,2,0,2,7e-06,31
en.wikipedia.org/wiki/National_Highway_233_(India),,1,0,1,7e-06,31
en.wikipedia.org/wiki/National_Highway_232_(India),,1,0,1,7e-06,31
en.wikipedia.org/wiki/Akbarpur_Airport,,1,0,1,7e-06,31
en.wikipedia.org/wiki/Sultanpur_Airport,,1,0,1,7e-06,31
en.wikipedia.org/wiki/Template:Ambedkar_Nagar_district,,1,0,1,7e-06,31
en.wikipedia.org/wiki/Template:Amethi_district,,1,0,1,7e-06,31
en.wikipedia.org/wiki/Template:Faizabad_district,,1,0,1,7e-06,31
en.wikipedia.org/wiki/Template:Barabanki_district,,1,0,1,7e-06,31
en.wikipedia.org/wiki/Template:Sultanpur_district,,1,0,1,7e-06,31
en.wikipedia.org/wiki/Category:Villages_in_Ambedkar_Nagar_district,,1,0,1,7e-06,31
"en.wikipedia.org/wiki/Category:Villages_in_Balrampur_district,_Uttar_Pradesh",,2,0,2,7e-06,31
en.wikipedia.org/wiki/Category:Villages_in_Barabanki_district,,1,0,1,7e-06,31
en.wikipedia.org/wiki/Category:Villages_in_Sultanpur_district,,1,0,1,7e-06,31
en.wikipedia.org/wiki/Category:People_from_Faizabad,,1,0,1,7e-06,31
"en.wikipedia.org/wiki/Category:People_from_Barabanki,_Uttar_Pradesh",,1,0,1,7e-06,31
"en.wikipedia.org/wiki/Category:People_from_Sultanpur,_Uttar_Pradesh",,1,0,1,7e-06,31
templatetransclusioncheck.toolforge.org/?lang=en&name=Template:Faizabad_division_topics,,1,0,1,7e-06,31
en.wikipedia.org/wiki/Special:PrefixIndex/Template:Faizabad_division_topics/,,1,0,1,7e-06,31
en.wikipedia.org/w/index.php?title=Special:CreateAccount&returnto=Template%3AEtawah+district,,1,0,1,7e-06,31
en.wikipedia.org/w/index.php?title=Special:UserLogin&returnto=Template%3AEtawah+district,,1,0,1,7e-06,31
hi.wikipedia.org/wiki/साँचा:इटावा_जिला,,1,0,1,7e-06,31
sco.wikipedia.org/wiki/Template:Etawah_destrict,,1,0,1,7e-06,31
ur.wikipedia.org/wiki/سانچہ:ضلع_اٹاوہ,,1,0,1,7e-06,31
wikidata.org/wiki/Special:EntityPage/Q15138137,,1,0,1,7e-06,31
en.wikipedia.org/w/index.php?title=Template:Etawah_district&action=edit,,1,0,1,7e-06,31
en.wikipedia.org/w/index.php?title=Template:Etawah_district&action=history,,1,0,1,7e-06,31
en.wikipedia.org/wiki/Special:WhatLinksHere/Template:Etawah_district,,1,0,1,7e-06,31
en.wikipedia.org/wiki/Special:RecentChangesLinked/Template:Etawah_district,,1,0,1,7e-06,31
en.wikipedia.org/w/index.php?title=Template:Etawah_district&oldid=1074971338,,1,0,1,7e-06,31
en.wikipedia.org/w/index.php?title=Template:Etawah_district&action=info,,1,0,1,7e-06,31
templatetransclusioncheck.toolforge.org/?lang=en&name=Template:Etawah_district,,1,0,1,7e-06,31
en.wikipedia.org/wiki/Special:PrefixIndex/Template:Etawah_district/,,1,0,1,7e-06,31
en.m.wikipedia.org/w/index.php?title=Template:Etawah_district&mobileaction=toggle_view_mobile,,1,0,1,7e-06,31
en.wikipedia.org/w/index.php?title=Special:UserLogin&returnto=Template%3ADevipatan+division+topics,,1,0,1,7e-06,31
si.wikipedia.org/wiki/සැකිල්ල:Devipatan_division_topics,,1,0,1,7e-06,31
wikidata.org/wiki/Special:EntityPage/Q22763884,,1,0,1,7e-06,31
en.wikipedia.org/wiki/Template_talk:Devipatan_division_topics,,1,0,1,7e-06,31
en.wikipedia.org/w/index.php?title=Template:Devipatan_division_topics&action=edit,,1,0,1,7e-06,31
en.wikipedia.org/w/index.php?title=Template:Devipatan_division_topics&action=history,,1,0,1,7e-06,31
en.wikipedia.org/wiki/Special:WhatLinksHere/Template:Devipatan_division_topics,,1,0,1,7e-06,31
en.wikipedia.org/wiki/Special:RecentChangesLinked/Template:Devipatan_division_topics,,1,0,1,7e-06,31
en.wikipedia.org/w/index.php?title=Template:Devipatan_division_topics&oldid=1241748636,,1,0,1,7e-06,31
en.wikipedia.org/w/index.php?title=Template:Devipatan_division_topics&action=info,,1,0,1,7e-06,31
en.wikipedia.org/wiki/Special:EditPage/Template:Devipatan_division_topics,,1,0,1,7e-06,31
en.wikipedia.org/wiki/Jetavana,,1,0,1,7e-06,31
en.wikipedia.org/wiki/Sambhavanath,,1,0,1,7e-06,31
en.wikipedia.org/wiki/Anathapindika,,1,0,1,7e-06,31
en.wikipedia.org/wiki/Visakha,,1,0,1,7e-06,31
en.wikipedia.org/wiki/Pasenadi,,1,0,1,7e-06,31
en.wikipedia.org/wiki/Angulimala,,1,0,1,7e-06,31
en.wikipedia.org/wiki/National_Highway_28C_(India),,1,0,1,7e-06,31
en.wikipedia.org/wiki/Bahraich_(Lok_Sabha_constituency),,1,0,1,7e-06,31
en.wikipedia.org/wiki/Kaiserganj_(Lok_Sabha_constituency),,1,0,1,7e-06,31
en.wikipedia.org/wiki/Shrawasti_(Lok_Sabha_constituency),,1,0,1,7e-06,31
en.wikipedia.org/wiki/Gonda_(Lok_Sabha_constituency),,1,0,1,7e-06,31
en.wikipedia.org/wiki/Template:Bahraich_district,,1,0,1,7e-06,31
en.wikipedia.org/wiki/Template:Balrampur_district,,1,0,1,7e-06,31
en.wikipedia.org/wiki/Template:Gonda_district,,1,0,1,7e-06,31
en.wikipedia.org/wiki/Template:Shravasti_district,,1,0,1,7e-06,31
en.wikipedia.org/wiki/Category:Villages_in_Gonda_district,,1,0,1,7e-06,31
en.wikipedia.org/wiki/Category:People_from_Bahraich,,1,0,1,7e-06,31
en.wikipedia.org/wiki/Category:People_from_Balrampur,,1,0,1,7e-06,31
"en.wikipedia.org/wiki/Category:People_from_Gonda,_Uttar_Pradesh",,1,0,1,7e-06,31
en.wikipedia.org/wiki/Category:People_from_Shravasti_district,,1,0,1,7e-06,31
templatetransclusioncheck.toolforge.org/?lang=en&name=Template:Devipatan_division_topics,,1,0,1,7e-06,31
en.wikipedia.org/wiki/Special:PrefixIndex/Template:Devipatan_division_topics/,,1,0,1,7e-06,31
en.wikipedia.org/w/index.php?title=Special:CreateAccount&returnto=Template%3ABasti+division+topics,,1,0,1,7e-06,31
en.wikipedia.org/w/index.php?title=Special:UserLogin&returnto=Template%3ABasti+division+topics,,1,0,1,7e-06,31
wikidata.org/wiki/Special:EntityPage/Q6712735,,1,0,1,7e-06,31
en.wikipedia.org/wiki/Template_talk:Basti_division_topics,,1,0,1,7e-06,31
en.wikipedia.org/w/index.php?title=Template:Basti_division_topics&action=edit,,1,0,1,7e-06,31
en.wikipedia.org/w/index.php?title=Template:Basti_division_topics&action=history,,1,0,1,7e-06,31
en.wikipedia.org/wiki/Special:WhatLinksHere/Template:Basti_division_topics,,1,0,1,7e-06,31
en.wikipedia.org/wiki/Special:RecentChangesLinked/Template:Basti_division_topics,,1,0,1,7e-06,31
en.wikipedia.org/w/index.php?title=Template:Basti_division_topics&oldid=1157886929,,1,0,1,7e-06,31
en.wikipedia.org/w/index.php?title=Template:Basti_division_topics&action=info,,1,0,1,7e-06,31
en.wikipedia.org/wiki/Special:EditPage/Template:Basti_division_topics,,1,0,1,7e-06,31
en.wikipedia.org/wiki/Khunwa,,1,0,1,7e-06,31
en.wikipedia.org/wiki/Basti_(Lok_Sabha_constituency),,1,0,1,7e-06,31
en.wikipedia.org/wiki/Sant_Kabir_Nagar_(Lok_Sabha_constituency),,1,0,1,7e-06,31
en.wikipedia.org/wiki/Khalilabad_(Lok_Sabha_constituency),,1,0,1,7e-06,31
en.wikipedia.org/wiki/Domariyaganj_(Lok_Sabha_constituency),,1,0,1,7e-06,31
en.wikipedia.org/wiki/Category:Basti_division,,1,0,1,7e-06,31
en.m.wikipedia.org/w/index.php?title=Template:Basti_division_topics&mobileaction=toggle_view_mobile,,1,0,1,7e-06,31
en.wikipedia.org/w/index.php?title=Special:UserLogin&returnto=Template%3AChitrakoot+division+topics,,1,0,1,7e-06,31
wikidata.org/wiki/Special:EntityPage/Q6923036,,1,0,1,7e-06,31
en.wikipedia.org/wiki/Template_talk:Chitrakoot_division_topics,,1,0,1,7e-06,31
en.wikipedia.org/w/index.php?title=Template:Chitrakoot_division_topics&action=edit,,1,0,1,7e-06,31
en.wikipedia.org/w/index.php?title=Template:Chitrakoot_division_topics&action=history,,1,0,1,7e-06,31
en.wikipedia.org/wiki/Special:WhatLinksHere/Template:Chitrakoot_division_topics,,1,0,1,7e-06,31
en.wikipedia.org/wiki/Special:RecentChangesLinked/Template:Chitrakoot_division_topics,,1,0,1,7e-06,31
en.wikipedia.org/w/index.php?title=Template:Chitrakoot_division_topics&oldid=1157887377,,1,0,1,7e-06,31
en.wikipedia.org/w/index.php?title=Template:Chitrakoot_division_topics&action=info,,1,0,1,7e-06,31
en.wikipedia.org/wiki/Special:EditPage/Template:Chitrakoot_division_topics,,1,0,1,7e-06,31
en.wikipedia.org/wiki/Ranipur_Sanctuary,,1,0,1,7e-06,31
en.wikipedia.org/wiki/Category:Princely_states_of_Bundelkhand,,1,0,1,7e-06,31
en.wikipedia.org/wiki/Banda_(Lok_Sabha_constituency),,1,0,1,7e-06,31
"en.wikipedia.org/wiki/Hamirpur,_Uttar_Pradesh_(Lok_Sabha_constituency)",,1,0,1,7e-06,31
en.wikipedia.org/wiki/Template:Banda_district,,1,0,1,7e-06,31
en.wikipedia.org/wiki/Template:Chitrakoot_district,,1,0,1,7e-06,31
"en.wikipedia.org/wiki/Template:Hamirpur_district,_Uttar_Pradesh",,1,0,1,7e-06,31
en.wikipedia.org/wiki/Template:Mahoba_district,,1,0,1,7e-06,31
en.wikipedia.org/wiki/Category:Villages_in_Mahoba_district,,1,0,1,7e-06,31
"en.wikipedia.org/wiki/Category:People_from_Banda,_Uttar_Pradesh",,1,0,1,7e-06,31
"en.wikipedia.org/wiki/Category:People_from_Hamirpur,_Uttar_Pradesh",,1,0,1,7e-06,31
en.wikipedia.org/wiki/Category:People_from_Mahoba,,1,0,1,7e-06,31
templatetransclusioncheck.toolforge.org/?lang=en&name=Template:Chitrakoot_division_topics,,1,0,1,7e-06,31
en.wikipedia.org/wiki/Special:PrefixIndex/Template:Chitrakoot_division_topics/,,1,0,1,7e-06,31
en.wikipedia.org/w/index.php?title=Special:UserLogin&returnto=Template%3ABRICS+Universities+League,,1,0,1,6e-06,31
arz.wikipedia.org/wiki/قالب:BRICS_Universities_League,,1,0,1,6e-06,31
wikidata.org/wiki/Special:EntityPage/Q123943962,,1,0,1,6e-06,31
en.wikipedia.org/w/index.php?title=Template:BRICS_Universities_League&action=edit,,1,0,1,6e-06,31
en.wikipedia.org/w/index.php?title=Template:BRICS_Universities_League&action=history,,1,0,1,6e-06,31
en.wikipedia.org/wiki/Special:WhatLinksHere/Template:BRICS_Universities_League,,1,0,1,6e-06,31
en.wikipedia.org/wiki/Special:RecentChangesLinked/Template:BRICS_Universities_League,,1,0,1,6e-06,31
en.wikipedia.org/w/index.php?title=Template:BRICS_Universities_League&oldid=1196825527,,1,0,1,6e-06,31
en.wikipedia.org/w/index.php?title=Template:BRICS_Universities_League&action=info,,1,0,1,6e-06,31
en.wikipedia.org/wiki/Special:Purge/Template:BRICS_Universities_League,,1,0,1,6e-06,31
templatetransclusioncheck.toolforge.org/?lang=en&name=Template:BRICS_Universities_League,,1,0,1,6e-06,31
en.wikipedia.org/wiki/Special:PrefixIndex/Template:BRICS_Universities_League/,,1,0,1,6e-06,31
en.wikipedia.org/wiki/Category:Associations_of_universities_and_colleges_navigational_boxes,,1,0,1,6e-06,31
en.wikipedia.org/wiki/Category:BRICS_navigational_boxes,,1,0,1,6e-06,31
en.wikipedia.org/w/index.php?title=Special:UserLogin&returnto=Template%3ABareilly+division+topics,,1,0,1,7e-06,31
ur.wikipedia.org/wiki/سانچہ:بریلی_ڈویژن_کے_موضوعات,,1,0,1,7e-06,31
wikidata.org/wiki/Special:EntityPage/Q6711692,,1,0,1,7e-06,31
en.wikipedia.org/w/index.php?title=Template:Bareilly_division_topics&action=edit,,1,0,1,7e-06,31
en.wikipedia.org/w/index.php?title=Template:Bareilly_division_topics&action=history,,1,0,1,7e-06,31
en.wikipedia.org/wiki/Special:WhatLinksHere/Template:Bareilly_division_topics,,1,0,1,7e-06,31
en.wikipedia.org/wiki/Special:RecentChangesLinked/Template:Bareilly_division_topics,,1,0,1,7e-06,31
en.wikipedia.org/w/index.php?title=Template:Bareilly_division_topics&oldid=1157886844,,1,0,1,7e-06,31
en.wikipedia.org/w/index.php?title=Template:Bareilly_division_topics&action=info,,1,0,1,7e-06,31
templatetransclusioncheck.toolforge.org/?lang=en&name=Template:Bareilly_division_topics,,1,0,1,7e-06,31
en.wikipedia.org/wiki/Special:PrefixIndex/Template:Bareilly_division_topics/,,1,0,1,7e-06,31
en.wikipedia.org/w/index.php?title=Special:UserLogin&returnto=Template%3APrayagraj+division+topics,,1,0,1,7e-06,31
bh.wikipedia.org/wiki/टेम्पलेट:इलाहाबाद_मंडल_बिसय,,1,0,1,7e-06,31
ur.wikipedia.org/wiki/سانچہ:الہ_آباد_ڈویژن_کے_موضوعات,,1,0,1,7e-06,31
wikidata.org/wiki/Special:EntityPage/Q6676448,,1,0,1,7e-06,31
en.wikipedia.org/w/index.php?title=Template:Prayagraj_division_topics&action=edit,,1,0,1,7e-06,31
en.wikipedia.org/w/index.php?title=Template:Prayagraj_division_topics&action=history,,1,0,1,7e-06,31
en.wikipedia.org/wiki/Special:WhatLinksHere/Template:Prayagraj_division_topics,,1,0,1,7e-06,31
en.wikipedia.org/wiki/Special:RecentChangesLinked/Template:Prayagraj_division_topics,,1,0,1,7e-06,31
en.wikipedia.org/w/index.php?title=Template:Prayagraj_division_topics&oldid=1272527135,,1,0,1,7e-06,31
en.wikipedia.org/w/index.php?title=Template:Prayagraj_division_topics&action=info,,1,0,1,7e-06,31
templatetransclusioncheck.toolforge.org/?lang=en&name=Template:Prayagraj_division_topics,,1,0,1,7e-06,31
en.wikipedia.org/wiki/Special:PrefixIndex/Template:Prayagraj_division_topics/,,1,0,1,7e-06,31
en.wikipedia.org/w/index.php?title=Special:CreateAccount&returnto=Template%3AAuraiya+district,,1,0,1,6e-06,31
en.wikipedia.org/w/index.php?title=Special:UserLogin&returnto=Template%3AAuraiya+district,,1,0,1,6e-06,31
hi.wikipedia.org/wiki/साँचा:औरैया_जिला,,1,0,1,6e-06,31
ur.wikipedia.org/wiki/سانچہ:ضلع_اوریا,,1,0,1,6e-06,31
wikidata.org/wiki/Special:EntityPage/Q6702123,,1,0,1,6e-06,31
en.wikipedia.org/w/index.php?title=Template:Auraiya_district&action=edit,,1,0,1,6e-06,31
en.wikipedia.org/w/index.php?title=Template:Auraiya_district&action=history,,1,0,1,6e-06,31
en.wikipedia.org/wiki/Special:WhatLinksHere/Template:Auraiya_district,,1,0,1,6e-06,31
en.wikipedia.org/wiki/Special:RecentChangesLinked/Template:Auraiya_district,,1,0,1,6e-06,31
en.wikipedia.org/w/index.php?title=Template:Auraiya_district&oldid=1178904391,,1,0,1,6e-06,31
en.wikipedia.org/w/index.php?title=Template:Auraiya_district&action=info,,1,0,1,6e-06,31
templatetransclusioncheck.toolforge.org/?lang=en&name=Template:Auraiya_district,,1,0,1,6e-06,31
en.wikipedia.org/wiki/Special:PrefixIndex/Template:Auraiya_district/,,1,0,1,6e-06,31
en.m.wikipedia.org/w/index.php?title=Template:Auraiya_district&mobileaction=toggle_view_mobile,,1,0,1,6e-06,31
en.wikipedia.org/w/index.php?title=Special:UserLogin&returnto=Template%3AAzamgarh+division+topics,,1,0,1,7e-06,31
wikidata.org/wiki/Special:EntityPage/Q6706392,,1,0,1,7e-06,31
en.wikipedia.org/wiki/Template_talk:Azamgarh_division_topics,,1,0,1,7e-06,31
en.wikipedia.org/w/index.php?title=Template:Azamgarh_division_topics&action=edit,,1,0,1,7e-06,31
en.wikipedia.org/w/index.php?title=Template:Azamgarh_division_topics&action=history,,1,0,1,7e-06,31
en.wikipedia.org/wiki/Special:WhatLinksHere/Template:Azamgarh_division_topics,,1,0,1,7e-06,31
en.wikipedia.org/wiki/Special:RecentChangesLinked/Template:Azamgarh_division_topics,,1,0,1,7e-06,31
en.wikipedia.org/w/index.php?title=Template:Azamgarh_division_topics&oldid=1157886603,,1,0,1,7e-06,31
en.wikipedia.org/w/index.php?title=Template:Azamgarh_division_topics&action=info,,1,0,1,7e-06,31
en.wikipedia.org/wiki/Special:EditPage/Template:Azamgarh_division_topics,,1,0,1,7e-06,31
en.wikipedia.org/wiki/Azamgarh_(Lok_Sabha_constituency),,1,0,1,7e-06,31
en.wikipedia.org/wiki/Lalganj_(Lok_Sabha_constituency),,1,0,1,7e-06,31
en.wikipedia.org/wiki/Ballia_(Lok_Sabha_constituency),,1,0,1,7e-06,31
en.wikipedia.org/wiki/Salempur_(Lok_Sabha_constituency),,1,0,1,7e-06,31
en.wikipedia.org/wiki/Ghosi_(Lok_Sabha_constituency),,1,0,1,7e-06,31
en.wikipedia.org/wiki/Template:Azamgarh_district,,1,0,1,7e-06,31
en.wikipedia.org/wiki/Template:Ballia_district,,1,0,1,7e-06,31
en.wikipedia.org/wiki/Template:Mau_district,,1,0,1,7e-06,31
en.wikipedia.org/wiki/Category:Villages_in_Azamgarh_district,,1,0,1,7e-06,31
en.wikipedia.org/wiki/Category:Villages_in_Ballia_district,,1,0,1,7e-06,31
en.wikipedia.org/wiki/Category:Villages_in_Mau_district,,1,0,1,7e-06,31
en.wikipedia.org/wiki/Category:People_from_Azamgarh,,1,0,1,7e-06,31
en.wikipedia.org/wiki/Category:People_from_Ballia,,1,0,1,7e-06,31
en.wikipedia.org/wiki/Category:People_from_Mau,,1,0,1,7e-06,31
templatetransclusioncheck.toolforge.org/?lang=en&name=Template:Azamgarh_division_topics,,1,0,1,7e-06,31
en.wikipedia.org/wiki/Special:PrefixIndex/Template:Azamgarh_division_topics/,,1,0,1,7e-06,31
en.wikipedia.org/w/index.php?title=Special:CreateAccount&returnto=Template%3AAligarh+division+topics,,1,0,1,7e-06,31
en.wikipedia.org/w/index.php?title=Special:UserLogin&returnto=Template%3AAligarh+division+topics,,1,0,1,7e-06,31
ur.wikipedia.org/wiki/سانچہ:علی_گڑھ_ڈویژن_کے_موضوعات,,1,0,1,7e-06,31
wikidata.org/wiki/Special:EntityPage/Q22751519,,1,0,1,7e-06,31
en.wikipedia.org/wiki/Template_talk:Aligarh_division_topics,,1,0,1,7e-06,31
en.wikipedia.org/w/index.php?title=Template:Aligarh_division_topics&action=edit,,1,0,1,7e-06,31
en.wikipedia.org/w/index.php?title=Template:Aligarh_division_topics&action=history,,1,0,1,7e-06,31
en.wikipedia.org/wiki/Special:WhatLinksHere/Template:Aligarh_division_topics,,1,0,1,7e-06,31
en.wikipedia.org/wiki/Special:RecentChangesLinked/Template:Aligarh_division_topics,,1,0,1,7e-06,31
en.wikipedia.org/w/index.php?title=Template:Aligarh_division_topics&oldid=1178586942,,1,0,1,7e-06,31
en.wikipedia.org/w/index.php?title=Template:Aligarh_division_topics&action=info,,1,0,1,7e-06,31
en.wikipedia.org/wiki/Special:EditPage/Template:Aligarh_division_topics,,1,0,1,7e-06,31
en.wikipedia.org/wiki/Aligarh_Movement,,1,0,1,7e-06,31
en.wikipedia.org/wiki/Aligarh_Fort,,1,0,1,7e-06,31
en.wikipedia.org/wiki/Template:Aligarh_Muslim_University,,1,0,1,7e-06,31
en.wikipedia.org/wiki/Template:Pakistan_Movement,,1,0,1,7e-06,31
en.wikipedia.org/wiki/Kol_Tehsil,,1,0,1,7e-06,31
en.wikipedia.org/wiki/Atrauli,,1,0,1,7e-06,31
en.wikipedia.org/wiki/Gabhana,,1,0,1,7e-06,31
en.wikipedia.org/wiki/Iglas,,1,0,1,7e-06,31
"en.wikipedia.org/wiki/Dhola,_Gujarat",,1,0,1,7e-06,31
en.wikipedia.org/wiki/Jatav,,3,0,3,7e-06,31
en.wikipedia.org/wiki/Aligarh_(Lok_Sabha_constituency),,1,0,1,7e-06,31
en.wikipedia.org/wiki/Hathras_(Lok_Sabha_constituency),,1,0,1,7e-06,31
en.wikipedia.org/wiki/Etah_(Lok_Sabha_constituency),,1,0,1,7e-06,31
en.wikipedia.org/wiki/Template:Aligarh_district,,1,0,1,7e-06,31
en.wikipedia.org/wiki/Template:Etah_district,,1,0,1,7e-06,31
en.wikipedia.org/wiki/Template:Hathras_district,,1,0,1,7e-06,31
en.wikipedia.org/wiki/Template:Kasganj_district,,1,0,1,7e-06,31
en.wikipedia.org/wiki/Category:Villages_in_Aligarh_district,,1,0,1,7e-06,31
en.wikipedia.org/wiki/Category:People_from_Aligarh,,1,0,1,7e-06,31
en.wikipedia.org/wiki/Category:Aligarh_Muslim_University_alumni,,1,0,1,7e-06,31
en.wikipedia.org/wiki/Category:People_from_Etah,,1,0,1,7e-06,31
templatetransclusioncheck.toolforge.org/?lang=en&name=Template:Aligarh_division_topics,,1,0,1,7e-06,31
en.wikipedia.org/wiki/Special:PrefixIndex/Template:Aligarh_division_topics/,,1,0,1,7e-06,31
en.wikipedia.org/w/index.php?title=Special:CreateAccount&returnto=Template%3AAgra+division+topics,,1,0,1,6e-06,31
en.wikipedia.org/w/index.php?title=Special:UserLogin&returnto=Template%3AAgra+division+topics,,1,0,1,6e-06,31
bn.wikipedia.org/wiki/টেমপ্লেট:Agra_Division_topics,,1,0,1,6e-06,31
ml.wikipedia.org/wiki/ഫലകം:Agra_Division_topics,,1,0,1,6e-06,31
ur.wikipedia.org/wiki/سانچہ:آگرہ_ڈویژن_کے_موضوعات,,1,0,1,6e-06,31
wikidata.org/wiki/Special:EntityPage/Q6672241,,1,0,1,6e-06,31
en.wikipedia.org/wiki/Template_talk:Agra_division_topics,,2,0,2,7e-06,31
en.wikipedia.org/w/index.php?title=Template:Agra_division_topics&action=edit,,1,0,1,6e-06,31
en.wikipedia.org/w/index.php?title=Template:Agra_division_topics&action=history,,1,0,1,6e-06,31
en.wikipedia.org/wiki/Special:WhatLinksHere/Template:Agra_division_topics,,1,0,1,6e-06,31
en.wikipedia.org/wiki/Special:RecentChangesLinked/Template:Agra_division_topics,,1,0,1,6e-06,31
en.wikipedia.org/w/index.php?title=Template:Agra_division_topics&oldid=1268517940,,1,0,1,6e-06,31
en.wikipedia.org/w/index.php?title=Template:Agra_division_topics&action=info,,1,0,1,6e-06,31
en.wikipedia.org/wiki/Special:EditPage/Template:Agra_division_topics,,2,0,2,7e-06,31
en.wikipedia.org/wiki/Template:Krishna,,2,0,2,7e-06,31
en.wikipedia.org/wiki/Template:Mughal_Empire,,2,0,2,7e-06,31
en.wikipedia.org/wiki/Buland_Darwaza,,2,0,2,7e-06,31
en.wikipedia.org/wiki/Tomb_of_Akbar_the_Great,,2,0,2,7e-06,31
en.wikipedia.org/wiki/Tomb_of_Mariam_Zamani,,2,0,2,7e-06,31
en.wikipedia.org/wiki/Gyarah_Sidhi,,2,0,2,7e-06,31
"en.wikipedia.org/wiki/Jama_Masjid,_Agra",,2,0,2,7e-06,31
"en.wikipedia.org/wiki/Moti_Masjid,_Agra",,2,0,2,7e-06,31
en.wikipedia.org/wiki/Guru_Ka_Tal,,2,0,2,7e-06,31
"en.wikipedia.org/wiki/Ram_Bagh,_Agra",,2,0,2,7e-06,31
en.wikipedia.org/wiki/Vrindavan_Chandrodaya_Mandir,,2,0,2,7e-06,31
en.wikipedia.org/wiki/Prem_Mandir_Vrindavan,,2,0,2,7e-06,31
en.wikipedia.org/wiki/Krishna_Balaram_Mandir,,2,0,2,7e-06,31
en.wikipedia.org/wiki/Braj_Bhasa,,2,0,2,7e-06,31
en.wikipedia.org/wiki/Agra_(Lok_Sabha_constituency),,2,0,2,7e-06,31
en.wikipedia.org/wiki/Firozabad_(Lok_Sabha_constituency),,2,0,2,7e-06,31
en.wikipedia.org/wiki/Fatehpur_Sikri_(Lok_Sabha_constituency),,2,0,2,7e-06,31
en.wikipedia.org/wiki/Mathura_(Lok_Sabha_constituency),,2,0,2,7e-06,31
en.wikipedia.org/wiki/Template:Agra_district,,2,0,2,7e-06,31
en.wikipedia.org/wiki/Template:Firozabad_district,,2,0,2,7e-06,31
en.wikipedia.org/wiki/Template:Mainpuri_district,,2,0,2,7e-06,31
en.wikipedia.org/wiki/Template:Mathura_district,,2,0,2,7e-06,31
en.wikipedia.org/wiki/Category:Villages_in_Agra_district,,2,0,2,7e-06,31
en.wikipedia.org/wiki/Category:Villages_in_Firozabad_district,,2,0,2,7e-06,31
en.wikipedia.org/wiki/Category:Villages_in_Mathura_district,,2,0,2,7e-06,31
en.wikipedia.org/wiki/Category:People_from_Agra,,2,0,2,7e-06,31
en.wikipedia.org/wiki/Category:People_from_Firozabad,,2,0,2,7e-06,31
en.wikipedia.org/wiki/Category:People_from_Mainpuri,,2,0,2,7e-06,31
en.wikipedia.org/wiki/Category:People_from_Mathura,,2,0,2,7e-06,31
templatetransclusioncheck.toolforge.org/?lang=en&name=Template:Agra_division_topics,,1,0,1,6e-06,31
en.wikipedia.org/wiki/Special:PrefixIndex/Template:Agra_division_topics/,,1,0,1,6e-06,31
en.m.wikipedia.org/w/index.php?title=Template:Agra_division_topics&mobileaction=toggle_view_mobile,,1,0,1,6e-06,31
en.wikipedia.org/w/index.php?title=Special:CreateAccount&returnto=Takha,,1,0,1,6e-06,31
en.wikipedia.org/w/index.php?title=Special:UserLogin&returnto=Takha,,1,0,1,6e-06,31
wikidata.org/wiki/Special:EntityPage/Q48727481,,1,0,1,6e-06,31
en.wikipedia.org/wiki/Talk:Takha,,1,0,1,6e-06,31
en.wikipedia.org/w/index.php?title=Takha&action=edit,,1,0,1,6e-06,31
en.wikipedia.org/w/index.php?title=Takha&action=history,,1,0,1,6e-06,31
en.wikipedia.org/wiki/Special:WhatLinksHere/Takha,,1,0,1,6e-06,31
en.wikipedia.org/wiki/Special:RecentChangesLinked/Takha,,1,0,1,6e-06,31
en.wikipedia.org/w/index.php?title=Takha&oldid=1167237207,,1,0,1,6e-06,31
en.wikipedia.org/w/index.php?title=Takha&action=info,,1,0,1,6e-06,31
en.wikipedia.org/w/index.php?title=Special:QrCode&url=https%3A%2F%2Fen.wikipedia.org%2Fwiki%2FTakha,,1,0,1,6e-06,31
en.wikipedia.org/w/index.php?title=Special:DownloadAsPdf&page=Takha&action=show-download-screen,,1,0,1,6e-06,31
en.wikipedia.org/w/index.php?title=Takha&printable=yes,,1,0,1,6e-06,31
geohack.toolforge.org/geohack.php?pagename=Takha&params=26.82_N_79.30_E_type:city_region:IN-UP,,1,0,1,6e-06,31
en.wikipedia.org/wiki/Special:EditPage/Takha,,1,0,1,6e-06,31
"google.com/search?as_eq=wikipedia&q=""Takha""",,1,0,1,6e-06,31
"google.com/search?tbm=nws&q=""Takha""+-wikipedia&tbs=ar:1",,1,0,1,6e-06,31
"google.com/search?&q=""Takha""&tbs=bkt:s&tbm=bks",,1,0,1,6e-06,31
"google.com/search?tbs=bks:1&q=""Takha""+-wikipedia",,1,0,1,6e-06,31
"scholar.google.com/scholar?q=""Takha""",,1,0,1,6e-06,31
"jstor.org/action/doBasicSearch?Query=""Takha""&acc=on&wc=on",,1,0,1,6e-06,31
en.wikipedia.org/wiki/Panchayat_raj,,1,0,1,6e-06,31
en.wikipedia.org/wiki/Saifai_airstrip,,2,0,2,7e-06,31
en.wikipedia.org/w/index.php?title=Takha&action=edit&section=1,,1,0,1,6e-06,31
en.wikipedia.org/w/index.php?title=Takha&action=edit&section=2,,1,0,1,6e-06,31
en.wikipedia.org/wiki/Subdistrict,,1,0,1,6e-06,31
en.wikipedia.org/w/index.php?title=Takha&action=edit&section=3,,1,0,1,6e-06,31
en.wikipedia.org/wiki/Taj_International_Airport,,1,0,1,6e-06,31
en.wikipedia.org/w/index.php?title=Takha&action=edit&section=4,,1,0,1,6e-06,31
en.wikipedia.org/w/index.php?title=Takha&action=edit&section=5,,1,0,1,6e-06,31
en.wikipedia.org/w/index.php?title=Takha&action=edit&section=6,,1,0,1,6e-06,31
census2011.co.in/data/village/147741-takha-uttar-pradesh.html,,1,0,1,6e-06,31
en.wikipedia.org/wiki/Category:Articles_needing_additional_references_from_July_2018,,1,0,1,6e-06,31
en.m.wikipedia.org/w/index.php?title=Takha&mobileaction=toggle_view_mobile,,1,0,1,6e-06,31
en.wikipedia.org/w/index.php?title=Special:CreateAccount&returnto=Shyam+Nagar,,1,0,1,7e-06,31
en.wikipedia.org/w/index.php?title=Special:UserLogin&returnto=Shyam+Nagar,,1,0,1,7e-06,31
wikidata.org/wiki/Special:EntityPage/Q30621559,,1,0,1,7e-06,31
en.wikipedia.org/wiki/Talk:Shyam_Nagar,,1,0,1,7e-06,31
en.wikipedia.org/w/index.php?title=Shyam_Nagar&action=edit,,1,0,1,7e-06,31
en.wikipedia.org/w/index.php?title=Shyam_Nagar&action=history,,1,0,1,7e-06,31
en.wikipedia.org/wiki/Special:WhatLinksHere/Shyam_Nagar,,1,0,1,7e-06,31
en.wikipedia.org/wiki/Special:RecentChangesLinked/Shyam_Nagar,,1,0,1,7e-06,31
en.wikipedia.org/w/index.php?title=Shyam_Nagar&oldid=997923058,,1,0,1,7e-06,31
en.wikipedia.org/w/index.php?title=Shyam_Nagar&action=info,,1,0,1,7e-06,31
en.wikipedia.org/w/index.php?title=Shyam_Nagar&printable=yes,,1,0,1,7e-06,31
en.wikipedia.org/wiki/Budaun_Metro_Area,,1,0,1,7e-06,31
en.wikipedia.org/w/index.php?title=Shekhupur&action=edit&redlink=1,,1,0,1,7e-06,31
en.wikipedia.org/w/index.php?title=Shyam_Nagar&action=edit&section=1,,1,0,1,7e-06,31
en.wikipedia.org/w/index.php?title=Shyam_Nagar&action=edit&section=2,,1,0,1,7e-06,31
en.wikipedia.org/w/index.php?title=Shyam_Nagar&action=edit&section=3,,1,0,1,7e-06,31
mapsofindia.com/pincode/india/uttar-pradesh/budaun/shyam-nagar.html,,1,0,1,7e-06,31
en.wikipedia.org/wiki/Category:Budaun,,1,0,1,7e-06,31
en.wikipedia.org/wiki/Category:Neighbourhoods_in_Uttar_Pradesh,,1,0,1,7e-06,31
en.m.wikipedia.org/w/index.php?title=Shyam_Nagar&mobileaction=toggle_view_mobile,,1,0,1,7e-06,31
en.wikipedia.org/w/index.php?title=Special:CreateAccount&returnto=Gangaghat,,1,0,1,6e-06,31
en.wikipedia.org/w/index.php?title=Special:UserLogin&returnto=Gangaghat,,1,0,1,6e-06,31
zh-min-nan.wikipedia.org/wiki/Gangaghat,,1,0,1,6e-06,31
de.wikipedia.org/wiki/Gangaghat,,1,0,1,6e-06,31
es.wikipedia.org/wiki/Gangaghat,,1,0,1,6e-06,31
hi.wikipedia.org/wiki/गंगाघाट,,1,0,1,6e-06,31
bpy.wikipedia.org/wiki/গঙ্গাঘাট,,1,0,1,6e-06,31
it.wikipedia.org/wiki/Gangaghat,,1,0,1,6e-06,31
ms.wikipedia.org/wiki/Gangaghat,,1,0,1,6e-06,31
nl.wikipedia.org/wiki/Gangaghat,,1,0,1,6e-06,31
new.wikipedia.org/wiki/गंगाघाट,,1,0,1,6e-06,31
pl.wikipedia.org/wiki/Gangaghat,,1,0,1,6e-06,31
pt.wikipedia.org/wiki/Gangaghat,,1,0,1,6e-06,31
sv.wikipedia.org/wiki/Gangaghat,,1,0,1,6e-06,31
ur.wikipedia.org/wiki/گنگاگھاٹ,,1,0,1,6e-06,31
vi.wikipedia.org/wiki/Gangaghat,,1,0,1,6e-06,31
zh.wikipedia.org/wiki/冈格阿加特,,1,0,1,6e-06,31
wikidata.org/wiki/Special:EntityPage/Q1654857,,1,0,1,6e-06,31
en.wikipedia.org/wiki/Gangaghat,,1,0,1,6e-06,31
en.wikipedia.org/wiki/Talk:Gangaghat,,1,0,1,6e-06,31
en.wikipedia.org/w/index.php?title=Gangaghat&action=edit,,1,0,1,6e-06,31
en.wikipedia.org/w/index.php?title=Gangaghat&action=history,,1,0,1,6e-06,31
en.wikipedia.org/wiki/Special:WhatLinksHere/Gangaghat,,1,0,1,6e-06,31
en.wikipedia.org/wiki/Special:RecentChangesLinked/Gangaghat,,1,0,1,6e-06,31
en.wikipedia.org/w/index.php?title=Gangaghat&oldid=1297603158,,1,0,1,6e-06,31
en.wikipedia.org/w/index.php?title=Gangaghat&action=info,,1,0,1,6e-06,31
en.wikipedia.org/w/index.php?title=Special:DownloadAsPdf&page=Gangaghat&action=show-download-screen,,1,0,1,6e-06,31
en.wikipedia.org/w/index.php?title=Gangaghat&printable=yes,,1,0,1,6e-06,31
en.wikipedia.org/wiki/SH_58,,1,0,1,6e-06,31
en.wikipedia.org/w/index.php?title=Gangaghat&action=edit&section=1,,1,0,1,6e-06,31
en.wikipedia.org/w/index.php?title=Gangaghat&action=edit&section=2,,1,0,1,6e-06,31
en.wikipedia.org/wiki/Kanpur_Bridge_Left_Bank,,1,0,1,6e-06,31
en.wikipedia.org/w/index.php?title=Gangaghat&action=edit&section=3,,1,0,1,6e-06,31
indiarailinfo.com/station/map/kanpur-bridge-left-bank-cpb/4915,,1,0,1,6e-06,31
en.wikipedia.org/wiki/Template_talk:Unnao_district,,1,0,1,6e-06,31
en.wikipedia.org/wiki/Special:EditPage/Template:Unnao_district,,1,0,1,6e-06,31
"en.wikipedia.org/wiki/Auras,_Uttar_Pradesh",,1,0,1,6e-06,31
en.wikipedia.org/wiki/Bangarmau,,1,0,1,6e-06,31
en.wikipedia.org/wiki/Bhagwant_Nagar,,1,0,1,6e-06,31
en.wikipedia.org/wiki/Bighapur,,1,0,1,6e-06,31
en.wikipedia.org/wiki/Fatehpur_Chaurasi,,1,0,1,6e-06,31
en.wikipedia.org/wiki/Ganj_Muradabad,,1,0,1,6e-06,31
"en.wikipedia.org/wiki/Hyderabad,_Uttar_Pradesh",,1,0,1,6e-06,31
"en.wikipedia.org/wiki/Kursath,_Unnao",,1,0,1,6e-06,31
en.wikipedia.org/wiki/Majhara_Pipar_Ehatmali,,1,0,1,6e-06,31
en.wikipedia.org/wiki/Maurawan,,1,0,1,6e-06,31
"en.wikipedia.org/wiki/Mohan,_Uttar_Pradesh",,1,0,1,6e-06,31
"en.wikipedia.org/wiki/Nawabganj,_Unnao",,1,0,1,6e-06,31
en.wikipedia.org/wiki/Nyotini,,1,0,1,6e-06,31
en.wikipedia.org/wiki/Purwa,,1,0,1,6e-06,31
en.wikipedia.org/wiki/Ugu,,1,0,1,6e-06,31
en.wikipedia.org/wiki/Ajgain,,1,0,1,6e-06,31
en.wikipedia.org/wiki/Akampur,,1,0,1,6e-06,31
en.wikipedia.org/wiki/Akthi,,1,0,1,6e-06,31
"en.wikipedia.org/wiki/Anwarpur,_Unnao",,1,0,1,6e-06,31
en.wikipedia.org/wiki/Arjunamau,,1,0,1,6e-06,31
"en.wikipedia.org/wiki/Asawar,_Unnao",,1,0,1,6e-06,31
en.wikipedia.org/wiki/Asehru,,1,0,1,6e-06,31
en.wikipedia.org/w/index.php?title=Asiwan&action=edit&redlink=1,,1,0,1,6e-06,31
en.wikipedia.org/wiki/Asoha,,1,0,1,6e-06,31
en.wikipedia.org/wiki/Asrenda,,1,0,1,6e-06,31
"en.wikipedia.org/wiki/Bachhaura,_Asoha",,1,0,1,6e-06,31
"en.wikipedia.org/wiki/Bachhaura,_Hilauli",,1,0,1,6e-06,31
en.wikipedia.org/wiki/Badarka,,1,0,1,6e-06,31
en.wikipedia.org/wiki/Baksar,,1,0,1,6e-06,31
en.wikipedia.org/wiki/Bardaha,,1,0,1,6e-06,31
en.wikipedia.org/wiki/Barenda,,1,0,1,6e-06,31
en.wikipedia.org/wiki/Basdeo_Khera,,1,0,1,6e-06,31
en.wikipedia.org/wiki/Bathua_Shahpur,,1,0,1,6e-06,31
en.wikipedia.org/wiki/Bhatan_Khera,,1,0,1,6e-06,31
en.wikipedia.org/wiki/Bhatmau,,1,0,1,6e-06,31
"en.wikipedia.org/wiki/Bichhiya,_Unnao",,1,0,1,6e-06,31
"en.wikipedia.org/wiki/Bihar,_Unnao",,1,0,1,6e-06,31
en.wikipedia.org/wiki/Bikamau,,1,0,1,6e-06,31
"en.wikipedia.org/wiki/Chamrauli,_Unnao",,1,0,1,6e-06,31
"en.wikipedia.org/wiki/Chaupai,_Unnao",,1,0,1,6e-06,31
en.wikipedia.org/wiki/Chhulamau,,1,0,1,6e-06,31
en.wikipedia.org/wiki/Dainta,,1,0,1,6e-06,31
en.wikipedia.org/wiki/Darsawan,,1,0,1,6e-06,31
"en.wikipedia.org/wiki/Daun,_Unnao",,1,0,1,6e-06,31
en.wikipedia.org/wiki/Deomai,,1,0,1,6e-06,31
"en.wikipedia.org/wiki/Dubai,_Unnao",,1,0,1,6e-06,31
"en.wikipedia.org/wiki/Fatehganj,_Unnao",,1,0,1,6e-06,31
en.wikipedia.org/wiki/Gulariha,,1,0,1,6e-06,31
en.wikipedia.org/w/index.php?title=Harha&action=edit&redlink=1,,1,0,1,6e-06,31
en.wikipedia.org/wiki/Harnam_Khera,,1,0,1,6e-06,31
en.wikipedia.org/wiki/Hasanganj,,1,0,1,6e-06,31
en.wikipedia.org/wiki/Hasnapur,,1,0,1,6e-06,31
en.wikipedia.org/wiki/Hilauli,,1,0,1,6e-06,31
en.wikipedia.org/wiki/Jagat_Khera,,1,0,1,6e-06,31
en.wikipedia.org/wiki/Jamipur,,1,0,1,6e-06,31
en.wikipedia.org/wiki/Jangal_Khurd,,1,0,1,6e-06,31
"en.wikipedia.org/wiki/Jera,_Unnao",,1,0,1,6e-06,31
en.wikipedia.org/wiki/Jhakwasa,,1,0,1,6e-06,31
en.wikipedia.org/wiki/Jhalotar,,1,0,1,6e-06,31
en.wikipedia.org/wiki/Kalu_Khera,,1,0,1,6e-06,31
"en.wikipedia.org/wiki/Kanchanpur,_Unnao",,1,0,1,6e-06,31
"en.wikipedia.org/wiki/Kantha,_Unnao",,1,0,1,6e-06,31
en.wikipedia.org/wiki/Keoni,,1,0,1,6e-06,31
en.wikipedia.org/wiki/Kishan_Khera,,1,0,1,6e-06,31
"en.wikipedia.org/wiki/Kukri,_Unnao",,1,0,1,6e-06,31
"en.wikipedia.org/wiki/Lachhi_Khera,_Hilauli",,1,0,1,6e-06,31
en.wikipedia.org/wiki/Lakhmademau,,1,0,1,6e-06,31
en.wikipedia.org/wiki/Lawa_Singhan_Khera,,1,0,1,6e-06,31
en.wikipedia.org/wiki/Lohli,,1,0,1,6e-06,31
"en.wikipedia.org/wiki/Lotna,_Unnao",,1,0,1,6e-06,31
en.wikipedia.org/wiki/Magarwara,,1,0,1,6e-06,31
en.wikipedia.org/wiki/Magrayar,,1,0,1,6e-06,31
"en.wikipedia.org/wiki/Maharajpur,_Unnao",,1,0,1,6e-06,31
en.wikipedia.org/wiki/Maharamau,,1,0,1,6e-06,31
en.wikipedia.org/wiki/Maharani_Khera,,1,0,1,6e-06,31
"en.wikipedia.org/wiki/Majharia,_Unnao",,1,0,1,6e-06,31
"en.wikipedia.org/wiki/Makhi,_Unnao",,1,0,1,6e-06,31
en.wikipedia.org/wiki/Malauna,,1,0,1,6e-06,31
"en.wikipedia.org/wiki/Mawai,_Hilauli",,1,0,1,6e-06,31
en.wikipedia.org/wiki/Mirmau,,1,0,1,6e-06,31
en.wikipedia.org/wiki/Mirri_Kalan,,1,0,1,6e-06,31
en.wikipedia.org/wiki/Mirri_Khurd,,1,0,1,6e-06,31
en.wikipedia.org/wiki/Miyanganj,,1,0,1,6e-06,31
en.wikipedia.org/wiki/Musandi,,1,0,1,6e-06,31
en.wikipedia.org/wiki/Nari_Chak,,1,0,1,6e-06,31
en.wikipedia.org/wiki/Nari_Khera,,1,0,1,6e-06,31
"en.wikipedia.org/w/index.php?title=Nawal,_Uttar_Pradesh&action=edit&redlink=1",,1,0,1,6e-06,31
en.wikipedia.org/wiki/Nimaicha,,1,0,1,6e-06,31
"en.wikipedia.org/wiki/Osiyan,_Unnao",,1,0,1,6e-06,31
en.wikipedia.org/wiki/Pahasa,,1,0,1,6e-06,31
en.wikipedia.org/wiki/Panhan,,1,0,1,6e-06,31
"en.wikipedia.org/wiki/Para,_Unnao",,1,0,1,6e-06,31
en.wikipedia.org/wiki/Pariyar,,1,0,1,6e-06,31
en.wikipedia.org/wiki/Parsanda,,1,0,1,6e-06,31
en.wikipedia.org/wiki/Parsandan,,1,0,1,6e-06,31
"en.wikipedia.org/wiki/Patan,_Uttar_Pradesh",,1,0,1,6e-06,31
"en.wikipedia.org/wiki/Pipri,_Asoha",,1,0,1,6e-06,31
"en.wikipedia.org/wiki/Poni,_Unnao",,1,0,1,6e-06,31
"en.wikipedia.org/wiki/Raghunathpur,_Unnao",,1,0,1,6e-06,31
"en.wikipedia.org/wiki/Rampur,_Asoha",,1,0,1,6e-06,31
"en.wikipedia.org/wiki/Rasulpur,_Nawabganj",,1,0,1,6e-06,31
"en.wikipedia.org/wiki/Rasulpur,_Purwa",,1,0,1,6e-06,31
en.wikipedia.org/wiki/Rau_Karna,,1,0,1,6e-06,31
"en.wikipedia.org/wiki/Rawatpur,_Purwa",,1,0,1,6e-06,31
"en.wikipedia.org/wiki/Reola,_Unnao",,1,0,1,6e-06,31
en.wikipedia.org/w/index.php?title=Rujhai&action=edit&redlink=1,,1,0,1,6e-06,31
"en.wikipedia.org/wiki/Sagauli,_Unnao",,1,0,1,6e-06,31
en.wikipedia.org/wiki/Salindh,,1,0,1,6e-06,31
en.wikipedia.org/wiki/Samadha,,1,0,1,6e-06,31
en.wikipedia.org/wiki/Sandana,,1,0,1,6e-06,31
"en.wikipedia.org/wiki/Sangrampur,_Unnao",,1,0,1,6e-06,31
en.wikipedia.org/wiki/Sarai_Thakuri,,1,0,1,6e-06,31
"en.wikipedia.org/wiki/Sarwan,_Unnao",,1,0,1,6e-06,31
en.wikipedia.org/wiki/Sarwara,,1,0,1,6e-06,31
en.wikipedia.org/wiki/Shukla_Khera,,1,0,1,6e-06,31
en.wikipedia.org/wiki/Sikandarpur_Karan,,1,0,1,6e-06,31
"en.wikipedia.org/wiki/Sikandarpur,_Sikandarpur_Sarausi",,1,0,1,6e-06,31
"en.wikipedia.org/wiki/Soho,_Unnao",,1,0,1,6e-06,31
en.wikipedia.org/w/index.php?title=Sonik&action=edit&redlink=1,,1,0,1,6e-06,31
en.wikipedia.org/wiki/Subas_Khera,,1,0,1,6e-06,31
en.wikipedia.org/wiki/Surseni,,1,0,1,6e-06,31
en.wikipedia.org/wiki/Terha,,1,0,1,6e-06,31
en.wikipedia.org/wiki/Tikar_Kalan,,1,0,1,6e-06,31
en.wikipedia.org/wiki/Tikar_Khurd,,1,0,1,6e-06,31
en.wikipedia.org/wiki/Utraura,,1,0,1,6e-06,31
en.wikipedia.org/wiki/Zorawarganj,,1,0,1,6e-06,31
"en.wikipedia.org/wiki/Sumerpur,_Unnao",,1,0,1,6e-06,31
en.wikipedia.org/wiki/Bichhiya,,1,0,1,6e-06,31
en.wikipedia.org/wiki/Sikandarpur_Sarausi,,1,0,1,6e-06,31
en.wikipedia.org/wiki/Category:Cities_and_towns_in_Unnao_district,,2,0,2,7e-06,31
en.m.wikipedia.org/w/index.php?title=Gangaghat&mobileaction=toggle_view_mobile,,1,0,1,6e-06,31
en.wikipedia.org/w/index.php?title=Special:CreateAccount&returnto=Sikandara,,1,0,1,6e-06,31
en.wikipedia.org/w/index.php?title=Special:UserLogin&returnto=Sikandara,,1,0,1,6e-06,31
"ceb.wikipedia.org/wiki/Sikandra_(lungsod_sa_Indiya,_Kanpur_Dehat)",,1,0,1,6e-06,31
es.wikipedia.org/wiki/Sikandra,,1,0,1,6e-06,31
hi.wikipedia.org/wiki/सिकंदरा,,1,0,1,6e-06,31
bpy.wikipedia.org/wiki/সিকান্দার,,1,0,1,6e-06,31
ms.wikipedia.org/wiki/Sikandra,,1,0,1,6e-06,31
or.wikipedia.org/wiki/ସିକନ୍ଦରା,,1,0,1,6e-06,31
"sv.wikipedia.org/wiki/Sikandra_(ort_i_Indien,_Kanpur_Dehat)",,1,0,1,6e-06,31
ur.wikipedia.org/wiki/سکندارا,,1,0,1,6e-06,31
wikidata.org/wiki/Special:EntityPage/Q16726968,,1,0,1,6e-06,31
en.wikipedia.org/wiki/Talk:Sikandara,,1,0,1,6e-06,31
en.wikipedia.org/w/index.php?title=Sikandara&action=edit,,1,0,1,6e-06,31
en.wikipedia.org/w/index.php?title=Sikandara&action=history,,1,0,1,6e-06,31
en.wikipedia.org/wiki/Special:WhatLinksHere/Sikandara,,1,0,1,6e-06,31
en.wikipedia.org/wiki/Special:RecentChangesLinked/Sikandara,,1,0,1,6e-06,31
en.wikipedia.org/w/index.php?title=Sikandara&oldid=1251512172,,1,0,1,6e-06,31
en.wikipedia.org/w/index.php?title=Sikandara&action=info,,1,0,1,6e-06,31
en.wikipedia.org/w/index.php?title=Special:DownloadAsPdf&page=Sikandara&action=show-download-screen,,1,0,1,6e-06,31
en.wikipedia.org/w/index.php?title=Sikandara&printable=yes,,1,0,1,6e-06,31
geohack.toolforge.org/geohack.php?pagename=Sikandara&params=26.44_N_79.59_E_type:city_region:IN-UP,,1,0,1,6e-06,31
en.wikipedia.org/wiki/Sikandra_(disambiguation),,1,0,1,6e-06,31
en.wikipedia.org/w/index.php?title=Sikandara&action=edit&section=1,,1,0,1,6e-06,31
en.wikipedia.org/wiki/Sikandra_(Assembly_constituency),,1,0,1,6e-06,31
en.wikipedia.org/w/index.php?title=Sikandara&action=edit&section=2,,1,0,1,6e-06,31
en.wikipedia.org/w/index.php?title=Sikandara&action=edit&section=3,,1,0,1,6e-06,31
geohack.toolforge.org/geohack.php?pagename=Sikandara&params=26_22_04_N_79_37_41_E_region:IN,,1,0,1,6e-06,31
en.wikipedia.org/w/index.php?title=Sikandara&action=edit&section=4,,1,0,1,6e-06,31
en.wikipedia.org/w/index.php?title=Sikandara&action=edit&section=5,,1,0,1,6e-06,31
censusindia.gov.in/pca/SearchDetails.aspx?Id=172866,,1,0,1,6e-06,31
fallingrain.com/world/IN/36/Sikandara.html,,1,0,1,6e-06,31
wikidata.org/wiki/Q16726968,,1,0,1,6e-06,31
musicbrainz.org/area/6f90f595-11a6-423c-adde-28d3506bbdf6,,1,0,1,6e-06,31
en.m.wikipedia.org/w/index.php?title=Sikandara&mobileaction=toggle_view_mobile,,1,0,1,6e-06,31
en.wikipedia.org/w/index.php?title=Special:CreateAccount&returnto=Saifai,,1,0,1,6e-06,31
en.wikipedia.org/w/index.php?title=Special:UserLogin&returnto=Saifai,,1,0,1,6e-06,31
azb.wikipedia.org/wiki/سایفای,,1,0,1,6e-06,31
es.wikipedia.org/wiki/Saifai,,1,0,1,6e-06,31
hi.wikipedia.org/wiki/सैफ़ई,,1,0,1,6e-06,31
arz.wikipedia.org/wiki/سايفاى_(الهند),,1,0,1,6e-06,31
ur.wikipedia.org/wiki/سیفائی,,1,0,1,6e-06,31
wikidata.org/wiki/Special:EntityPage/Q21811972,,1,0,1,6e-06,31
en.wikipedia.org/wiki/Talk:Saifai,,1,0,1,6e-06,31
en.wikipedia.org/w/index.php?title=Saifai&action=edit,,1,0,1,6e-06,31
en.wikipedia.org/w/index.php?title=Saifai&action=history,,1,0,1,6e-06,31
en.wikipedia.org/wiki/Special:WhatLinksHere/Saifai,,1,0,1,6e-06,31
en.wikipedia.org/wiki/Special:RecentChangesLinked/Saifai,,1,0,1,6e-06,31
en.wikipedia.org/w/index.php?title=Saifai&oldid=1306969825,,1,0,1,6e-06,31
en.wikipedia.org/w/index.php?title=Saifai&action=info,,1,0,1,6e-06,31
en.wikipedia.org/w/index.php?title=Special:QrCode&url=https%3A%2F%2Fen.wikipedia.org%2Fwiki%2FSaifai,,1,0,1,6e-06,31
en.wikipedia.org/w/index.php?title=Special:DownloadAsPdf&page=Saifai&action=show-download-screen,,1,0,1,6e-06,31
en.wikipedia.org/w/index.php?title=Saifai&printable=yes,,1,0,1,6e-06,31
commons.wikimedia.org/wiki/Category:Saifai,,1,0,1,6e-06,31
en.wikivoyage.org/wiki/Saifai,,1,0,1,6e-06,31
geohack.toolforge.org/geohack.php?pagename=Saifai&params=26.964_N_78.953_E_region:IN-UP_type:city,,1,0,1,6e-06,31
en.wikipedia.org/wiki/File:Saifai_village.jpg,,1,0,1,6e-06,31
en.wikipedia.org/wiki/District,,1,0,1,6e-06,31
en.wikipedia.org/wiki/Panchayati_raj_(India),,1,0,1,6e-06,31
en.wikipedia.org/wiki/Sarpanch,,1,0,1,6e-06,31
en.wikipedia.org/wiki/Circle_Officer,,1,0,1,6e-06,31
en.wikipedia.org/wiki/Member_of_the_Legislative_Assembly,,1,0,1,6e-06,31
en.wikipedia.org/wiki/Block_Pramukh,,1,0,1,6e-06,31
en.wikipedia.org/w/index.php?title=Saifai&action=edit&section=1,,1,0,1,6e-06,31
en.wikipedia.org/w/index.php?title=Saifai&action=edit&section=2,,1,0,1,6e-06,31
en.wikipedia.org/wiki/Community_development_block_in_India,,1,0,1,6e-06,31
en.wikipedia.org/w/index.php?title=Saifai&action=edit&section=3,,1,0,1,6e-06,31
en.wikipedia.org/w/index.php?title=Saifai&action=edit&section=4,,1,0,1,6e-06,31
en.wikipedia.org/w/index.php?title=Saifai&action=edit&section=5,,1,0,1,6e-06,31
"en.wikipedia.org/wiki/File:Chaudhary_Charan_Singh_Post_Graduate_College,_Heonra,_Saifai,_Etawah.jpg",,1,0,1,6e-06,31
en.wikipedia.org/wiki/Major_Dhyanchand_Sports_College,,1,0,1,6e-06,31
en.wikipedia.org/wiki/Sports_college,,1,0,1,6e-06,31
en.wikipedia.org/wiki/Chaudhary_Charan_Singh_College_of_Law,,1,0,1,6e-06,31
en.wikipedia.org/wiki/Under_graduate_degree,,1,0,1,6e-06,31
en.wikipedia.org/w/index.php?title=Saifai&action=edit&section=6,,1,0,1,6e-06,31
en.wikipedia.org/wiki/Industrial_Training_Institute,,1,0,1,6e-06,31
en.wikipedia.org/wiki/File:Sports_Authority_of_India.png,,1,0,1,6e-06,31
en.wikipedia.org/wiki/Sports_Authority_of_India,,1,0,1,6e-06,31
en.wikipedia.org/wiki/Master_Chandgi_Ram_Sports_Stadium,,1,0,1,6e-06,31
en.wikipedia.org/wiki/Handball,,1,0,1,6e-06,31
en.wikipedia.org/wiki/Worker_cooperative,,1,0,1,6e-06,31
en.wikipedia.org/wiki/Bilari,,1,0,1,6e-06,31
en.wikipedia.org/w/index.php?title=Saifai&action=edit&section=7,,1,0,1,6e-06,31
en.wikipedia.org/w/index.php?title=Saifai&action=edit&section=8,,1,0,1,6e-06,31
en.wikipedia.org/w/index.php?title=Saifai&action=edit&section=9,,1,0,1,6e-06,31
en.wikipedia.org/wiki/Mainpuri-Etawah_line,,1,0,1,6e-06,31
en.wikipedia.org/wiki/Etawah_railway_station,,1,0,1,6e-06,31
en.wikipedia.org/w/index.php?title=Saifai&action=edit&section=10,,1,0,1,6e-06,31
en.wikipedia.org/wiki/Lucknow_International_Airport,,1,0,1,6e-06,31
en.wikipedia.org/w/index.php?title=Saifai&action=edit&section=11,,1,0,1,6e-06,31
en.wikipedia.org/w/index.php?title=Saifai&action=edit&section=12,,1,0,1,6e-06,31
en.wikipedia.org/w/index.php?title=Saifai&action=edit&section=13,,1,0,1,6e-06,31
en.wikipedia.org/w/index.php?title=Saifai&action=edit&section=14,,1,0,1,6e-06,31
en.wikipedia.org/wiki/Saifai_International_Cricket_Stadium,,1,0,1,6e-06,31
en.wikipedia.org/wiki/Athletics_stadium,,1,0,1,6e-06,31
en.wikipedia.org/wiki/Master_Chandgiram_Sports_Stadium,,1,0,1,6e-06,31
en.wikipedia.org/wiki/Field_hockey_pitch,,1,0,1,6e-06,31
en.wikipedia.org/w/index.php?title=Saifai&action=edit&section=15,,1,0,1,6e-06,31
en.wikipedia.org/wiki/Tej_Pratap_Singh_Yadav,,2,0,2,6e-06,31
en.wikipedia.org/wiki/Celebrities,,1,0,1,6e-06,31
en.wikipedia.org/w/index.php?title=Saifai&action=edit&section=16,,1,0,1,6e-06,31
en.wikipedia.org/w/index.php?title=Saifai&action=edit&section=17,,1,0,1,6e-06,31
census2011.co.in/data/village/147452-saifai-uttar-pradesh.html,,1,0,1,6e-06,31
indianexpress.com/article/india/india-others/neighbours-envy-3/,,1,0,1,6e-06,31
censusindia.gov.in/2011census/dchb/0930_PART_B_DCHB_ETAWAH.pdf,,1,0,1,6e-06,31
villageinfo.in/uttar-pradesh/etawah/saifai.html,,1,0,1,6e-06,31
barcouncilofindia.org/wp-content/uploads/2010/05/List-of-Law-Colleges-2013-as-on-1st-Jan.-2013.pdf,,1,0,1,6e-06,31
pnbindia.in/PNB-farmers-welfare-trust.html,,1,0,1,6e-06,31
sportsauthorityofindia.nic.in/det.asp?tcid=18,,1,0,1,6e-06,31
jagran.com/uttar-pradesh/etawah-15240631.html,,1,0,1,6e-06,31
cooperativeup.gov.in/StaticPages/cultraining_scheme-hi.aspx,,1,0,1,6e-06,31
web.archive.org/web/20181226035820/http://www.upsrtc.com/default.aspx?depots---bus-stations,,1,0,1,6e-06,31
upsrtc.com/default.aspx?depots---bus-stations,,1,0,1,6e-06,31
jagran.com/uttar-pradesh/etawah-13631358.html,,1,0,1,6e-06,31
amarujala.com/uttar-pradesh/etawah/saifai-mahotsav-programme-2nd-time-cancelled,,1,0,1,6e-06,31
en.wikipedia.org/wiki/Category:Wikipedia_articles_with_style_issues_from_September_2022,,1,0,1,6e-06,31
en.m.wikipedia.org/w/index.php?title=Saifai&mobileaction=toggle_view_mobile,,1,0,1,6e-06,31
upload.wikimedia.org/wikipedia/commons/thumb/7/77/Saifai_village.jpg/250px-Saifai_village.jpg,,1,0,1,6e-06,31
en.wikipedia.org/w/index.php?title=Special:CreateAccount&returnto=Sarsai+Nawar+Wetland,,1,0,1,6e-06,31
en.wikipedia.org/w/index.php?title=Special:UserLogin&returnto=Sarsai+Nawar+Wetland,,1,0,1,6e-06,31
ta.wikipedia.org/wiki/சர்சாய்_நவார்_ஈரநிலம்,,1,0,1,6e-06,31
wikidata.org/wiki/Special:EntityPage/Q56277554,,1,0,1,6e-06,31
en.wikipedia.org/wiki/Talk:Sarsai_Nawar_Wetland,,1,0,1,6e-06,31
en.wikipedia.org/w/index.php?title=Sarsai_Nawar_Wetland&action=edit,,1,0,1,6e-06,31
en.wikipedia.org/w/index.php?title=Sarsai_Nawar_Wetland&action=history,,1,0,1,6e-06,31
en.wikipedia.org/wiki/Special:WhatLinksHere/Sarsai_Nawar_Wetland,,1,0,1,6e-06,31
en.wikipedia.org/wiki/Special:RecentChangesLinked/Sarsai_Nawar_Wetland,,1,0,1,6e-06,31
en.wikipedia.org/w/index.php?title=Sarsai_Nawar_Wetland&oldid=1306336376,,1,0,1,6e-06,31
en.wikipedia.org/w/index.php?title=Sarsai_Nawar_Wetland&action=info,,1,0,1,6e-06,31
en.wikipedia.org/w/index.php?title=Sarsai_Nawar_Wetland&printable=yes,,1,0,1,6e-06,31
commons.wikimedia.org/wiki/Category:Sarsai_Nawar_Wetland,,1,0,1,6e-06,31
en.wikipedia.org/wiki/Special:Map/13/26.966667/79.246666/en,,1,0,1,6e-06,31
en.wikipedia.org/wiki/Bird_sanctuary,,1,0,1,6e-06,31
en.wikipedia.org/wiki/Ramsar_site,,1,0,1,6e-06,31
en.wikipedia.org/w/index.php?title=Sarsai_Nawar_Wetland&action=edit&section=1,,1,0,1,6e-06,31
en.wikipedia.org/wiki/File:VIR_4720-res1_filtered.jpg,,1,0,1,6e-06,31
en.wikipedia.org/wiki/File:Sarsai_Nawar(1).jpg,,1,0,1,6e-06,31
en.wikipedia.org/w/index.php?title=Sarsai_Nawar_Wetland&action=edit&section=2,,1,0,1,6e-06,31
en.wikipedia.org/wiki/Dhanauri_Wetlands,,1,0,1,6e-06,31
en.wikipedia.org/wiki/Basai_Wetland,,1,0,1,6e-06,31
en.wikipedia.org/w/index.php?title=Sarsai_Nawar_Wetland&action=edit&section=3,,1,0,1,6e-06,31
rsis.ramsar.org/ris/2411,,1,0,1,6e-06,31
en.wikipedia.org/w/index.php?title=Sarsai_Nawar_Wetland&action=edit&section=4,,1,0,1,6e-06,31
en.wikivoyage.org/wiki/Sarsai_Nawar_Wetland,,1,0,1,6e-06,31
en.wikipedia.org/wiki/Category:Wildlife_sanctuaries_in_Uttar_Pradesh,,1,0,1,6e-06,31
en.wikipedia.org/wiki/Category:Wetlands_of_India,,1,0,1,6e-06,31
en.m.wikipedia.org/w/index.php?title=Sarsai_Nawar_Wetland&mobileaction=toggle_view_mobile,,1,0,1,6e-06,31
upload.wikimedia.org/wikipedia/commons/thumb/d/d3/Sarsai_Nawar(1).jpg/250px-Sarsai_Nawar(1).jpg,,1,0,1,6e-06,31
en.wikipedia.org/w/index.php?title=Special:CreateAccount&returnto=Ratan+Lal+Nagar,,1,0,1,7e-06,31
en.wikipedia.org/w/index.php?title=Special:UserLogin&returnto=Ratan+Lal+Nagar,,1,0,1,7e-06,31
wikidata.org/wiki/Special:EntityPage/Q17086282,,1,0,1,7e-06,31
en.wikipedia.org/wiki/Talk:Ratan_Lal_Nagar,,1,0,1,7e-06,31
en.wikipedia.org/w/index.php?title=Ratan_Lal_Nagar&action=edit,,1,0,1,7e-06,31
en.wikipedia.org/w/index.php?title=Ratan_Lal_Nagar&action=history,,1,0,1,7e-06,31
en.wikipedia.org/wiki/Special:WhatLinksHere/Ratan_Lal_Nagar,,1,0,1,7e-06,31
en.wikipedia.org/wiki/Special:RecentChangesLinked/Ratan_Lal_Nagar,,1,0,1,7e-06,31
en.wikipedia.org/w/index.php?title=Ratan_Lal_Nagar&oldid=1286515615,,1,0,1,7e-06,31
en.wikipedia.org/w/index.php?title=Ratan_Lal_Nagar&action=info,,1,0,1,7e-06,31
en.wikipedia.org/w/index.php?title=Ratan_Lal_Nagar&printable=yes,,1,0,1,7e-06,31
"en.wikipedia.org/w/index.php?title=Barra,Kanpur&action=edit&redlink=1",,1,0,1,7e-06,31
en.wikipedia.org/w/index.php?title=Harmilap_Mission_School&action=edit&redlink=1,,1,0,1,7e-06,31
en.m.wikipedia.org/w/index.php?title=Ratan_Lal_Nagar&mobileaction=toggle_view_mobile,,1,0,1,7e-06,31
en.wikipedia.org/w/index.php?title=Special:CreateAccount&returnto=Rawatpur,,1,0,1,6e-06,31
en.wikipedia.org/w/index.php?title=Special:UserLogin&returnto=Rawatpur,,1,0,1,6e-06,31
wikidata.org/wiki/Special:EntityPage/Q7296950,,1,0,1,6e-06,31
en.wikipedia.org/wiki/Talk:Rawatpur,,1,0,1,6e-06,31
en.wikipedia.org/w/index.php?title=Rawatpur&action=edit,,1,0,1,6e-06,31
en.wikipedia.org/w/index.php?title=Rawatpur&action=history,,1,0,1,6e-06,31
en.wikipedia.org/wiki/Special:WhatLinksHere/Rawatpur,,1,0,1,6e-06,31
en.wikipedia.org/wiki/Special:RecentChangesLinked/Rawatpur,,1,0,1,6e-06,31
en.wikipedia.org/w/index.php?title=Rawatpur&oldid=1282986964,,1,0,1,6e-06,31
en.wikipedia.org/w/index.php?title=Rawatpur&action=info,,1,0,1,6e-06,31
en.wikipedia.org/w/index.php?title=Special:DownloadAsPdf&page=Rawatpur&action=show-download-screen,,1,0,1,6e-06,31
en.wikipedia.org/w/index.php?title=Rawatpur&printable=yes,,1,0,1,6e-06,31
en.wikipedia.org/w/index.php?title=Rawatpur&action=edit&section=1,,1,0,1,6e-06,31
en.wikipedia.org/w/index.php?title=Rawatpur&action=edit&section=2,,1,0,1,6e-06,31
en.wikipedia.org/wiki/J_K_Temple,,2,0,2,7e-06,31
"en.wikipedia.org/wiki/Rave@Moti_Mall,_Kanpur",,1,0,1,6e-06,31
en.wikipedia.org/w/index.php?title=Rawatpur&action=edit&section=3,,1,0,1,6e-06,31
en.wikipedia.org/w/index.php?title=Rawatpur&action=edit&section=4,,1,0,1,6e-06,31
en.m.wikipedia.org/w/index.php?title=Rawatpur&mobileaction=toggle_view_mobile,,1,0,1,6e-06,31
fr.wikipedia.org/wiki/Université_technique_de_l%27Uttar_Pradesh,,3,0,3,6e-06,31
hi.wikipedia.org/wiki/डॉ॰_ए॰_पी॰_जे॰_अब्दुल_कलाम_प्राविधिक_विश्वविद्यालय,,3,0,3,6e-06,31
ta.wikipedia.org/wiki/டாக்டர்_ஆ._ப._ஜெ._அப்துல்_கலாம்_தொழில்நுட்ப_பல்கலைக்கழகம்,,3,0,3,6e-06,31
ur.wikipedia.org/wiki/ڈاکٹر_اے_پی_جے_عبدالکلام_ٹیکنیکل_یونیورسٹی,,3,0,3,6e-06,31
wikidata.org/wiki/Special:EntityPage/Q7903351,,3,0,3,6e-06,31
"en.wikipedia.org/wiki/Talk:Dr._A._P._J._Abdul_Kalam_Technical_University,_Lucknow",,3,0,3,6e-06,31
"en.wikipedia.org/wiki/Special:WhatLinksHere/Dr._A._P._J._Abdul_Kalam_Technical_University,_Lucknow",,3,0,3,6e-06,31
en.wikipedia.org/wiki/File:Dr._A.P.J._Abdul_Kalam_Technical_University_logo.png,,3,0,3,6e-06,31
en.wikipedia.org/wiki/Special:Map/13/26.9443029/80.9396275/en,,3,0,3,6e-06,31
en.wikipedia.org/wiki/IET_Lucknow,,3,0,3,6e-06,31
en.wikipedia.org/wiki/List_of_colleges_affiliated_with_Dr._A.P.J._Abdul_Kalam_Technical_University,,3,0,3,6e-06,31
en.wikipedia.org/wiki/Institute_of_Engineering_and_Technology,,3,0,3,6e-06,31
"en.wikipedia.org/wiki/Faculty_of_Architecture,_Dr._A.P.J._Abdul_Kalam_Technical_University",,3,0,3,6e-06,31
en.wikipedia.org/wiki/Jauhar_College_of_Engineering_and_Technology,,3,0,3,6e-06,31
en.wikipedia.org/wiki/Hospitality_management_studies,,3,0,3,6e-06,31
en.wikipedia.org/wiki/B.Arch,,3,0,3,6e-06,31
en.wikipedia.org/wiki/Bachelor_of_Pharmacy,,3,0,3,6e-06,31
en.wikipedia.org/wiki/File:JSSATE_Noida.png,,3,0,3,6e-06,31
jssaten.ac.in/,,3,0,3,6e-06,31
en.wikipedia.org/wiki/Greater_Noida_Industrial_Development_Authority,,3,0,3,6e-06,31
en.wikipedia.org/wiki/Nikita_Anand,,3,0,3,6e-06,31
en.wikipedia.org/wiki/Gaurav_Chaudhary,,3,0,3,6e-06,31
en.wikipedia.org/wiki/Sudhanshu_Trivedi,,3,0,3,6e-06,31
en.wikipedia.org/wiki/Praveen_Kumar_Nishad,,3,0,3,6e-06,31
en.wikipedia.org/wiki/Yasar_Shah,,3,0,3,6e-06,31
en.wikipedia.org/wiki/Abdullah_Azam_Khan,,3,0,3,6e-06,31
en.wikipedia.org/wiki/Swati_Maliwal,,3,0,3,6e-06,31
en.wikipedia.org/wiki/Arun_Verma,,3,0,3,6e-06,31
en.wikipedia.org/wiki/Utkarsh_Verma,,3,0,3,6e-06,31
en.wikipedia.org/wiki/Kumudini_Tyagi,,3,0,3,6e-06,31
en.wikipedia.org/wiki/Reecha_Sinha,,3,0,3,6e-06,31
en.wikipedia.org/wiki/Prachi_Mishra,,3,0,3,6e-06,31
en.wikipedia.org/wiki/Ruchita_Misra,,3,0,3,6e-06,31
en.wikipedia.org/wiki/EA_Sports,,3,0,3,6e-06,31
en.wikipedia.org/wiki/R._K._Mittal,,3,0,3,6e-06,31
en.wikipedia.org/wiki/R.K._Khandal,,3,0,3,6e-06,31
en.wikipedia.org/wiki/Ghanshyam_Binani,,3,0,3,6e-06,31
web.archive.org/web/20100124084343/http://www.aicte-india.org/statisticuniversities.htm,,3,0,3,6e-06,31
aicte-india.org/statisticuniversities.htm,,3,0,3,6e-06,31
web.archive.org/web/20110721151149/http://uptu.ac.in/colleges/clogin_28052010.pdf,,3,0,3,6e-06,31
uptu.ac.in/colleges/clogin_28052010.pdf,,3,0,3,6e-06,31
web.archive.org/web/20120421123135/http://www.uptu.ac.in/academics/inst_list.asp,,3,0,3,6e-06,31
uptu.ac.in/academics/inst_list.asp,,3,0,3,6e-06,31
erp.aktu.ac.in/webpages/kyc/AboutAKTU.aspx,,3,0,3,6e-06,31
web.archive.org/web/20190928113255/https://erp.aktu.ac.in/webpages/kyc/AboutAKTU.aspx,,3,0,3,6e-06,31
indiatoday.intoday.in/education/story/uptu-renamed-as-apj-abdul-kalam-tech-university/1/455535.html,,3,0,3,6e-06,31
web.archive.org/web/20110820112221/http://magazine.uptuwatch.com/?p=1864,,3,0,3,6e-06,31
magazine.uptuwatch.com/?p=1864,,3,0,3,6e-06,31
aktu.ac.in/pdf/annualreport2017.pdf,,3,0,3,6e-06,31
web.archive.org/web/20180116135434/https://aktu.ac.in/pdf/annualreport2017.pdf,,3,0,3,6e-06,31
mnnit.ac.in/index.php/institute/about-us,,3,0,3,6e-06,31
web.archive.org/web/20230903184129/http://www.mnnit.ac.in/index.php/institute/about-us,,3,0,3,6e-06,31
uptu.ac.in/examination/branch_code_list.htm,,3,0,3,6e-06,31
web.archive.org/web/20130516012420/http://www.uptu.ac.in/examination/branch_code_list.htm,,3,0,3,6e-06,31
aktu.ac.in/naac%20programm.html,,3,0,3,6e-06,31
jssaten.ac.in//about,,3,0,3,6e-06,31
jssaten.ac.in/pview/about_mvp,,3,0,3,6e-06,31
jssonline.org/note-on-jss-mahavidyapeetha-ghaziabad-noida/,,3,0,3,6e-06,31
erp.aktu.ac.in/WebPages/KYC/CollegeDetailedInformation.aspx?Inst=091%20%20&S=26,,3,0,3,6e-06,31
uptac.admissions.nic.in/institutes/,,3,0,3,6e-06,31
cdnbbsr.s3waas.gov.in/s32d969e2cee8cfa07ce7ca0bb13c7a36d/uploads/2025/07/2025072447.pdf,,3,0,3,6e-06,31
nirfindia.org/Rankings/2025/EngineeringRanking300.html,,3,0,3,6e-06,31
outlookindia.com/education/top-160-private-engineering-institutes-2,,3,0,3,6e-06,31
outlookindia.com/education/outlook-icare-rankings-2025-top-200-private-engineering-institutes,,3,0,3,6e-06,31
igauge.in/institution/colleges/jss-academy-of-technical-education-noida,,3,0,3,6e-06,31
millenniumpost.in/delhi/pvt-universities-plan-to-set-up-campuses-in-gr-noida-546027,,3,0,3,6e-06,31
ted.com/tedx/events/24520,,3,0,3,6e-06,31
nstedb.com/institutional/step.htm,,3,0,3,6e-06,31
nstedb.com/institutional/step-centre.htm,,3,0,3,6e-06,31
dst.gov.in/breath-fresh-air-bikers,,3,0,3,6e-06,31
theprint.in/economy/nitin-gadkari-to-inaugurate-sustainable-india-2023-event-on-nov-21/1850843/,,3,0,3,6e-06,31
en.wikipedia.org/wiki/The_Print,,3,0,3,6e-06,31
india.gov.in/my-government/indian-parliament/dr-sudhanshu-trivedi,,3,0,3,6e-06,31
india.gov.in/my-government/indian-parliament/praveen-kumar-nishad,,3,0,3,6e-06,31
myneta.info/uttarpradesh2017/candidate.php?candidate_id=4427,,3,0,3,6e-06,31
ibtimes.co.in/who-swati-maliwal-why-she-indefinite-hunger-strike-767315,,3,0,3,6e-06,31
web.archive.org/web/20141225212649/http://arunvermamla.com/About.aspx,,3,0,3,6e-06,31
arunvermamla.com/About.aspx,,3,0,3,6e-06,31
srijanpalsingh.com/about,,3,0,3,6e-06,31
web.archive.org/web/20230903151720/https://www.srijanpalsingh.com/about,,3,0,3,6e-06,31
aktu.ac.in/vc-profile-ds-chauhan.html,,3,0,3,6e-06,31
web.archive.org/web/20161207043744/http://aktu.ac.in/vc-profile-ds-chauhan.html,,3,0,3,6e-06,31
aktu.ac.in/vc-profile-prem-vrat.html,,3,0,3,6e-06,31
web.archive.org/web/20160906013102/http://aktu.ac.in/vc-profile-prem-vrat.html,,3,0,3,6e-06,31
aktu.ac.in/vc_profile_kripa_shanker.html,,3,0,3,6e-06,31
web.archive.org/web/20160906012617/http://aktu.ac.in/vc_profile_kripa_shanker.html,,3,0,3,6e-06,31
aktu.ac.in/vc-khandal.html,,3,0,3,6e-06,31
web.archive.org/web/20160906012603/http://aktu.ac.in/vc-khandal.html,,3,0,3,6e-06,31
aktu.ac.in/vc_profile_onkar.html,,3,0,3,6e-06,31
web.archive.org/web/20160604175157/http://aktu.ac.in/vc_profile_onkar.html,,3,0,3,6e-06,31
aktu.ac.in/Prof.%20Vinay%20Kumar%20Pathak.html,,3,0,3,6e-06,31
aktu.ac.in/prof_kansal.html,,3,0,3,6e-06,31
aktu.ac.in/Prof%20Pradeep%20Kumar%20Mishra.html,,3,0,3,6e-06,31
aktu.ac.in/Prof%20AKR.html,,3,0,3,6e-06,31
aktu.ac.in/vice-chancellor-profile.html,,3,0,3,6e-06,31
web.archive.org/web/20230403225552/https://aktu.ac.in/vice-chancellor-profile.html,,3,0,3,6e-06,31
en.wikipedia.org/wiki/Template:Education_in_Lucknow,,3,0,3,6e-06,31
en.wikipedia.org/wiki/Template_talk:Education_in_Lucknow,,3,0,3,6e-06,31
en.wikipedia.org/wiki/Special:EditPage/Template:Education_in_Lucknow,,3,0,3,6e-06,31
en.wikipedia.org/wiki/Category:Education_in_Lucknow,,3,0,3,6e-06,31
en.wikipedia.org/wiki/Isabella_Thoburn_College,,3,0,3,6e-06,31
"en.wikipedia.org/wiki/National_P._G._College,_Lucknow",,3,0,3,6e-06,31
en.wikipedia.org/wiki/Lucknow_Christian_College,,3,0,3,6e-06,31
en.wikipedia.org/wiki/Shia_College,,3,0,3,6e-06,31
en.wikipedia.org/wiki/Lucknow_College_of_Arts_and_Crafts,,3,0,3,6e-06,31
"en.wikipedia.org/wiki/Institute_of_Hotel_Management,_Lucknow",,3,0,3,6e-06,31
"en.wikipedia.org/wiki/Seth_M.R._Jaipuria_School,_Lucknow",,3,0,3,6e-06,31
en.wikipedia.org/wiki/Loreto_Convent_Lucknow,,3,0,3,6e-06,31
en.wikipedia.org/wiki/Lucknow_Public_School,,3,0,3,6e-06,31
en.wikipedia.org/wiki/Cathedral_School_of_Lucknow,,3,0,3,6e-06,31
"en.wikipedia.org/wiki/City_Montessori_School,_RDSO_Branch",,3,0,3,6e-06,31
"en.wikipedia.org/wiki/City_Montessori_School,_Chowk_Branch",,3,0,3,6e-06,31
"en.wikipedia.org/wiki/City_Montessori_School,_Indira_Nagar_Branch",,3,0,3,6e-06,31
"en.wikipedia.org/wiki/City_Montessori_School,_Kanpur_Road_Branch",,3,0,3,6e-06,31
"en.wikipedia.org/wiki/City_Montessori_School,_Gomti_Nagar_Branch",,3,0,3,6e-06,31
"en.wikipedia.org/wiki/Bal_Vidya_Mandir,_Lucknow",,3,0,3,6e-06,31
wikidata.org/wiki/Q7903351,,3,0,3,6e-06,31
isni.org/isni/0000000107339339,,3,0,3,6e-06,31
viaf.org/viaf/159999530,,3,0,3,6e-06,31
id.loc.gov/authorities/nb2010031612,,3,0,3,6e-06,31
en.wikipedia.org/wiki/Category:Educational_institutions_established_in_2000,,3,0,3,6e-06,31
en.wikipedia.org/wiki/Category:Universities_and_colleges_in_Lucknow,,3,0,3,6e-06,31
en.wikipedia.org/wiki/Category:Memorials_to_A._P._J._Abdul_Kalam,,3,0,3,6e-06,31
upload.wikimedia.org/wikipedia/en/thumb/c/c5/JSSATE_Noida.png/250px-JSSATE_Noida.png,,3,0,3,6e-06,31
en.wikipedia.org/w/index.php?title=Special:CreateAccount&returnto=Phaphund+railway+station,,1,0,1,6e-06,31
en.wikipedia.org/w/index.php?title=Special:UserLogin&returnto=Phaphund+railway+station,,1,0,1,6e-06,31
hi.wikipedia.org/wiki/फफूँद_रेलवे_स्टेशन,,1,0,1,6e-06,31
sat.wikipedia.org/wiki/ᱯᱷᱚᱯᱷᱩᱸᱫᱽ_ᱨᱮᱞᱣᱮ_ᱥᱴᱮᱥᱚᱱ,,1,0,1,6e-06,31
ur.wikipedia.org/wiki/پھپھوند_ریلوے_اسٹیشن,,1,0,1,6e-06,31
wikidata.org/wiki/Special:EntityPage/Q24949815,,1,0,1,6e-06,31
en.wikipedia.org/wiki/Talk:Phaphund_railway_station,,1,0,1,6e-06,31
en.wikipedia.org/w/index.php?title=Phaphund_railway_station&action=edit,,1,0,1,6e-06,31
en.wikipedia.org/w/index.php?title=Phaphund_railway_station&action=history,,1,0,1,6e-06,31
en.wikipedia.org/wiki/Special:WhatLinksHere/Phaphund_railway_station,,1,0,1,6e-06,31
en.wikipedia.org/wiki/Special:RecentChangesLinked/Phaphund_railway_station,,1,0,1,6e-06,31
en.wikipedia.org/w/index.php?title=Phaphund_railway_station&oldid=1268736612,,1,0,1,6e-06,31
en.wikipedia.org/w/index.php?title=Phaphund_railway_station&action=info,,1,0,1,6e-06,31
en.wikipedia.org/w/index.php?title=Phaphund_railway_station&printable=yes,,1,0,1,6e-06,31
commons.wikimedia.org/wiki/Category:Phaphund_railway_station,,1,0,1,6e-06,31
en.wikipedia.org/wiki/Template:Kanpur–Phaphund–Tundla_section,,1,0,1,6e-06,31
en.wikipedia.org/wiki/Template_talk:Kanpur–Phaphund–Tundla_section,,1,0,1,6e-06,31
en.wikipedia.org/wiki/Special:EditPage/Template:Kanpur–Phaphund–Tundla_section,,1,0,1,6e-06,31
en.wikipedia.org/w/index.php?title=Phaphund_railway_station&action=edit&section=1,,1,0,1,6e-06,31
en.wikipedia.org/w/index.php?title=Phaphund_railway_station&action=edit&section=2,,1,0,1,6e-06,31
en.wikipedia.org/w/index.php?title=Phaphund_railway_station&action=edit&section=3,,1,0,1,6e-06,31
en.wikipedia.org/w/index.php?title=Phaphund_railway_station&action=edit&section=4,,1,0,1,6e-06,31
en.wikipedia.org/w/index.php?title=Phaphund_railway_station&action=edit&section=5,,1,0,1,6e-06,31
en.wikipedia.org/wiki/Smart_card,,1,0,1,6e-06,31
en.wikipedia.org/wiki/CCTV,,1,0,1,6e-06,31
en.wikipedia.org/w/index.php?title=Phaphund_railway_station&action=edit&section=6,,1,0,1,6e-06,31
en.wikipedia.org/w/index.php?title=Phaphund_railway_station&action=edit&section=7,,1,0,1,6e-06,31
en.wikipedia.org/wiki/Eastern_Dedicated_Freight_Corridor,,1,0,1,6e-06,31
en.wikipedia.org/w/index.php?title=Phaphund_railway_station&action=edit&section=8,,1,0,1,6e-06,31
en.wikipedia.org/w/index.php?title=Phaphund_railway_station&action=edit&section=9,,1,0,1,6e-06,31
en.wikipedia.org/w/index.php?title=Phaphund_railway_station&action=edit&section=10,,1,0,1,6e-06,31
en.wikipedia.org/wiki/File:Phaphund_Railway_Station.jpg,,1,0,1,6e-06,31
en.wikipedia.org/wiki/File:Phaphund_railway_station_2023_5.jpg,,1,0,1,6e-06,31
en.wikipedia.org/wiki/File:Phaphund_railway_station_2023_7.jpg,,1,0,1,6e-06,31
en.wikipedia.org/wiki/File:Water_tank_at_Phaphund_railway_station.jpg,,1,0,1,6e-06,31
en.wikipedia.org/wiki/East_Indian_Railway,,1,0,1,6e-06,31
en.wikipedia.org/w/index.php?title=Phaphund_railway_station&action=edit&section=11,,1,0,1,6e-06,31
news.webindia123.com/news/Articles/India/20150706/2635577.html,,1,0,1,6e-06,31
en.wikipedia.org/w/index.php?title=Phaphund_railway_station&action=edit&section=12,,1,0,1,6e-06,31
indiarailinfo.com/arrivals/905/,,1,0,1,6e-06,31
en.wikipedia.org/wiki/Category:Railway_stations_in_India_opened_in_1886,,1,0,1,6e-06,31
en.wikipedia.org/wiki/Category:Railway_stations_in_Auraiya_district,,1,0,1,6e-06,31
en.m.wikipedia.org/w/index.php?title=Phaphund_railway_station&mobileaction=toggle_view_mobile,,1,0,1,6e-06,31
upload.wikimedia.org/wikipedia/commons/thumb/0/0e/BSicon_ABZg%2Bl.svg/20px-BSicon_ABZg%2Bl.svg.png,,1,0,1,6e-06,31
upload.wikimedia.org/wikipedia/commons/thumb/0/04/BSicon_SKRZ-G4o.svg/20px-BSicon_SKRZ-G4o.svg.png,,1,0,1,6e-06,31
upload.wikimedia.org/wikipedia/commons/thumb/3/35/NH2-IN.svg/20px-NH2-IN.svg.png,,1,0,1,6e-06,31
upload.wikimedia.org/wikipedia/commons/thumb/2/20/BSicon_BST.svg/20px-BSicon_BST.svg.png,,1,0,1,6e-06,31
upload.wikimedia.org/wikipedia/commons/thumb/e/e3/BSicon_KBSTeq.svg/20px-BSicon_KBSTeq.svg.png,,1,0,1,6e-06,31
upload.wikimedia.org/wikipedia/commons/thumb/4/41/BSicon_STR%2Bc2.svg/20px-BSicon_STR%2Bc2.svg.png,,1,0,1,6e-06,31
upload.wikimedia.org/wikipedia/commons/thumb/6/67/BSicon_BHF3.svg/20px-BSicon_BHF3.svg.png,,1,0,1,6e-06,31
upload.wikimedia.org/wikipedia/commons/thumb/c/cc/BSicon_ABZ2%2B1g.svg/20px-BSicon_ABZ2%2B1g.svg.png,,1,0,1,6e-06,31
upload.wikimedia.org/wikipedia/commons/thumb/7/7d/BSicon_STRc34.svg/20px-BSicon_STRc34.svg.png,,1,0,1,6e-06,31
upload.wikimedia.org/wikipedia/commons/thumb/9/94/BSicon_STRc1.svg/20px-BSicon_STRc1.svg.png,,1,0,1,6e-06,31
upload.wikimedia.org/wikipedia/commons/thumb/c/ca/BSicon_ABZq%2Br.svg/20px-BSicon_ABZq%2Br.svg.png,,1,0,1,6e-06,31
upload.wikimedia.org/wikipedia/commons/thumb/b/b7/BSicon_ABZ%2B4r.svg/20px-BSicon_ABZ%2B4r.svg.png,,1,0,1,6e-06,31
upload.wikimedia.org/wikipedia/commons/thumb/a/a6/BSicon_STRl.svg/20px-BSicon_STRl.svg.png,,1,0,1,6e-06,31
en.wikipedia.org/w/index.php?title=Special:CreateAccount&returnto=Rasulabad,,1,0,1,6e-06,31
en.wikipedia.org/w/index.php?title=Special:UserLogin&returnto=Rasulabad,,1,0,1,6e-06,31
zh-min-nan.wikipedia.org/wiki/Rasulabad,,1,0,1,6e-06,31
"ceb.wikipedia.org/wiki/Rasūlābād_(lungsod_sa_Indiya,_Kanpur_Dehat)",,1,0,1,6e-06,31
el.wikipedia.org/wiki/Ρασουλαμπάντ,,1,0,1,6e-06,31
es.wikipedia.org/wiki/Rasulabad,,1,0,1,6e-06,31
fa.wikipedia.org/wiki/رسول‌آباد،_هند,,1,0,1,6e-06,31
hi.wikipedia.org/wiki/रसूलाबाद,,1,0,1,6e-06,31
bpy.wikipedia.org/wiki/রসুলাবাদ,,1,0,1,6e-06,31
it.wikipedia.org/wiki/Rasulabad,,1,0,1,6e-06,31
mg.wikipedia.org/wiki/Rasulabad,,1,0,1,6e-06,31
ms.wikipedia.org/wiki/Rasulabad,,1,0,1,6e-06,31
nl.wikipedia.org/wiki/Rasulabad,,1,0,1,6e-06,31
pl.wikipedia.org/wiki/Rasulabad,,1,0,1,6e-06,31
pt.wikipedia.org/wiki/Rasulabad,,1,0,1,6e-06,31
"sv.wikipedia.org/wiki/Rasūlābād_(ort_i_Indien,_Kanpur_Dehat)",,1,0,1,6e-06,31
ur.wikipedia.org/wiki/رسول_آباد,,1,0,1,6e-06,31
vi.wikipedia.org/wiki/Rasulabad,,1,0,1,6e-06,31
zh.wikipedia.org/wiki/拉苏拉巴德,,1,0,1,6e-06,31
wikidata.org/wiki/Special:EntityPage/Q2717648,,1,0,1,6e-06,31
en.wikipedia.org/wiki/Talk:Rasulabad,,1,0,1,6e-06,31
en.wikipedia.org/w/index.php?title=Rasulabad&action=edit,,1,0,1,6e-06,31
en.wikipedia.org/w/index.php?title=Rasulabad&action=history,,1,0,1,6e-06,31
en.wikipedia.org/wiki/Special:WhatLinksHere/Rasulabad,,1,0,1,6e-06,31
en.wikipedia.org/wiki/Special:RecentChangesLinked/Rasulabad,,1,0,1,6e-06,31
en.wikipedia.org/w/index.php?title=Rasulabad&oldid=1242828646,,1,0,1,6e-06,31
en.wikipedia.org/w/index.php?title=Rasulabad&action=info,,1,0,1,6e-06,31
en.wikipedia.org/w/index.php?title=Special:DownloadAsPdf&page=Rasulabad&action=show-download-screen,,1,0,1,6e-06,31
en.wikipedia.org/w/index.php?title=Rasulabad&printable=yes,,1,0,1,6e-06,31
"en.wikipedia.org/wiki/Rasulabad,_Iran_(disambiguation)",,1,0,1,6e-06,31
en.wikipedia.org/wiki/Rasoolabad,,1,0,1,6e-06,31
en.wikipedia.org/wiki/File:Rasulabad_railway_station_(1).jpg,,1,0,1,6e-06,31
en.wikipedia.org/w/index.php?title=Rasulabad&action=edit&section=1,,1,0,1,6e-06,31
geohack.toolforge.org/geohack.php?pagename=Rasulabad&params=26.68_N_79.78_E_,,1,0,1,6e-06,31
en.wikipedia.org/w/index.php?title=Rasulabad&action=edit&section=2,,1,0,1,6e-06,31
en.wikipedia.org/w/index.php?title=Rasulabad&action=edit&section=3,,1,0,1,6e-06,31
en.wikipedia.org/wiki/Orai,,1,0,1,6e-06,31
en.wikipedia.org/w/index.php?title=Rasulabad&action=edit&section=4,,1,0,1,6e-06,31
fallingrain.com/world/IN/36/Rasulabad.html,,1,0,1,6e-06,31
en.m.wikipedia.org/w/index.php?title=Rasulabad&mobileaction=toggle_view_mobile,,1,0,1,6e-06,31
en.wikipedia.org/w/index.php?title=Special:CreateAccount&returnto=Panki%2C+Kanpur,,1,0,1,6e-06,31
en.wikipedia.org/w/index.php?title=Special:UserLogin&returnto=Panki%2C+Kanpur,,1,0,1,6e-06,31
ur.wikipedia.org/wiki/پنکی،_کانپور,,1,0,1,6e-06,31
wikidata.org/wiki/Special:EntityPage/Q7131320,,1,0,1,6e-06,31
"en.wikipedia.org/wiki/Talk:Panki,_Kanpur",,1,0,1,6e-06,31
"en.wikipedia.org/w/index.php?title=Panki,_Kanpur&action=edit",,1,0,1,6e-06,31
"en.wikipedia.org/w/index.php?title=Panki,_Kanpur&action=history",,1,0,1,6e-06,31
"en.wikipedia.org/wiki/Special:WhatLinksHere/Panki,_Kanpur",,1,0,1,6e-06,31
"en.wikipedia.org/wiki/Special:RecentChangesLinked/Panki,_Kanpur",,1,0,1,6e-06,31
"en.wikipedia.org/w/index.php?title=Panki,_Kanpur&oldid=1281491127",,1,0,1,6e-06,31
"en.wikipedia.org/w/index.php?title=Panki,_Kanpur&action=info",,1,0,1,6e-06,31
"en.wikipedia.org/w/index.php?title=Panki,_Kanpur&printable=yes",,1,0,1,6e-06,31
en.wikipedia.org/wiki/File:Panki_railway_station_nameplate.JPG,,1,0,1,6e-06,31
"en.wikipedia.org/w/index.php?title=Panki,_Kanpur&action=edit&section=1",,1,0,1,6e-06,31
"en.wikipedia.org/w/index.php?title=Panki,_Kanpur&action=edit&section=2",,1,0,1,6e-06,31
en.wikipedia.org/wiki/File:Panki_railway_station_east.JPG,,1,0,1,6e-06,31
en.wikipedia.org/wiki/Gorakhdham_Express,,1,0,1,6e-06,31
en.wikipedia.org/wiki/Prayagraj_Express,,1,0,1,6e-06,31
"en.wikipedia.org/w/index.php?title=Panki,_Kanpur&action=edit&section=3",,1,0,1,6e-06,31
web.archive.org/web/20130421150438/http://panki.webs.com,,1,0,1,6e-06,31
panki.webs.com/,,1,0,1,6e-06,31
thehindu.com/news/national/10-killed-as-trains-collide-in-dense-fog-U.P./article16835525.ece,,1,0,1,6e-06,31
"en.m.wikipedia.org/w/index.php?title=Panki,_Kanpur&mobileaction=toggle_view_mobile",,1,0,1,6e-06,31
en.wikipedia.org/w/index.php?title=Special:CreateAccount&returnto=New+Kanpur+City,,1,0,1,6e-06,31
en.wikipedia.org/w/index.php?title=Special:UserLogin&returnto=New+Kanpur+City,,1,0,1,6e-06,31
hi.wikipedia.org/wiki/नया_कानपुर_नगर,,1,0,1,6e-06,31
wikidata.org/wiki/Special:EntityPage/Q7009637,,1,0,1,6e-06,31
en.wikipedia.org/wiki/Talk:New_Kanpur_City,,1,0,1,6e-06,31
en.wikipedia.org/w/index.php?title=New_Kanpur_City&action=edit,,1,0,1,6e-06,31
en.wikipedia.org/w/index.php?title=New_Kanpur_City&action=history,,1,0,1,6e-06,31
en.wikipedia.org/wiki/Special:WhatLinksHere/New_Kanpur_City,,1,0,1,6e-06,31
en.wikipedia.org/wiki/Special:RecentChangesLinked/New_Kanpur_City,,1,0,1,6e-06,31
en.wikipedia.org/w/index.php?title=New_Kanpur_City&oldid=1159317478,,1,0,1,6e-06,31
en.wikipedia.org/w/index.php?title=New_Kanpur_City&action=info,,1,0,1,6e-06,31
en.wikipedia.org/w/index.php?title=New_Kanpur_City&printable=yes,,1,0,1,6e-06,31
en.wikipedia.org/wiki/Special:EditPage/New_Kanpur_City,,1,0,1,6e-06,31
"google.com/search?as_eq=wikipedia&q=""New+Kanpur+City""",,1,0,1,6e-06,31
"google.com/search?tbm=nws&q=""New+Kanpur+City""+-wikipedia&tbs=ar:1",,1,0,1,6e-06,31
"google.com/search?&q=""New+Kanpur+City""&tbs=bkt:s&tbm=bks",,1,0,1,6e-06,31
"google.com/search?tbs=bks:1&q=""New+Kanpur+City""+-wikipedia",,1,0,1,6e-06,31
"scholar.google.com/scholar?q=""New+Kanpur+City""",,1,0,1,6e-06,31
"jstor.org/action/doBasicSearch?Query=""New+Kanpur+City""&acc=on&wc=on",,1,0,1,6e-06,31
en.wikipedia.org/w/index.php?title=New_Kanpur_City&action=edit&section=1,,1,0,1,6e-06,31
en.wikipedia.org/w/index.php?title=New_Kanpur_City&action=edit&section=2,,1,0,1,6e-06,31
en.wikipedia.org/w/index.php?title=New_Kanpur_City&action=edit&section=3,,1,0,1,6e-06,31
en.wikipedia.org/w/index.php?title=New_Kanpur_City&action=edit&section=4,,1,0,1,6e-06,31
en.wikipedia.org/w/index.php?title=New_Kanpur_City&action=edit&section=5,,1,0,1,6e-06,31
en.wikipedia.org/w/index.php?title=New_Kanpur_City&action=edit&section=6,,1,0,1,6e-06,31
en.wikipedia.org/w/index.php?title=New_Kanpur_City&action=edit&section=7,,1,0,1,6e-06,31
en.wikipedia.org/wiki/Bithur,,1,0,1,6e-06,31
en.wikipedia.org/w/index.php?title=New_Kanpur_City&action=edit&section=8,,1,0,1,6e-06,31
accommodationtimes.com/indian-city/kanpur/new-kanpur-city-in-offing/,,1,0,1,6e-06,31
en.wikipedia.org/w/index.php?title=New_Kanpur_City&action=edit&section=9,,1,0,1,6e-06,31
web.archive.org/web/20110721170455/http://www.kanpurdehat.nic.in/,,2,0,2,6e-06,31
kmc.up.nic.in/smartcity.htm,,1,0,1,6e-06,31
en.wikipedia.org/wiki/Category:Proposed_buildings_and_structures_in_India,,1,0,1,6e-06,31
en.wikipedia.org/wiki/Category:Townships_in_India,,1,0,1,6e-06,31
en.wikipedia.org/wiki/Category:Proposed_infrastructure_in_Uttar_Pradesh,,2,0,2,6e-06,31
en.wikipedia.org/wiki/Category:Financial_districts_in_India,,1,0,1,6e-06,31
en.wikipedia.org/wiki/Category:Buildings_and_structures_under_construction_in_India,,1,0,1,6e-06,31
en.wikipedia.org/wiki/Category:Articles_needing_additional_references_from_December_2018,,1,0,1,6e-06,31
en.m.wikipedia.org/w/index.php?title=New_Kanpur_City&mobileaction=toggle_view_mobile,,1,0,1,6e-06,31
en.wikipedia.org/w/index.php?title=Special:CreateAccount&returnto=Naubasta,,1,0,1,6e-06,31
en.wikipedia.org/w/index.php?title=Special:UserLogin&returnto=Naubasta,,1,0,1,6e-06,31
anp.wikipedia.org/wiki/नौबस्ता,,1,0,1,6e-06,31
ceb.wikipedia.org/wiki/Naubasta,,1,0,1,6e-06,31
mai.wikipedia.org/wiki/नौबस्ता,,1,0,1,6e-06,31
ms.wikipedia.org/wiki/Naubasta,,1,0,1,6e-06,31
ne.wikipedia.org/wiki/नौबस्ता,,1,0,1,6e-06,31
new.wikipedia.org/wiki/नौबस्ता,,1,0,1,6e-06,31
pl.wikipedia.org/wiki/Naubasta,,1,0,1,6e-06,31
wikidata.org/wiki/Special:EntityPage/Q3424510,,1,0,1,6e-06,31
en.wikipedia.org/wiki/Talk:Naubasta,,1,0,1,6e-06,31
en.wikipedia.org/w/index.php?title=Naubasta&action=edit,,1,0,1,6e-06,31
en.wikipedia.org/w/index.php?title=Naubasta&action=history,,1,0,1,6e-06,31
en.wikipedia.org/wiki/Special:WhatLinksHere/Naubasta,,1,0,1,6e-06,31
en.wikipedia.org/wiki/Special:RecentChangesLinked/Naubasta,,1,0,1,6e-06,31
en.wikipedia.org/w/index.php?title=Naubasta&oldid=1041792699,,1,0,1,6e-06,31
en.wikipedia.org/w/index.php?title=Naubasta&action=info,,1,0,1,6e-06,31
en.wikipedia.org/w/index.php?title=Special:DownloadAsPdf&page=Naubasta&action=show-download-screen,,1,0,1,6e-06,31
en.wikipedia.org/w/index.php?title=Naubasta&printable=yes,,1,0,1,6e-06,31
en.wikipedia.org/wiki/Village_development_committee_(Nepal),,1,0,1,6e-06,31
en.wikipedia.org/wiki/File:Nepal_Lumbini_adm_location_map.svg,,1,0,1,6e-06,31
en.wikipedia.org/wiki/File:Nepal_adm_location_map.svg,,1,0,1,6e-06,31
en.wikipedia.org/wiki/Zones_of_Nepal,,1,0,1,6e-06,31
en.wikipedia.org/wiki/Bheri_Zone,,1,0,1,6e-06,31
en.wikipedia.org/wiki/Districts_of_Nepal,,1,0,1,6e-06,31
en.wikipedia.org/wiki/UTC%2B5:45,,1,0,1,6e-06,31
en.wikipedia.org/wiki/Nepal_Time,,1,0,1,6e-06,31
en.wikipedia.org/wiki/1991_Nepal_census,,1,0,1,6e-06,31
en.wikipedia.org/w/index.php?title=Naubasta&action=edit&section=1,,1,0,1,6e-06,31
en.wikipedia.org/w/index.php?title=Naubasta&action=edit&section=2,,1,0,1,6e-06,31
digitalhimalaya.com/collections/nepalcensus/form.php?selection=1,,1,0,1,6e-06,31
en.wikipedia.org/wiki/Digital_Himalaya,,1,0,1,6e-06,31
web.archive.org/web/20090201014059/http://www.scspeb.sdnpk.org/village_development_committee.htm,,1,0,1,6e-06,31
scspeb.sdnpk.org/village_development_committee.htm,,1,0,1,6e-06,31
en.wikipedia.org/wiki/Template:Banke_District,,1,0,1,6e-06,31
en.wikipedia.org/wiki/Template_talk:Banke_District,,1,0,1,6e-06,31
en.wikipedia.org/wiki/Special:EditPage/Template:Banke_District,,1,0,1,6e-06,31
en.wikipedia.org/wiki/Nepalgunj,,1,0,1,6e-06,31
en.wikipedia.org/wiki/List_of_cities_in_Nepal,,1,0,1,6e-06,31
en.wikipedia.org/wiki/File:Banke_Province5_locator.png,,1,0,1,6e-06,31
en.wikipedia.org/wiki/Kohalpur,,1,0,1,6e-06,31
en.wikipedia.org/wiki/List_of_gaunpalikas_of_Nepal,,1,0,1,6e-06,31
en.wikipedia.org/wiki/Janaki_Rural_Municipality_(Banke_District),,1,0,1,6e-06,31
en.wikipedia.org/wiki/Khajura_Rural_Municipality,,1,0,1,6e-06,31
en.wikipedia.org/wiki/Rapti-Sonari_Rural_Municipality,,1,0,1,6e-06,31
en.wikipedia.org/wiki/Duduwa_Rural_Municipality,,1,0,1,6e-06,31
en.wikipedia.org/wiki/Baijanath_Rural_Municipality,,1,0,1,6e-06,31
en.wikipedia.org/wiki/Narainapur_Rural_Municipality,,1,0,1,6e-06,31
"en.wikipedia.org/wiki/Bageshwari,_Banke",,1,0,1,6e-06,31
en.wikipedia.org/wiki/Banakatawa,,1,0,1,6e-06,31
en.wikipedia.org/wiki/Banakatti,,1,0,1,6e-06,31
en.wikipedia.org/wiki/Basudevapur,,1,0,1,6e-06,31
en.wikipedia.org/wiki/Bejapur,,1,0,1,6e-06,31
en.wikipedia.org/wiki/Belahari,,1,0,1,6e-06,31
en.wikipedia.org/wiki/Belbhar,,1,0,1,6e-06,31
en.wikipedia.org/wiki/Betahani,,1,0,1,6e-06,31
en.wikipedia.org/wiki/Bhawaniyapur,,1,0,1,6e-06,31
en.wikipedia.org/wiki/Binauna,,1,0,1,6e-06,31
"en.wikipedia.org/wiki/Chisapani,_Banke",,1,0,1,6e-06,31
en.wikipedia.org/wiki/Ganapur,,1,0,1,6e-06,31
"en.wikipedia.org/wiki/Gangapur,_Nepal",,1,0,1,6e-06,31
en.wikipedia.org/wiki/Hirminiya,,1,0,1,6e-06,31
"en.wikipedia.org/wiki/Holiya,_Nepal",,1,0,1,6e-06,31
"en.wikipedia.org/wiki/Indrapur,_Banke",,1,0,1,6e-06,31
en.wikipedia.org/wiki/Jaispur,,1,0,1,6e-06,31
en.wikipedia.org/wiki/Kalaphanta,,1,0,1,6e-06,31
"en.wikipedia.org/wiki/Kamdi,_Banke",,1,0,1,6e-06,31
en.wikipedia.org/wiki/Kanchanapur,,1,0,1,6e-06,31
en.wikipedia.org/wiki/Kathkuiya,,1,0,1,6e-06,31
en.wikipedia.org/wiki/Khajura_Khurda,,1,0,1,6e-06,31
en.wikipedia.org/wiki/Khaskarkando,,1,0,1,6e-06,31
en.wikipedia.org/wiki/Khaskusma,,1,0,1,6e-06,31
en.wikipedia.org/wiki/Lakshmanpur,,1,0,1,6e-06,31
en.wikipedia.org/wiki/Mahadevpuri,,1,0,1,6e-06,31
en.wikipedia.org/wiki/Manikapur,,1,0,1,6e-06,31
en.wikipedia.org/wiki/Matahiya,,1,0,1,6e-06,31
en.wikipedia.org/wiki/Parsapur,,1,0,1,6e-06,31
en.wikipedia.org/wiki/Phatepur,,1,0,1,6e-06,31
en.wikipedia.org/wiki/Piparhawa,,1,0,1,6e-06,31
en.wikipedia.org/wiki/Puraina,,1,0,1,6e-06,31
en.wikipedia.org/wiki/Puraini,,1,0,1,6e-06,31
"en.wikipedia.org/wiki/Radhapur,_Nepal",,1,0,1,6e-06,31
en.wikipedia.org/wiki/Raniyapur,,1,0,1,6e-06,31
en.wikipedia.org/wiki/Saigaun,,1,0,1,6e-06,31
en.wikipedia.org/wiki/Samserganj,,1,0,1,6e-06,31
"en.wikipedia.org/wiki/Sitapur,_Banke",,1,0,1,6e-06,31
"en.wikipedia.org/wiki/Sonapur,_Banke",,1,0,1,6e-06,31
en.wikipedia.org/wiki/Titahiriya,,1,0,1,6e-06,31
en.wikipedia.org/wiki/Udarapur,,1,0,1,6e-06,31
"en.wikipedia.org/wiki/Udayapur,_Banke",,1,0,1,6e-06,31
en.wikipedia.org/wiki/Category:Populated_places_in_Banke_District,,1,0,1,6e-06,31
en.m.wikipedia.org/w/index.php?title=Naubasta&mobileaction=toggle_view_mobile,,1,0,1,6e-06,31
en.wikipedia.org/w/index.php?title=Special:CreateAccount&returnto=Mandhana%2C+Kanpur,,1,0,1,7e-06,31
en.wikipedia.org/w/index.php?title=Special:UserLogin&returnto=Mandhana%2C+Kanpur,,1,0,1,7e-06,31
"hi.wikipedia.org/wiki/मंधना,_कानपुर",,1,0,1,7e-06,31
wikidata.org/wiki/Special:EntityPage/Q6748016,,1,0,1,7e-06,31
"en.wikipedia.org/wiki/Talk:Mandhana,_Kanpur",,1,0,1,7e-06,31
"en.wikipedia.org/w/index.php?title=Mandhana,_Kanpur&action=edit",,1,0,1,7e-06,31
"en.wikipedia.org/w/index.php?title=Mandhana,_Kanpur&action=history",,1,0,1,7e-06,31
"en.wikipedia.org/wiki/Special:WhatLinksHere/Mandhana,_Kanpur",,1,0,1,7e-06,31
"en.wikipedia.org/wiki/Special:RecentChangesLinked/Mandhana,_Kanpur",,1,0,1,7e-06,31
"en.wikipedia.org/w/index.php?title=Mandhana,_Kanpur&oldid=1297515210",,1,0,1,7e-06,31
"en.wikipedia.org/w/index.php?title=Mandhana,_Kanpur&action=info",,1,0,1,7e-06,31
"en.wikipedia.org/w/index.php?title=Mandhana,_Kanpur&printable=yes",,1,0,1,7e-06,31
"en.wikipedia.org/w/index.php?title=Mandhana,_Kanpur&action=edit&section=1",,1,0,1,7e-06,31
"en.wikipedia.org/w/index.php?title=Mandhana,_Kanpur&action=edit&section=2",,1,0,1,7e-06,31
"en.wikipedia.org/w/index.php?title=Mandhana,_Kanpur&action=edit&section=3",,1,0,1,7e-06,31
censusindia.gov.in/pca/SearchDetails.aspx?Id=168121,,1,0,1,7e-06,31
"en.m.wikipedia.org/w/index.php?title=Mandhana,_Kanpur&mobileaction=toggle_view_mobile",,1,0,1,7e-06,31
en.wikipedia.org/w/index.php?title=Special:CreateAccount&returnto=Lucknow–Kanpur+Suburban+Railway,,2,0,2,6e-06,31
en.wikipedia.org/w/index.php?title=Special:UserLogin&returnto=Lucknow–Kanpur+Suburban+Railway,,2,0,2,6e-06,31
wikidata.org/wiki/Special:EntityPage/Q6697763,,2,0,2,6e-06,31
en.wikipedia.org/wiki/Talk:Lucknow–Kanpur_Suburban_Railway,,2,0,2,6e-06,31
en.wikipedia.org/w/index.php?title=Lucknow–Kanpur_Suburban_Railway&action=edit,,2,0,2,6e-06,31
en.wikipedia.org/w/index.php?title=Lucknow–Kanpur_Suburban_Railway&action=history,,2,0,2,6e-06,31
en.wikipedia.org/wiki/Special:WhatLinksHere/Lucknow–Kanpur_Suburban_Railway,,2,0,2,6e-06,31
en.wikipedia.org/wiki/Special:RecentChangesLinked/Lucknow–Kanpur_Suburban_Railway,,2,0,2,6e-06,31
en.wikipedia.org/w/index.php?title=Lucknow–Kanpur_Suburban_Railway&oldid=1288854171,,2,0,2,6e-06,31
en.wikipedia.org/w/index.php?title=Lucknow–Kanpur_Suburban_Railway&action=info,,2,0,2,6e-06,31
en.wikipedia.org/w/index.php?title=Lucknow–Kanpur_Suburban_Railway&printable=yes,,2,0,2,6e-06,31
commons.wikimedia.org/wiki/Category:Lucknow–Kanpur_MEMU,,2,0,2,6e-06,31
en.wikipedia.org/wiki/Special:EditPage/Lucknow–Kanpur_Suburban_Railway,,2,0,2,6e-06,31
"google.com/search?as_eq=wikipedia&q=""Lucknow–Kanpur+Suburban+Railway""",,2,0,2,6e-06,31
"google.com/search?tbm=nws&q=""Lucknow–Kanpur+Suburban+Railway""+-wikipedia&tbs=ar:1",,2,0,2,6e-06,31
"google.com/search?&q=""Lucknow–Kanpur+Suburban+Railway""&tbs=bkt:s&tbm=bks",,2,0,2,6e-06,31
"google.com/search?tbs=bks:1&q=""Lucknow–Kanpur+Suburban+Railway""+-wikipedia",,2,0,2,6e-06,31
"scholar.google.com/scholar?q=""Lucknow–Kanpur+Suburban+Railway""",,2,0,2,6e-06,31
"jstor.org/action/doBasicSearch?Query=""Lucknow–Kanpur+Suburban+Railway""&acc=on&wc=on",,2,0,2,6e-06,31
en.wikipedia.org/wiki/North_Eastern_Railway_Zone_(India),,2,0,2,6e-06,31
en.wikipedia.org/wiki/Electric_multiple_unit,,2,0,2,6e-06,31
en.wikipedia.org/wiki/Charbagh_Railway_Station,,2,0,2,6e-06,31
en.wikipedia.org/w/index.php?title=Lucknow–Kanpur_Suburban_Railway&action=edit&section=1,,2,0,2,6e-06,31
en.wikipedia.org/w/index.php?title=Lucknow–Kanpur_Suburban_Railway&action=edit&section=2,,2,0,2,6e-06,31
en.wikipedia.org/w/index.php?title=Lucknow–Kanpur_Suburban_Railway&action=edit&section=3,,2,0,2,6e-06,31
en.wikipedia.org/w/index.php?title=Lucknow–Kanpur_Suburban_Railway&action=edit&section=4,,2,0,2,6e-06,31
en.wikipedia.org/w/index.php?title=Lucknow–Kanpur_Suburban_Railway&action=edit&section=5,,2,0,2,6e-06,31
en.wikipedia.org/w/index.php?title=Lucknow–Kanpur_Suburban_Railway&action=edit&section=6,,2,0,2,6e-06,31
en.wikipedia.org/w/index.php?title=Lucknow–Kanpur_Suburban_Railway&action=edit&section=7,,2,0,2,6e-06,31
en.wikipedia.org/wiki/Barabanki-Lucknow_Suburban_Railway,,2,0,2,6e-06,31
en.wikipedia.org/wiki/Cawnpore-Barabanki_Railway,,2,0,2,6e-06,31
en.wikipedia.org/w/index.php?title=Lucknow–Kanpur_Suburban_Railway&action=edit&section=8,,2,0,2,6e-06,31
metrorailnews.in/lucknow-kanpur-suburban-railway/,,2,0,2,6e-06,31
en.wikipedia.org/w/index.php?title=Lucknow–Kanpur_Suburban_Railway&action=edit&section=9,,2,0,2,6e-06,31
en.wikipedia.org/wiki/Category:Suburban_rail_in_India,,2,0,2,6e-06,31
en.m.wikipedia.org/w/index.php?title=Lucknow–Kanpur_Suburban_Railway&mobileaction=toggle_view_mobile,,2,0,2,6e-06,31
en.wikipedia.org/w/index.php?title=Special:CreateAccount&returnto=Maitha,,1,0,1,7e-06,31
en.wikipedia.org/w/index.php?title=Special:UserLogin&returnto=Maitha,,1,0,1,7e-06,31
azb.wikipedia.org/wiki/مایتا_(هیندوستان),,1,0,1,7e-06,31
wikidata.org/wiki/Special:EntityPage/Q6737110,,1,0,1,7e-06,31
en.wikipedia.org/wiki/Talk:Maitha,,1,0,1,7e-06,31
en.wikipedia.org/w/index.php?title=Maitha&action=edit,,1,0,1,7e-06,31
en.wikipedia.org/w/index.php?title=Maitha&action=history,,1,0,1,7e-06,31
en.wikipedia.org/wiki/Special:WhatLinksHere/Maitha,,1,0,1,7e-06,31
en.wikipedia.org/wiki/Special:RecentChangesLinked/Maitha,,1,0,1,7e-06,31
en.wikipedia.org/w/index.php?title=Maitha&oldid=1279225054,,1,0,1,7e-06,31
en.wikipedia.org/w/index.php?title=Maitha&action=info,,1,0,1,7e-06,31
en.wikipedia.org/w/index.php?title=Special:QrCode&url=https%3A%2F%2Fen.wikipedia.org%2Fwiki%2FMaitha,,1,0,1,7e-06,31
en.wikipedia.org/w/index.php?title=Special:DownloadAsPdf&page=Maitha&action=show-download-screen,,1,0,1,7e-06,31
en.wikipedia.org/w/index.php?title=Maitha&printable=yes,,1,0,1,7e-06,31
en.wikipedia.org/wiki/Special:EditPage/Maitha,,1,0,1,7e-06,31
"google.com/search?as_eq=wikipedia&q=""Maitha""",,1,0,1,7e-06,31
"google.com/search?tbm=nws&q=""Maitha""+-wikipedia&tbs=ar:1",,1,0,1,7e-06,31
"google.com/search?&q=""Maitha""&tbs=bkt:s&tbm=bks",,1,0,1,7e-06,31
"google.com/search?tbs=bks:1&q=""Maitha""+-wikipedia",,1,0,1,7e-06,31
"scholar.google.com/scholar?q=""Maitha""",,1,0,1,7e-06,31
"jstor.org/action/doBasicSearch?Query=""Maitha""&acc=on&wc=on",,1,0,1,7e-06,31
en.wikipedia.org/wiki/File:Maitha_Railway_Station.JPG,,1,0,1,7e-06,31
en.wikipedia.org/w/index.php?title=Maitha&action=edit&section=1,,1,0,1,7e-06,31
en.wikipedia.org/w/index.php?title=Maitha&action=edit&section=2,,1,0,1,7e-06,31
en.wikipedia.org/w/index.php?title=Maitha&action=edit&section=3,,1,0,1,7e-06,31
en.wikipedia.org/w/index.php?title=Maitha&action=edit&section=4,,1,0,1,7e-06,31
en.wikipedia.org/w/index.php?title=Maitha&action=edit&section=5,,1,0,1,7e-06,31
web.archive.org/web/20161011085124/http://www.kanpurdehat.nic.in/tehsil/maitha.htm,,1,0,1,7e-06,31
kanpurdehat.nic.in/tehsil/maitha.htm,,1,0,1,7e-06,31
en.wikipedia.org/wiki/Category:Articles_needing_additional_references_from_August_2016,,1,0,1,7e-06,31
en.wikipedia.org/wiki/Category:Wikipedia_articles_needing_rewrite_from_August_2021,,1,0,1,7e-06,31
en.wikipedia.org/wiki/Category:All_articles_needing_rewrite,,1,0,1,7e-06,31
en.m.wikipedia.org/w/index.php?title=Maitha&mobileaction=toggle_view_mobile,,1,0,1,7e-06,31
en.wikipedia.org/w/index.php?title=Special:CreateAccount&returnto=Mainpuri+Lok+Sabha+constituency,,1,0,1,6e-06,31
en.wikipedia.org/w/index.php?title=Special:UserLogin&returnto=Mainpuri+Lok+Sabha+constituency,,1,0,1,6e-06,31
bn.wikipedia.org/wiki/মৈনপুরী_লোকসভা_কেন্দ্র,,1,0,1,6e-06,31
ca.wikipedia.org/wiki/Mainpuri,,1,0,1,6e-06,31
hi.wikipedia.org/wiki/मैनपुरी_लोक_सभा_निर्वाचन_क्षेत्र,,1,0,1,6e-06,31
mr.wikipedia.org/wiki/मैनपुरी_लोकसभा_मतदारसंघ,,1,0,1,6e-06,31
pa.wikipedia.org/wiki/ਮੈਨਪੁਰੀ_ਲੋਕ_ਸਭਾ_ਹਲਕਾ,,1,0,1,6e-06,31
ta.wikipedia.org/wiki/மைன்புரி_மக்களவைத்_தொகுதி,,1,0,1,6e-06,31
te.wikipedia.org/wiki/మెయిన్‌పురి_లోక్‌సభ_నియోజకవర్గం,,1,0,1,6e-06,31
wikidata.org/wiki/Special:EntityPage/Q6736725,,1,0,1,6e-06,31
en.wikipedia.org/wiki/Talk:Mainpuri_Lok_Sabha_constituency,,1,0,1,6e-06,31
en.wikipedia.org/w/index.php?title=Mainpuri_Lok_Sabha_constituency&action=edit,,1,0,1,6e-06,31
en.wikipedia.org/w/index.php?title=Mainpuri_Lok_Sabha_constituency&action=history,,1,0,1,6e-06,31
en.wikipedia.org/wiki/Special:WhatLinksHere/Mainpuri_Lok_Sabha_constituency,,1,0,1,6e-06,31
en.wikipedia.org/wiki/Special:RecentChangesLinked/Mainpuri_Lok_Sabha_constituency,,1,0,1,6e-06,31
en.wikipedia.org/w/index.php?title=Mainpuri_Lok_Sabha_constituency&oldid=1297374487,,1,0,1,6e-06,31
en.wikipedia.org/w/index.php?title=Mainpuri_Lok_Sabha_constituency&action=info,,1,0,1,6e-06,31
en.wikipedia.org/w/index.php?title=Mainpuri_Lok_Sabha_constituency&printable=yes,,1,0,1,6e-06,31
geohack.toolforge.org/geohack.php?pagename=Mainpuri_Lok_Sabha_constituency&params=27.22_N_79.03_E_,,1,0,1,6e-06,31
en.wikipedia.org/wiki/File:Dimple_Yadav.jpg,,1,0,1,6e-06,31
en.wikipedia.org/w/index.php?title=Mainpuri_Lok_Sabha_constituency&action=edit&section=1,,1,0,1,6e-06,31
en.wikipedia.org/wiki/Jaiveer_Singh,,1,0,1,6e-06,31
en.wikipedia.org/wiki/Ram_Naresh_Agnihotri,,1,0,1,6e-06,31
en.wikipedia.org/wiki/Brajesh_Katheriya,,1,0,1,6e-06,31
en.wikipedia.org/wiki/Shakya_(surname),,1,0,1,6e-06,31
en.wikipedia.org/w/index.php?title=Mainpuri_Lok_Sabha_constituency&action=edit&section=2,,1,0,1,6e-06,31
en.wikipedia.org/wiki/Badshah_Gupta,,1,0,1,6e-06,31
en.wikipedia.org/wiki/Praja_Socialist_Party,,2,0,2,6e-06,31
"en.wikipedia.org/wiki/Indian_general_election,_1967",,2,0,2,6e-06,31
en.wikipedia.org/wiki/Maharaj_Singh,,1,0,1,6e-06,31
"en.wikipedia.org/wiki/Indian_general_election,_1971",,2,0,2,6e-06,31
"en.wikipedia.org/wiki/Indian_general_election,_1977",,2,0,2,6e-06,31
en.wikipedia.org/wiki/Raghunath_Singh_Verma,,1,0,1,6e-06,31
"en.wikipedia.org/wiki/Indian_general_election,_1980",,2,0,2,6e-06,31
"en.wikipedia.org/wiki/Indian_general_election,_1984",,2,0,2,6e-06,31
"en.wikipedia.org/wiki/Indian_general_election,_1989",,2,0,2,6e-06,31
en.wikipedia.org/wiki/Uday_Pratap_Singh,,1,0,1,6e-06,31
"en.wikipedia.org/wiki/Indian_general_election,_1991",,2,0,2,6e-06,31
"en.wikipedia.org/wiki/Indian_general_election,_1998",,2,0,2,6e-06,31
"en.wikipedia.org/wiki/Indian_general_election,_1999",,2,0,2,6e-06,31
"en.wikipedia.org/wiki/Indian_general_election,_2004",,2,0,2,6e-06,31
en.wikipedia.org/wiki/Dharmendra_Yadav,,1,0,1,6e-06,31
en.wikipedia.org/wiki/2014_elections_in_India,,1,0,1,6e-06,31
en.wikipedia.org/w/index.php?title=Mainpuri_Lok_Sabha_constituency&action=edit&section=3,,1,0,1,6e-06,31
en.wikipedia.org/w/index.php?title=Mainpuri_Lok_Sabha_constituency&action=edit&section=4,,1,0,1,6e-06,31
en.wikipedia.org/w/index.php?title=Mainpuri_Lok_Sabha_constituency&action=edit&section=5,,1,0,1,6e-06,31
en.wikipedia.org/w/index.php?title=Mainpuri_Lok_Sabha_constituency&action=edit&section=6,,1,0,1,6e-06,31
en.wikipedia.org/w/index.php?title=Mainpuri_Lok_Sabha_constituency&action=edit&section=7,,1,0,1,6e-06,31
en.wikipedia.org/w/index.php?title=Mainpuri_Lok_Sabha_constituency&action=edit&section=8,,1,0,1,6e-06,31
en.wikipedia.org/wiki/Sanghmitra_Maurya,,1,0,1,6e-06,31
en.wikipedia.org/w/index.php?title=Mainpuri_Lok_Sabha_constituency&action=edit&section=9,,1,0,1,6e-06,31
en.wikipedia.org/w/index.php?title=Mainpuri_Lok_Sabha_constituency&action=edit&section=10,,1,0,1,6e-06,31
en.wikipedia.org/w/index.php?title=Mainpuri_Lok_Sabha_constituency&action=edit&section=11,,1,0,1,6e-06,31
en.wikipedia.org/w/index.php?title=Mainpuri_Lok_Sabha_constituency&action=edit&section=12,,1,0,1,6e-06,31
en.wikipedia.org/w/index.php?title=Mainpuri_Lok_Sabha_constituency&action=edit&section=13,,1,0,1,6e-06,31
en.wikipedia.org/w/index.php?title=Mainpuri_Lok_Sabha_constituency&action=edit&section=14,,1,0,1,6e-06,31
web.archive.org/web/20240525141320/https://elections24.eci.gov.in/docs/WYKXFehhEH.pdf,,1,0,1,6e-06,31
elections24.eci.gov.in/docs/WYKXFehhEH.pdf,,1,0,1,6e-06,31
ceouttarpradesh.nic.in/021_PC_Statistics_English.aspx,,1,0,1,6e-06,31
hindustantimes.com/india-news/mulayam-trying-hard-to-recapture-west-up/article1-1255487.aspx,,1,0,1,6e-06,31
eci.gov.in/statistical-report/statistical-reports/,,1,0,1,6e-06,31
en.wikipedia.org/wiki/Category:Mainpuri_district,,1,0,1,6e-06,31
en.m.wikipedia.org/w/index.php?title=Mainpuri_Lok_Sabha_constituency&mobileaction=toggle_view_mobile,,1,0,1,6e-06,31
upload.wikimedia.org/wikipedia/commons/thumb/2/2e/Dimple_Yadav.jpg/120px-Dimple_Yadav.jpg,,1,0,1,6e-06,31
en.wikipedia.org/w/index.php?title=Special:UserLogin&returnto=List+of+engineering+colleges+in+Kanpur,,1,0,1,7e-06,31
wikidata.org/wiki/Special:EntityPage/Q6618886,,1,0,1,7e-06,31
en.wikipedia.org/wiki/Talk:List_of_engineering_colleges_in_Kanpur,,1,0,1,7e-06,31
en.wikipedia.org/w/index.php?title=List_of_engineering_colleges_in_Kanpur&action=edit,,1,0,1,7e-06,31
en.wikipedia.org/w/index.php?title=List_of_engineering_colleges_in_Kanpur&action=history,,1,0,1,7e-06,31
en.wikipedia.org/wiki/Special:WhatLinksHere/List_of_engineering_colleges_in_Kanpur,,1,0,1,7e-06,31
en.wikipedia.org/wiki/Special:RecentChangesLinked/List_of_engineering_colleges_in_Kanpur,,1,0,1,7e-06,31
en.wikipedia.org/w/index.php?title=List_of_engineering_colleges_in_Kanpur&oldid=1292876859,,1,0,1,7e-06,31
en.wikipedia.org/w/index.php?title=List_of_engineering_colleges_in_Kanpur&action=info,,1,0,1,7e-06,31
en.wikipedia.org/w/index.php?title=List_of_engineering_colleges_in_Kanpur&printable=yes,,1,0,1,7e-06,31
en.wikipedia.org/wiki/Special:EditPage/List_of_engineering_colleges_in_Kanpur,,1,0,1,7e-06,31
"google.com/search?as_eq=wikipedia&q=""List+of+engineering+colleges+in+Kanpur""",,1,0,1,7e-06,31
"google.com/search?tbm=nws&q=""List+of+engineering+colleges+in+Kanpur""+-wikipedia&tbs=ar:1",,1,0,1,7e-06,31
"google.com/search?&q=""List+of+engineering+colleges+in+Kanpur""&tbs=bkt:s&tbm=bks",,1,0,1,7e-06,31
"google.com/search?tbs=bks:1&q=""List+of+engineering+colleges+in+Kanpur""+-wikipedia",,1,0,1,7e-06,31
"scholar.google.com/scholar?q=""List+of+engineering+colleges+in+Kanpur""",,1,0,1,7e-06,31
"jstor.org/action/doBasicSearch?Query=""List+of+engineering+colleges+in+Kanpur""&acc=on&wc=on",,1,0,1,7e-06,31
en.wikipedia.org/w/index.php?title=List_of_engineering_colleges_in_Kanpur&action=edit&section=1,,1,0,1,7e-06,31
aith.ac.in/,,1,0,1,7e-06,31
en.wikipedia.org/wiki/CSJMU,,1,0,1,7e-06,31
en.wikipedia.org/wiki/BTEUP,,1,0,1,7e-06,31
en.wikipedia.org/w/index.php?title=Government_Polytechnic_Kanpur&action=edit&redlink=1,,1,0,1,7e-06,31
en.wikipedia.org/w/index.php?title=Bhabha_Institute_Of_Science_and_Technology&action=edit&redlink=1,,1,0,1,7e-06,31
en.wikipedia.org/w/index.php?title=Bhabha_institute_of_technology&action=edit&redlink=1,,1,0,1,7e-06,31
en.wikipedia.org/w/index.php?title=List_of_engineering_colleges_in_Kanpur&action=edit&section=2,,1,0,1,7e-06,31
jagranjosh.com/engineering-and-other-technical-studies-colleges-in-kanpur,,1,0,1,7e-06,31
psit.ac.in/,,1,0,1,7e-06,31
web.archive.org/web/20150612082141/http://online.uptu.ac.in/abs/discription/frmInstitute.aspx,,1,0,1,7e-06,31
online.uptu.ac.in/abs/discription/frmInstitute.aspx,,1,0,1,7e-06,31
en.wikipedia.org/wiki/Category:Lists_of_engineering_colleges_in_India,,1,0,1,7e-06,31
en.wikipedia.org/wiki/Category:Kanpur-related_lists,,1,0,1,7e-06,31
en.wikipedia.org/wiki/Category:Articles_needing_additional_references_from_August_2010,,1,0,1,7e-06,31
en.wikipedia.org/w/index.php?title=Special:CreateAccount&returnto=Lal+Bangla,,1,0,1,7e-06,31
en.wikipedia.org/w/index.php?title=Special:UserLogin&returnto=Lal+Bangla,,1,0,1,7e-06,31
bn.wikipedia.org/wiki/লাল_বাংলা,,1,0,1,7e-06,31
arz.wikipedia.org/wiki/لال_البنجاليه,,1,0,1,7e-06,31
uz.wikipedia.org/wiki/Lal_Bangla,,1,0,1,7e-06,31
pa.wikipedia.org/wiki/ਲਾਲ_ਬੰਗਲਾ,,1,0,1,7e-06,31
pnb.wikipedia.org/wiki/لال_بنگلہ,,1,0,1,7e-06,31
sd.wikipedia.org/wiki/لعل_بنگلو,,1,0,1,7e-06,31
ta.wikipedia.org/wiki/லால்_பங்களா,,1,0,1,7e-06,31
ur.wikipedia.org/wiki/لال_بنگلہ,,1,0,1,7e-06,31
wikidata.org/wiki/Special:EntityPage/Q6480027,,1,0,1,7e-06,31
en.wikipedia.org/wiki/Talk:Lal_Bangla,,1,0,1,7e-06,31
en.wikipedia.org/w/index.php?title=Lal_Bangla&action=edit,,1,0,1,7e-06,31
en.wikipedia.org/w/index.php?title=Lal_Bangla&action=history,,1,0,1,7e-06,31
en.wikipedia.org/wiki/Special:WhatLinksHere/Lal_Bangla,,1,0,1,7e-06,31
en.wikipedia.org/wiki/Special:RecentChangesLinked/Lal_Bangla,,1,0,1,7e-06,31
en.wikipedia.org/w/index.php?title=Lal_Bangla&oldid=1277928605,,1,0,1,7e-06,31
en.wikipedia.org/w/index.php?title=Lal_Bangla&action=info,,1,0,1,7e-06,31
en.wikipedia.org/w/index.php?title=Special:DownloadAsPdf&page=Lal_Bangla&action=show-download-screen,,1,0,1,7e-06,31
en.wikipedia.org/w/index.php?title=Lal_Bangla&printable=yes,,1,0,1,7e-06,31
commons.wikimedia.org/wiki/Category:Lal_Bangla,,1,0,1,7e-06,31
geohack.toolforge.org/geohack.php?pagename=Lal_Bangla&params=28.6003_N_77.2381_E_source:wikidata,,1,0,1,7e-06,31
en.wikipedia.org/wiki/File:Lal_Bangla_pict..JPG,,1,0,1,7e-06,31
"en.wikipedia.org/wiki/File:Lal_Bangla,_New_Delhi,_Picture_8.jpg",,1,0,1,7e-06,31
"en.wikipedia.org/wiki/File:Lal_Bangla,_New_Delhi,_Picture_1.jpg",,1,0,1,7e-06,31
en.wikipedia.org/w/index.php?title=Lal_Bangla&action=edit&section=1,,1,0,1,7e-06,31
en.wikipedia.org/wiki/Lal_Kunwar,,1,0,1,7e-06,31
en.wikipedia.org/wiki/Tomb_of_Safdarjung,,1,0,1,7e-06,31
en.wikipedia.org/wiki/Akbar_II,,1,0,1,7e-06,31
en.wikipedia.org/wiki/Delhi_Golf_Club,,1,0,1,7e-06,31
en.wikipedia.org/wiki/Tomb_of_Syed_Abid,,1,0,1,7e-06,31
en.wikipedia.org/w/index.php?title=Lal_Bangla&action=edit&section=2,,1,0,1,7e-06,31
en.wikipedia.org/wiki/Mausoleum,,1,0,1,7e-06,31
en.wikipedia.org/w/index.php?title=Lal_Bangla&action=edit&section=3,,1,0,1,7e-06,31
en.wikipedia.org/wiki/List_of_Monuments_of_National_Importance_in_Delhi,,1,0,1,7e-06,31
en.wikipedia.org/wiki/Tomb_of_Nur_Jahan,,1,0,1,7e-06,31
en.wikipedia.org/wiki/Nur_Jahan,,1,0,1,7e-06,31
en.wikipedia.org/wiki/Roshanara_Bagh,,1,0,1,7e-06,31
en.wikipedia.org/wiki/Roshanara_Begum,,1,0,1,7e-06,31
en.wikipedia.org/w/index.php?title=Lal_Bangla&action=edit&section=4,,1,0,1,7e-06,31
asi.nic.in/asi_monu_alphalist_delhi.asp,,1,0,1,7e-06,31
so.city/delhi/article/lying-neglected-within-the-glossy-posh-delhi-golf-club-the-ancient-lal-bangla,,1,0,1,7e-06,31
astrolika.com/monuments/lal-bangla-delhi.html,,1,0,1,7e-06,31
en.wikipedia.org/w/index.php?title=Lal_Bangla&action=edit&section=5,,1,0,1,7e-06,31
en.wikipedia.org/wiki/Category:Mausoleums_in_Delhi,,1,0,1,7e-06,31
en.wikipedia.org/wiki/Category:Mughal_tombs,,1,0,1,7e-06,31
en.wikipedia.org/wiki/Category:Monuments_of_National_Importance_in_Delhi,,1,0,1,7e-06,31
en.m.wikipedia.org/w/index.php?title=Lal_Bangla&mobileaction=toggle_view_mobile,,1,0,1,7e-06,31
upload.wikimedia.org/wikipedia/commons/thumb/d/de/Lal_Bangla_pict..JPG/250px-Lal_Bangla_pict..JPG,,1,0,1,7e-06,31
en.wikipedia.org/w/index.php?title=Special:CreateAccount&returnto=Kidwai+Nagar,,1,0,1,7e-06,31
en.wikipedia.org/w/index.php?title=Special:UserLogin&returnto=Kidwai+Nagar,,1,0,1,7e-06,31
wikidata.org/wiki/Special:EntityPage/Q6405061,,1,0,1,7e-06,31
en.wikipedia.org/wiki/Talk:Kidwai_Nagar,,1,0,1,7e-06,31
en.wikipedia.org/w/index.php?title=Kidwai_Nagar&action=edit,,1,0,1,7e-06,31
en.wikipedia.org/w/index.php?title=Kidwai_Nagar&action=history,,1,0,1,7e-06,31
en.wikipedia.org/wiki/Special:WhatLinksHere/Kidwai_Nagar,,1,0,1,7e-06,31
en.wikipedia.org/wiki/Special:RecentChangesLinked/Kidwai_Nagar,,1,0,1,7e-06,31
en.wikipedia.org/w/index.php?title=Kidwai_Nagar&oldid=1286514819,,1,0,1,7e-06,31
en.wikipedia.org/w/index.php?title=Kidwai_Nagar&action=info,,1,0,1,7e-06,31
en.wikipedia.org/w/index.php?title=Kidwai_Nagar&printable=yes,,1,0,1,7e-06,31
en.wikipedia.org/wiki/Special:EditPage/Kidwai_Nagar,,1,0,1,7e-06,31
"google.com/search?as_eq=wikipedia&q=""Kidwai+Nagar""",,1,0,1,7e-06,31
"google.com/search?tbm=nws&q=""Kidwai+Nagar""+-wikipedia&tbs=ar:1",,1,0,1,7e-06,31
"google.com/search?&q=""Kidwai+Nagar""&tbs=bkt:s&tbm=bks",,1,0,1,7e-06,31
"google.com/search?tbs=bks:1&q=""Kidwai+Nagar""+-wikipedia",,1,0,1,7e-06,31
"scholar.google.com/scholar?q=""Kidwai+Nagar""",,1,0,1,7e-06,31
"jstor.org/action/doBasicSearch?Query=""Kidwai+Nagar""&acc=on&wc=on",,1,0,1,7e-06,31
en.wikipedia.org/wiki/Kilometer,,1,0,1,7e-06,31
en.wikipedia.org/wiki/Railway_station,,1,0,1,7e-06,31
en.wikipedia.org/w/index.php?title=Kidwai_Nagar&action=edit&section=1,,1,0,1,7e-06,31
en.wikipedia.org/wiki/Category:Articles_lacking_sources_from_December_2016,,1,0,1,7e-06,31
en.wikipedia.org/wiki/Category:Articles_with_topics_of_unclear_notability_from_November_2024,,1,0,1,7e-06,31
en.m.wikipedia.org/w/index.php?title=Kidwai_Nagar&mobileaction=toggle_view_mobile,,1,0,1,7e-06,31
en.wikipedia.org/w/index.php?title=Special:CreateAccount&returnto=Kanpur+Electricity+Supply+Company,,1,0,1,6e-06,31
en.wikipedia.org/w/index.php?title=Special:UserLogin&returnto=Kanpur+Electricity+Supply+Company,,1,0,1,6e-06,31
ta.wikipedia.org/wiki/கான்பூர்_மின்சார_வழங்கல்_நிறுவனம்,,1,0,1,6e-06,31
wikidata.org/wiki/Special:EntityPage/Q16943596,,1,0,1,6e-06,31
en.wikipedia.org/wiki/Talk:Kanpur_Electricity_Supply_Company,,1,0,1,6e-06,31
en.wikipedia.org/w/index.php?title=Kanpur_Electricity_Supply_Company&action=edit,,1,0,1,6e-06,31
en.wikipedia.org/w/index.php?title=Kanpur_Electricity_Supply_Company&action=history,,1,0,1,6e-06,31
en.wikipedia.org/wiki/Special:WhatLinksHere/Kanpur_Electricity_Supply_Company,,1,0,1,6e-06,31
en.wikipedia.org/wiki/Special:RecentChangesLinked/Kanpur_Electricity_Supply_Company,,1,0,1,6e-06,31
en.wikipedia.org/w/index.php?title=Kanpur_Electricity_Supply_Company&oldid=1299954236,,1,0,1,6e-06,31
en.wikipedia.org/w/index.php?title=Kanpur_Electricity_Supply_Company&action=info,,1,0,1,6e-06,31
en.wikipedia.org/w/index.php?title=Kanpur_Electricity_Supply_Company&printable=yes,,1,0,1,6e-06,31
en.wikipedia.org/wiki/Special:EditPage/Kanpur_Electricity_Supply_Company,,1,0,1,6e-06,31
"google.com/search?as_eq=wikipedia&q=""Kanpur+Electricity+Supply+Company""",,1,0,1,6e-06,31
"google.com/search?tbm=nws&q=""Kanpur+Electricity+Supply+Company""+-wikipedia&tbs=ar:1",,1,0,1,6e-06,31
"google.com/search?&q=""Kanpur+Electricity+Supply+Company""&tbs=bkt:s&tbm=bks",,1,0,1,6e-06,31
"google.com/search?tbs=bks:1&q=""Kanpur+Electricity+Supply+Company""+-wikipedia",,1,0,1,6e-06,31
"scholar.google.com/scholar?q=""Kanpur+Electricity+Supply+Company""",,1,0,1,6e-06,31
"jstor.org/action/doBasicSearch?Query=""Kanpur+Electricity+Supply+Company""&acc=on&wc=on",,1,0,1,6e-06,31
en.wikipedia.org/w/index.php?title=Kanpur_Electricity_Supply_Company&action=edit&section=1,,1,0,1,6e-06,31
web.archive.org/web/20140625144526/http://kesco.co.in/docs/aboutus.htm,,1,0,1,6e-06,31
kesco.co.in/docs/aboutus.htm,,1,0,1,6e-06,31
en.wikipedia.org/w/index.php?title=Kanpur_Electricity_Supply_Company&action=edit&section=2,,1,0,1,6e-06,31
kesco.co.in/,,1,0,1,6e-06,31
en.wikipedia.org/wiki/Category:Electric_power_distribution_network_operators_in_India,,1,0,1,6e-06,31
en.wikipedia.org/wiki/Category:Energy_companies_established_in_2000,,1,0,1,6e-06,31
en.wikipedia.org/wiki/Category:Government-owned_energy_companies_of_Uttar_Pradesh,,1,0,1,6e-06,31
en.wikipedia.org/wiki/Category:Articles_needing_additional_references_from_April_2025,,1,0,1,6e-06,31
en.wikipedia.org/wiki/Category:Articles_lacking_reliable_references_from_April_2025,,1,0,1,6e-06,31
en.wikipedia.org/w/index.php?title=Special:CreateAccount&returnto=Kanpur+division,,1,0,1,6e-06,31
en.wikipedia.org/w/index.php?title=Special:UserLogin&returnto=Kanpur+division,,1,0,1,6e-06,31
awa.wikipedia.org/wiki/कानपुर_मंडल,,1,0,1,6e-06,31
bn.wikipedia.org/wiki/কানপুর_বিভাগ,,1,0,1,6e-06,31
ca.wikipedia.org/wiki/Divisió_de_Kanpur,,1,0,1,6e-06,31
de.wikipedia.org/wiki/Kanpur_(Division),,1,0,1,6e-06,31
fa.wikipedia.org/wiki/بخش_کانپور,,1,0,1,6e-06,31
fr.wikipedia.org/wiki/Division_de_Kanpur,,1,0,1,6e-06,31
gu.wikipedia.org/wiki/કાનપુર_પ્રાંત,,1,0,1,6e-06,31
hi.wikipedia.org/wiki/कानपुर_मंडल,,1,0,1,6e-06,31
it.wikipedia.org/wiki/Divisione_di_Kanpur,,1,0,1,6e-06,31
nl.wikipedia.org/wiki/Kanpur_(divisie),,1,0,1,6e-06,31
ne.wikipedia.org/wiki/कानपुर_मण्डल,,1,0,1,6e-06,31
sat.wikipedia.org/wiki/ᱠᱟᱱᱯᱩᱨ_ᱦᱟᱹᱴᱤᱧ,,1,0,1,6e-06,31
sco.wikipedia.org/wiki/Kanpur_diveesion,,1,0,1,6e-06,31
simple.wikipedia.org/wiki/Kanpur_division,,1,0,1,6e-06,31
wikidata.org/wiki/Special:EntityPage/Q1656311,,1,0,1,6e-06,31
en.wikipedia.org/wiki/Talk:Kanpur_division,,1,0,1,6e-06,31
en.wikipedia.org/w/index.php?title=Kanpur_division&action=edit,,1,0,1,6e-06,31
en.wikipedia.org/w/index.php?title=Kanpur_division&action=history,,1,0,1,6e-06,31
en.wikipedia.org/wiki/Special:WhatLinksHere/Kanpur_division,,1,0,1,6e-06,31
en.wikipedia.org/wiki/Special:RecentChangesLinked/Kanpur_division,,1,0,1,6e-06,31
en.wikipedia.org/w/index.php?title=Kanpur_division&oldid=1305059142,,1,0,1,6e-06,31
en.wikipedia.org/w/index.php?title=Kanpur_division&action=info,,1,0,1,6e-06,31
en.wikipedia.org/w/index.php?title=Kanpur_division&printable=yes,,1,0,1,6e-06,31
commons.wikimedia.org/wiki/Category:Kanpur_division,,1,0,1,6e-06,31
en.wikipedia.org/wiki/Special:EditPage/Kanpur_division,,1,0,1,6e-06,31
"google.com/search?as_eq=wikipedia&q=""Kanpur+division""",,1,0,1,6e-06,31
"google.com/search?tbm=nws&q=""Kanpur+division""+-wikipedia&tbs=ar:1",,1,0,1,6e-06,31
"google.com/search?&q=""Kanpur+division""&tbs=bkt:s&tbm=bks",,1,0,1,6e-06,31
"google.com/search?tbs=bks:1&q=""Kanpur+division""+-wikipedia",,1,0,1,6e-06,31
"scholar.google.com/scholar?q=""Kanpur+division""",,1,0,1,6e-06,31
"jstor.org/action/doBasicSearch?Query=""Kanpur+division""&acc=on&wc=on",,1,0,1,6e-06,31
en.wikipedia.org/wiki/File:Kanpur_division.svg,,1,0,1,6e-06,31
en.wikipedia.org/w/index.php?title=Kanpur_division&action=edit&section=1,,1,0,1,6e-06,31
en.wikipedia.org/w/index.php?title=Kanpur_division&action=edit&section=2,,1,0,1,6e-06,31
en.wikipedia.org/wiki/Allahabad_division,,2,0,2,6e-06,31
en.wikipedia.org/wiki/Ramabai_Bhimrao_Ambedkar,,1,0,1,6e-06,31
en.wikipedia.org/w/index.php?title=Kanpur_division&action=edit&section=3,,1,0,1,6e-06,31
en.wikipedia.org/w/index.php?title=Kanpur_division&action=edit&section=4,,1,0,1,6e-06,31
en.wikipedia.org/wiki/Kumauni_language,,1,0,1,6e-06,31
en.wikipedia.org/w/index.php?title=Kanpur_division&action=edit&section=5,,1,0,1,6e-06,31
censusindia.gov.in/2011census/C-16/DDW-C16-STMT-MDDS-0900.XLSX,,1,0,1,6e-06,31
en.wikipedia.org/wiki/File:India_Uttar_Pradesh_locator_map.svg,,1,0,1,6e-06,31
en.wikipedia.org/wiki/Template:UttarPradesh-geo-stub,,1,0,1,6e-06,31
en.wikipedia.org/wiki/Template_talk:UttarPradesh-geo-stub,,1,0,1,6e-06,31
en.wikipedia.org/wiki/Special:EditPage/Template:UttarPradesh-geo-stub,,1,0,1,6e-06,31
en.wikipedia.org/wiki/Category:Uttar_Pradesh_geography_stubs,,1,0,1,6e-06,31
en.wikipedia.org/wiki/Category:Articles_needing_additional_references_from_September_2018,,1,0,1,6e-06,31
en.m.wikipedia.org/w/index.php?title=Kanpur_division&mobileaction=toggle_view_mobile,,1,0,1,6e-06,31
upload.wikimedia.org/wikipedia/commons/thumb/f/f3/Kanpur_division.svg/250px-Kanpur_division.svg.png,,1,0,1,6e-06,31
en.wikipedia.org/w/index.php?title=Special:CreateAccount&returnto=Lakh+Bahosi+Sanctuary,,1,0,1,6e-06,31
en.wikipedia.org/w/index.php?title=Special:UserLogin&returnto=Lakh+Bahosi+Sanctuary,,1,0,1,6e-06,31
wikidata.org/wiki/Special:EntityPage/Q6479478,,1,0,1,6e-06,31
en.wikipedia.org/wiki/Talk:Lakh_Bahosi_Sanctuary,,1,0,1,6e-06,31
en.wikipedia.org/w/index.php?title=Lakh_Bahosi_Sanctuary&action=edit,,1,0,1,6e-06,31
en.wikipedia.org/w/index.php?title=Lakh_Bahosi_Sanctuary&action=history,,1,0,1,6e-06,31
en.wikipedia.org/wiki/Special:WhatLinksHere/Lakh_Bahosi_Sanctuary,,1,0,1,6e-06,31
en.wikipedia.org/wiki/Special:RecentChangesLinked/Lakh_Bahosi_Sanctuary,,1,0,1,6e-06,31
en.wikipedia.org/w/index.php?title=Lakh_Bahosi_Sanctuary&oldid=1307674511,,1,0,1,6e-06,31
en.wikipedia.org/w/index.php?title=Lakh_Bahosi_Sanctuary&action=info,,1,0,1,6e-06,31
en.wikipedia.org/w/index.php?title=Lakh_Bahosi_Sanctuary&printable=yes,,1,0,1,6e-06,31
geohack.toolforge.org/geohack.php?pagename=Lakh_Bahosi_Sanctuary&params=26.911_N_79.641_E_,,1,0,1,6e-06,31
en.wikipedia.org/wiki/Special:EditPage/Lakh_Bahosi_Sanctuary,,1,0,1,6e-06,31
"google.com/search?as_eq=wikipedia&q=""Lakh+Bahosi+Sanctuary""",,1,0,1,6e-06,31
"google.com/search?tbm=nws&q=""Lakh+Bahosi+Sanctuary""+-wikipedia&tbs=ar:1",,1,0,1,6e-06,31
"google.com/search?&q=""Lakh+Bahosi+Sanctuary""&tbs=bkt:s&tbm=bks",,1,0,1,6e-06,31
"google.com/search?tbs=bks:1&q=""Lakh+Bahosi+Sanctuary""+-wikipedia",,1,0,1,6e-06,31
"scholar.google.com/scholar?q=""Lakh+Bahosi+Sanctuary""",,1,0,1,6e-06,31
"jstor.org/action/doBasicSearch?Query=""Lakh+Bahosi+Sanctuary""&acc=on&wc=on",,1,0,1,6e-06,31
en.wikipedia.org/wiki/Upper_Ganges_canal,,1,0,1,6e-06,31
en.wikipedia.org/w/index.php?title=Lakh_Bahosi_Sanctuary&action=edit&section=1,,1,0,1,6e-06,31
en.wikipedia.org/w/index.php?title=Lakh_Bahosi_Sanctuary&action=edit&section=2,,1,0,1,6e-06,31
en.wikipedia.org/wiki/Jackal,,1,0,1,6e-06,31
en.wikipedia.org/wiki/Blue_bull,,1,0,1,6e-06,31
en.wikipedia.org/wiki/Mongoose,,1,0,1,6e-06,31
en.wikipedia.org/wiki/Monkeys,,1,0,1,6e-06,31
en.wikipedia.org/w/index.php?title=Lakh_Bahosi_Sanctuary&action=edit&section=3,,1,0,1,6e-06,31
cse.iitk.ac.in/users/amit/bicycling/lakhbahosi/,,1,0,1,6e-06,31
unep-wcmc.org/wdpa/sitedetails.cfm?siteid=308591&level=nat,,1,0,1,6e-06,31
en.wikipedia.org/wiki/Category:Articles_lacking_sources_from_September_2023,,1,0,1,6e-06,31
en.wikipedia.org/wiki/Category:Protected_areas_with_year_of_establishment_missing,,1,0,1,6e-06,31
en.m.wikipedia.org/w/index.php?title=Lakh_Bahosi_Sanctuary&mobileaction=toggle_view_mobile,,1,0,1,6e-06,31
en.wikipedia.org/w/index.php?title=Special:CreateAccount&returnto=Kanpur+Nagar+district,,1,0,1,6e-06,31
en.wikipedia.org/w/index.php?title=Special:UserLogin&returnto=Kanpur+Nagar+district,,1,0,1,6e-06,31
ar.wikipedia.org/wiki/كانبور_نكر,,1,0,1,6e-06,31
bn.wikipedia.org/wiki/কানপুর_নগর_জেলা,,1,0,1,6e-06,31
zh-min-nan.wikipedia.org/wiki/Kanpur_Nagar,,1,0,1,6e-06,31
bh.wikipedia.org/wiki/कानपुर_नगर_जिला,,1,0,1,6e-06,31
ca.wikipedia.org/wiki/Districte_de_Kanpur_Nagar,,1,0,1,6e-06,31
ceb.wikipedia.org/wiki/Kānpur_(distrito),,1,0,1,6e-06,31
de.wikipedia.org/wiki/Kanpur_Nagar,,1,0,1,6e-06,31
es.wikipedia.org/wiki/Distrito_de_Kanpur_Nagar,,1,0,1,6e-06,31
eu.wikipedia.org/wiki/Kanpur_Nagar_barrutia,,1,0,1,6e-06,31
fa.wikipedia.org/wiki/بخش_کانپور_ناگار,,1,0,1,6e-06,31
fr.wikipedia.org/wiki/District_de_Kanpur_Nagar,,1,0,1,6e-06,31
gu.wikipedia.org/wiki/કાનપુર_નગર_જિલ્લો,,1,0,1,6e-06,31
hi.wikipedia.org/wiki/कानपुर_नगर_जिला,,1,0,1,6e-06,31
it.wikipedia.org/wiki/Distretto_di_Kanpur_Nagar,,1,0,1,6e-06,31
mr.wikipedia.org/wiki/कानपूर_जिल्हा,,1,0,1,6e-06,31
arz.wikipedia.org/wiki/كانبور_نجر,,1,0,1,6e-06,31
nl.wikipedia.org/wiki/Kanpur_Nagar,,1,0,1,6e-06,31
ne.wikipedia.org/wiki/कानपुर_नगर_जिल्ला,,1,0,1,6e-06,31
new.wikipedia.org/wiki/कानपुर_नगर_जिल्ला,,1,0,1,6e-06,31
no.wikipedia.org/wiki/Kanpur_Nagar_(distrikt),,1,0,1,6e-06,31
pa.wikipedia.org/wiki/ਕਾਨਪੁਰ_ਨਗਰ_ਜ਼ਿਲ੍ਹਾ,,1,0,1,6e-06,31
pnb.wikipedia.org/wiki/ضلع_کانپور_نگر,,1,0,1,6e-06,31
pl.wikipedia.org/wiki/Kanpur_(dystrykt),,1,0,1,6e-06,31
ru.wikipedia.org/wiki/Канпур_(округ),,1,0,1,6e-06,31
sa.wikipedia.org/wiki/कानपुरनगरमण्डलम्,,1,0,1,6e-06,31
sat.wikipedia.org/wiki/ᱠᱟᱱᱯᱩᱨ_ᱱᱚᱜᱚᱨ_ᱦᱚᱱᱚᱛ,,1,0,1,6e-06,31
sco.wikipedia.org/wiki/Kanpur_destrict,,1,0,1,6e-06,31
sv.wikipedia.org/wiki/Kanpur_Nagar,,1,0,1,6e-06,31
ta.wikipedia.org/wiki/கான்பூர்_மாவட்டம்,,1,0,1,6e-06,31
te.wikipedia.org/wiki/కాన్పూర్_నగర్_జిల్లా,,1,0,1,6e-06,31
th.wikipedia.org/wiki/อำเภอกานปุรนคร,,1,0,1,6e-06,31
ur.wikipedia.org/wiki/ضلع_کانپور_نگر,,1,0,1,6e-06,31
vi.wikipedia.org/wiki/Kanpur_(huyện),,1,0,1,6e-06,31
wikidata.org/wiki/Special:EntityPage/Q2089152,,1,0,1,6e-06,31
en.wikipedia.org/wiki/Talk:Kanpur_Nagar_district,,1,0,1,6e-06,31
en.wikipedia.org/w/index.php?title=Kanpur_Nagar_district&action=edit,,1,0,1,6e-06,31
en.wikipedia.org/w/index.php?title=Kanpur_Nagar_district&action=history,,1,0,1,6e-06,31
en.wikipedia.org/wiki/Special:WhatLinksHere/Kanpur_Nagar_district,,1,0,1,6e-06,31
en.wikipedia.org/wiki/Special:RecentChangesLinked/Kanpur_Nagar_district,,1,0,1,6e-06,31
en.wikipedia.org/w/index.php?title=Kanpur_Nagar_district&oldid=1305911994,,1,0,1,6e-06,31
en.wikipedia.org/w/index.php?title=Kanpur_Nagar_district&action=info,,1,0,1,6e-06,31
en.wikipedia.org/w/index.php?title=Kanpur_Nagar_district&printable=yes,,1,0,1,6e-06,31
commons.wikimedia.org/wiki/Category:Kanpur_Nagar_district,,1,0,1,6e-06,31
en.wikipedia.org/wiki/File:Kanpur%27s_Skyline.jpg,,1,0,1,6e-06,31
en.wikipedia.org/wiki/File:J.K._Temple.jpg,,1,0,1,6e-06,31
en.wikipedia.org/wiki/File:Ganga_Aarti_Kanpur.jpg,,1,0,1,6e-06,31
en.wikipedia.org/wiki/File:India_Uttar_Pradesh_districts_2012_Kanpur_Nagar.svg,,1,0,1,6e-06,31
en.wikipedia.org/w/index.php?title=Kanpur_Nagar_district&action=edit&section=1,,1,0,1,6e-06,31
en.wikipedia.org/wiki/Chhatrasal,,1,0,1,6e-06,31
en.wikipedia.org/wiki/Shivaji,,1,0,1,6e-06,31
en.wikipedia.org/w/index.php?title=Kanpur_Nagar_district&action=edit&section=2,,1,0,1,6e-06,31
en.wikipedia.org/wiki/Louisiana,,1,0,1,6e-06,31
en.wikipedia.org/w/index.php?title=Kanpur_Nagar_district&action=edit&section=3,,1,0,1,6e-06,31
en.wikipedia.org/wiki/Anei_(village),,1,0,1,6e-06,31
"en.wikipedia.org/wiki/Sarh,_Kanpur",,1,0,1,6e-06,31
en.wikipedia.org/w/index.php?title=Kanpur_Nagar_district&action=edit&section=4,,1,0,1,6e-06,31
en.wikipedia.org/w/index.php?title=Kanpur_Nagar_district&action=edit&section=5,,1,0,1,6e-06,31
kanpurnagar.nic.in/village-bilhaur-block/,,1,0,1,6e-06,31
en.wikipedia.org/w/index.php?title=Kanpur_Nagar_district&action=edit&section=6,,1,0,1,6e-06,31
wikidata.org/wiki/Q2089152,,1,0,1,6e-06,31
viaf.org/viaf/251102341,,1,0,1,6e-06,31
en.wikipedia.org/wiki/Category:Articles_that_may_contain_original_research_from_April_2018,,1,0,1,6e-06,31
en.m.wikipedia.org/w/index.php?title=Kanpur_Nagar_district&mobileaction=toggle_view_mobile,,1,0,1,6e-06,31
upload.wikimedia.org/wikipedia/commons/thumb/7/7d/J.K._Temple.jpg/250px-J.K._Temple.jpg,,1,0,1,6e-06,31
en.wikipedia.org/w/index.php?title=Special:UserLogin&returnto=Kanpur+City+Transport+Services+Limited,,1,0,1,6e-06,31
wikidata.org/wiki/Special:EntityPage/Q6364373,,1,0,1,6e-06,31
en.wikipedia.org/wiki/Talk:Kanpur_City_Transport_Services_Limited,,1,0,1,6e-06,31
en.wikipedia.org/w/index.php?title=Kanpur_City_Transport_Services_Limited&action=edit,,1,0,1,6e-06,31
en.wikipedia.org/w/index.php?title=Kanpur_City_Transport_Services_Limited&action=history,,1,0,1,6e-06,31
en.wikipedia.org/wiki/Special:WhatLinksHere/Kanpur_City_Transport_Services_Limited,,1,0,1,6e-06,31
en.wikipedia.org/wiki/Special:RecentChangesLinked/Kanpur_City_Transport_Services_Limited,,1,0,1,6e-06,31
en.wikipedia.org/w/index.php?title=Kanpur_City_Transport_Services_Limited&oldid=1283226766,,1,0,1,6e-06,31
en.wikipedia.org/w/index.php?title=Kanpur_City_Transport_Services_Limited&action=info,,1,0,1,6e-06,31
en.wikipedia.org/w/index.php?title=Kanpur_City_Transport_Services_Limited&printable=yes,,1,0,1,6e-06,31
en.wikipedia.org/wiki/Special:EditPage/Kanpur_City_Transport_Services_Limited,,1,0,1,6e-06,31
"google.com/search?as_eq=wikipedia&q=""Kanpur+City+Transport+Services+Limited""",,1,0,1,6e-06,31
"google.com/search?tbm=nws&q=""Kanpur+City+Transport+Services+Limited""+-wikipedia&tbs=ar:1",,1,0,1,6e-06,31
"google.com/search?&q=""Kanpur+City+Transport+Services+Limited""&tbs=bkt:s&tbm=bks",,1,0,1,6e-06,31
"google.com/search?tbs=bks:1&q=""Kanpur+City+Transport+Services+Limited""+-wikipedia",,1,0,1,6e-06,31
"scholar.google.com/scholar?q=""Kanpur+City+Transport+Services+Limited""",,1,0,1,6e-06,31
"jstor.org/action/doBasicSearch?Query=""Kanpur+City+Transport+Services+Limited""&acc=on&wc=on",,1,0,1,6e-06,31
uputd.gov.in/kanpurctsl,,1,0,1,6e-06,31
en.wikipedia.org/w/index.php?title=Kanpur_City_Transport_Services_Limited&action=edit&section=1,,1,0,1,6e-06,31
en.wikipedia.org/wiki/Jawaharlal_Nehru_National_Urban_Renewal_Mission,,1,0,1,6e-06,31
en.wikipedia.org/w/index.php?title=Kanpur_City_Transport_Services_Limited&action=edit&section=2,,1,0,1,6e-06,31
en.wikipedia.org/w/index.php?title=Kanpur_City_Transport_Services_Limited&action=edit&section=3,,1,0,1,6e-06,31
en.wikipedia.org/w/index.php?title=Kanpur_City_Transport_Services_Limited&action=edit&section=4,,1,0,1,6e-06,31
kanpuronline.in/city-guide/transport-in-kanpur,,1,0,1,6e-06,31
web.archive.org/web/20140326072055/https://www.kanpuronline.in/city-guide/transport-in-kanpur,,1,0,1,6e-06,31
books.google.com/books?id=2vTf6OtaD6cC&dq=born+in+Kanpur&pg=PA188,,1,0,1,6e-06,31
en.wikipedia.org/wiki/Template:State_owned_road_transport_companies_in_India,,1,0,1,6e-06,31
en.wikipedia.org/wiki/Template_talk:State_owned_road_transport_companies_in_India,,1,0,1,6e-06,31
en.wikipedia.org/wiki/Special:EditPage/Template:State_owned_road_transport_companies_in_India,,1,0,1,6e-06,31
en.wikipedia.org/wiki/Andhra_Pradesh_State_Road_Transport_Corporation,,1,0,1,6e-06,31
en.wikipedia.org/wiki/Arunachal_Pradesh_State_Transport_Services,,1,0,1,6e-06,31
en.wikipedia.org/wiki/Assam_State_Transport_Corporation,,1,0,1,6e-06,31
en.wikipedia.org/wiki/Bihar_State_Road_Transport_Corporation,,1,0,1,6e-06,31
en.wikipedia.org/wiki/Kadamba_Transport_Corporation,,1,0,1,6e-06,31
en.wikipedia.org/wiki/Gujarat_State_Road_Transport_Corporation,,1,0,1,6e-06,31
en.wikipedia.org/wiki/Himachal_Road_Transport_Corporation,,1,0,1,6e-06,31
en.wikipedia.org/wiki/Jammu_and_Kashmir_State_Road_Transport_Corporation,,1,0,1,6e-06,31
en.wikipedia.org/wiki/Karnataka_State_Road_Transport_Corporation,,1,0,1,6e-06,31
en.wikipedia.org/wiki/Kalyana_Karnataka_Road_Transport_Corporation,,1,0,1,6e-06,31
en.wikipedia.org/wiki/North_Western_Karnataka_Road_Transport_Corporation,,1,0,1,6e-06,31
en.wikipedia.org/wiki/Kerala_State_Road_Transport_Corporation,,1,0,1,6e-06,31
en.wikipedia.org/wiki/Kerala_Urban_Road_Transport_Corporation,,1,0,1,6e-06,31
en.wikipedia.org/wiki/Maharashtra_State_Road_Transport_Corporation,,1,0,1,6e-06,31
en.wikipedia.org/w/index.php?title=Nagaland_State_Transport&action=edit&redlink=1,,1,0,1,6e-06,31
en.wikipedia.org/wiki/Odisha_State_Road_Transport_Corporation,,1,0,1,6e-06,31
en.wikipedia.org/wiki/Puducherry_Road_Transport_Corporation,,1,0,1,6e-06,31
en.wikipedia.org/wiki/PEPSU_Road_Transport_Corporation,,1,0,1,6e-06,31
en.wikipedia.org/wiki/Punjab_Roadways,,1,0,1,6e-06,31
en.wikipedia.org/wiki/Rajasthan_State_Road_Transport_Corporation,,1,0,1,6e-06,31
en.wikipedia.org/w/index.php?title=Sikkim_Nationalised_Transport&action=edit&redlink=1,,1,0,1,6e-06,31
en.wikipedia.org/wiki/Tamil_Nadu_State_Transport_Corporation,,1,0,1,6e-06,31
en.wikipedia.org/wiki/Tripura_Road_Transport_Corporation,,1,0,1,6e-06,31
en.wikipedia.org/wiki/Uttarakhand_Transport_Corporation,,1,0,1,6e-06,31
en.wikipedia.org/wiki/North_Bengal_State_Transport_Corporation,,1,0,1,6e-06,31
en.wikipedia.org/wiki/South_Bengal_State_Transport_Corporation,,1,0,1,6e-06,31
en.wikipedia.org/wiki/West_Bengal_Transport_Corporation,,1,0,1,6e-06,31
en.wikipedia.org/wiki/Bhubaneswar_City_Bus,,1,0,1,6e-06,31
en.wikipedia.org/wiki/Ama_Bus,,1,0,1,6e-06,31
en.wikipedia.org/wiki/Chandigarh_Transport_Undertaking,,1,0,1,6e-06,31
en.wikipedia.org/wiki/Atal_Indore_City_Transport_Service_Limited,,1,0,1,6e-06,31
en.wikipedia.org/wiki/Jaipur_City_Transport_Services_Limited,,1,0,1,6e-06,31
en.wikipedia.org/wiki/Kalyan-Dombivli_Municipal_Transport,,1,0,1,6e-06,31
en.wikipedia.org/wiki/Lucknow_Mahanagar_Parivahan_Sewa,,1,0,1,6e-06,31
en.wikipedia.org/wiki/Mira-Bhayandar_Municipal_Transport,,1,0,1,6e-06,31
en.wikipedia.org/wiki/Nagpur_Mahanagar_Parivahan_Limited,,1,0,1,6e-06,31
en.wikipedia.org/wiki/Navi_Mumbai_Municipal_Transport,,1,0,1,6e-06,31
en.wikipedia.org/wiki/Pune_Mahanagar_Parivahan_Mahamandal_Limited,,1,0,1,6e-06,31
en.wikipedia.org/wiki/Surat_City_Bus,,1,0,1,6e-06,31
en.wikipedia.org/wiki/Thane_Municipal_Transport,,1,0,1,6e-06,31
en.wikipedia.org/wiki/List_of_bus_depots_in_Karnataka,,1,0,1,6e-06,31
en.wikipedia.org/wiki/Category:Metropolitan_transport_agencies_of_India,,1,0,1,6e-06,31
en.wikipedia.org/wiki/Category:Transport_companies_established_in_2006,,1,0,1,6e-06,31
en.wikipedia.org/wiki/Category:Indian_companies_established_in_2006,,1,0,1,6e-06,31
en.wikipedia.org/wiki/Category:Articles_needing_additional_references_from_August_2019,,1,0,1,6e-06,31
en.wikipedia.org/w/index.php?title=Special:CreateAccount&returnto=Kanpur+Lucknow+Roadways+Service,,1,0,1,6e-06,31
en.wikipedia.org/w/index.php?title=Special:UserLogin&returnto=Kanpur+Lucknow+Roadways+Service,,1,0,1,6e-06,31
wikidata.org/wiki/Special:EntityPage/Q6364365,,1,0,1,6e-06,31
en.wikipedia.org/wiki/Talk:Kanpur_Lucknow_Roadways_Service,,1,0,1,6e-06,31
en.wikipedia.org/w/index.php?title=Kanpur_Lucknow_Roadways_Service&action=edit,,1,0,1,6e-06,31
en.wikipedia.org/w/index.php?title=Kanpur_Lucknow_Roadways_Service&action=history,,1,0,1,6e-06,31
en.wikipedia.org/wiki/Special:WhatLinksHere/Kanpur_Lucknow_Roadways_Service,,1,0,1,6e-06,31
en.wikipedia.org/wiki/Special:RecentChangesLinked/Kanpur_Lucknow_Roadways_Service,,1,0,1,6e-06,31
en.wikipedia.org/w/index.php?title=Kanpur_Lucknow_Roadways_Service&oldid=1277306393,,1,0,1,6e-06,31
en.wikipedia.org/w/index.php?title=Kanpur_Lucknow_Roadways_Service&action=info,,1,0,1,6e-06,31
en.wikipedia.org/w/index.php?title=Kanpur_Lucknow_Roadways_Service&printable=yes,,1,0,1,6e-06,31
en.wikipedia.org/wiki/File:UPSRTC_Logo.jpg,,1,0,1,6e-06,31
en.wikipedia.org/w/index.php?title=Kanpur_Lucknow_Roadways_Service&action=edit&section=1,,1,0,1,6e-06,31
en.wikipedia.org/w/index.php?title=Kanpur_Lucknow_Roadways_Service&action=edit&section=2,,1,0,1,6e-06,31
en.wikipedia.org/w/index.php?title=Kanpur_Lucknow_Roadways_Service&action=edit&section=3,,1,0,1,6e-06,31
en.wikipedia.org/wiki/Lucknow_Upnagariya_Parivahan_Sewa,,1,0,1,6e-06,31
en.wikipedia.org/wiki/Faizabad_Bus_Depot,,1,0,1,6e-06,31
en.wikipedia.org/w/index.php?title=Kanpur_Lucknow_Roadways_Service&action=edit&section=4,,1,0,1,6e-06,31
upsrtc.com/online/query/service_query.asp,,1,0,1,6e-06,31
en.wikipedia.org/wiki/Category:Bus_companies_of_India,,1,0,1,6e-06,31
en.wikipedia.org/wiki/Category:State_road_transport_corporations_of_India,,1,0,1,6e-06,31
en.wikipedia.org/wiki/Category:Pages_using_infobox_bus_company_with_unknown_parameters,,1,0,1,6e-06,31
en.m.wikipedia.org/w/index.php?title=Kanpur_Lucknow_Roadways_Service&mobileaction=toggle_view_mobile,,1,0,1,6e-06,31
upload.wikimedia.org/wikipedia/commons/thumb/6/66/UPSRTC_Logo.jpg/250px-UPSRTC_Logo.jpg,,1,0,1,6e-06,31
en.wikipedia.org/w/index.php?title=Special:CreateAccount&returnto=Kanpur+Dehat+district,,1,0,1,6e-06,31
en.wikipedia.org/w/index.php?title=Special:UserLogin&returnto=Kanpur+Dehat+district,,1,0,1,6e-06,31
ar.wikipedia.org/wiki/راماباي_نجار,,1,0,1,6e-06,31
bn.wikipedia.org/wiki/কানপুর_দেহাত_জেলা,,1,0,1,6e-06,31
zh-min-nan.wikipedia.org/wiki/Kanpur_Dehat,,1,0,1,6e-06,31
bh.wikipedia.org/wiki/कानपुर_देहात_जिला,,1,0,1,6e-06,31
ca.wikipedia.org/wiki/Districte_de_Kanpur_Dehat,,1,0,1,6e-06,31
ceb.wikipedia.org/wiki/Kanpur_Dehat,,1,0,1,6e-06,31
da.wikipedia.org/wiki/Kanpur_Dehat_(distrikt),,1,0,1,6e-06,31
de.wikipedia.org/wiki/Kanpur_Dehat,,1,0,1,6e-06,31
es.wikipedia.org/wiki/Distrito_de_Kanpur_Dehat,,1,0,1,6e-06,31
eu.wikipedia.org/wiki/Kanpur_Dehat_barrutia,,1,0,1,6e-06,31
fa.wikipedia.org/wiki/بخش_کانپور_دیهات,,1,0,1,6e-06,31
fr.wikipedia.org/wiki/District_de_Kanpur_Dehat,,1,0,1,6e-06,31
gu.wikipedia.org/wiki/કાનપુર_દેહાત_જિલ્લો,,1,0,1,6e-06,31
hi.wikipedia.org/wiki/कानपुर_देहात_जिला,,1,0,1,6e-06,31
it.wikipedia.org/wiki/Distretto_di_Kanpur_Dehat,,1,0,1,6e-06,31
mr.wikipedia.org/wiki/कानपूर_देहात_जिल्हा,,1,0,1,6e-06,31
arz.wikipedia.org/wiki/راماباى_نجار,,1,0,1,6e-06,31
nl.wikipedia.org/wiki/Kanpur_Dehat,,1,0,1,6e-06,31
ne.wikipedia.org/wiki/कानपुर_देहात_जिल्ला,,1,0,1,6e-06,31
new.wikipedia.org/wiki/कानपुर_देहात_जिल्ला,,1,0,1,6e-06,31
no.wikipedia.org/wiki/Ramabai_Nagar_(distrikt),,1,0,1,6e-06,31
pl.wikipedia.org/wiki/Ramabai_Nagar_(dystrykt),,1,0,1,6e-06,31
ru.wikipedia.org/wiki/Рамабайнагар,,1,0,1,6e-06,31
sa.wikipedia.org/wiki/कानपुरदेहातमण्डलम्,,1,0,1,6e-06,31
sat.wikipedia.org/wiki/ᱠᱟᱱᱯᱩᱨ_ᱫᱮᱦᱟᱛ_ᱦᱚᱱᱚᱛ,,1,0,1,6e-06,31
sv.wikipedia.org/wiki/Kanpur_Dehat,,1,0,1,6e-06,31
ta.wikipedia.org/wiki/இராமாபாய்_நகர்_மாவட்டம்,,1,0,1,6e-06,31
te.wikipedia.org/wiki/కాన్పూర్_దేహత్_జిల్లా,,1,0,1,6e-06,31
ur.wikipedia.org/wiki/ضلع_کانپور_دیہات,,1,0,1,6e-06,31
vi.wikipedia.org/wiki/Kanpur_Dehat_(huyện),,1,0,1,6e-06,31
zh.wikipedia.org/wiki/坎普爾郊縣,,1,0,1,6e-06,31
wikidata.org/wiki/Special:EntityPage/Q610612,,1,0,1,6e-06,31
en.wikipedia.org/wiki/Talk:Kanpur_Dehat_district,,1,0,1,6e-06,31
en.wikipedia.org/w/index.php?title=Kanpur_Dehat_district&action=edit,,1,0,1,6e-06,31
en.wikipedia.org/w/index.php?title=Kanpur_Dehat_district&action=history,,1,0,1,6e-06,31
en.wikipedia.org/wiki/Special:WhatLinksHere/Kanpur_Dehat_district,,1,0,1,6e-06,31
en.wikipedia.org/wiki/Special:RecentChangesLinked/Kanpur_Dehat_district,,1,0,1,6e-06,31
en.wikipedia.org/w/index.php?title=Kanpur_Dehat_district&oldid=1298896862,,1,0,1,6e-06,31
en.wikipedia.org/w/index.php?title=Kanpur_Dehat_district&action=info,,1,0,1,6e-06,31
en.wikipedia.org/w/index.php?title=Kanpur_Dehat_district&printable=yes,,1,0,1,6e-06,31
commons.wikimedia.org/wiki/Category:Kanpur_Dehat_district,,1,0,1,6e-06,31
en.wikipedia.org/wiki/File:Akbarpur_kanpur_dehat_temple_and_places_5.jpg,,1,0,1,6e-06,31
en.wikipedia.org/wiki/File:Dharma_Garh_Temple_Rasulabad.jpg,,1,0,1,6e-06,31
en.wikipedia.org/wiki/File:Parhul_Devi_Temple_(west_view).jpg,,1,0,1,6e-06,31
en.wikipedia.org/wiki/File:Rind_River.JPG,,1,0,1,6e-06,31
"en.wikipedia.org/wiki/Rasulabad,_Kanpur_Dehat",,1,0,1,6e-06,31
en.wikipedia.org/wiki/Parhul_Devi_Temple,,1,0,1,6e-06,31
en.wikipedia.org/wiki/File:India_Uttar_Pradesh_districts_2012_Kanpur_Dehat.svg,,1,0,1,6e-06,31
en.wikipedia.org/w/index.php?title=Kanpur_Dehat_district&action=edit&section=1,,1,0,1,6e-06,31
en.wikipedia.org/wiki/Zamindars,,1,0,1,6e-06,31
en.wikipedia.org/wiki/Sachan,,1,0,1,6e-06,31
en.wikipedia.org/wiki/Nana_Saheb,,1,0,1,6e-06,31
en.wikipedia.org/w/index.php?title=1857_Revolt&action=edit&redlink=1,,1,0,1,6e-06,31
en.wikipedia.org/w/index.php?title=Zamindaries&action=edit&redlink=1,,1,0,1,6e-06,31
en.wikipedia.org/w/index.php?title=Kanpur_Dehat_district&action=edit&section=2,,1,0,1,6e-06,31
en.wikipedia.org/w/index.php?title=Kanpur_Dehat_district&action=edit&section=3,,1,0,1,6e-06,31
en.wikipedia.org/w/index.php?title=Kanpur_Dehat_district&action=edit&section=4,,1,0,1,6e-06,31
en.wikipedia.org/w/index.php?title=Sarvankheda&action=edit&redlink=1,,1,0,1,6e-06,31
en.wikipedia.org/wiki/Sandalpur,,1,0,1,6e-06,31
"en.wikipedia.org/wiki/Rajpur,_Ramabai_Nagar",,1,0,1,6e-06,31
en.wikipedia.org/w/index.php?title=Kanpur_Dehat_district&action=edit&section=5,,1,0,1,6e-06,31
en.wikipedia.org/w/index.php?title=Kanpur_Dehat_district&action=edit&section=6,,1,0,1,6e-06,31
en.wikipedia.org/wiki/Arun_Pathak_(politician),,1,0,1,6e-06,31
en.wikipedia.org/w/index.php?title=Kanpur_Dehat_district&action=edit&section=7,,1,0,1,6e-06,31
en.wikipedia.org/w/index.php?title=Kanpur_Dehat_district&action=edit&section=8,,1,0,1,6e-06,31
en.wikipedia.org/wiki/Samajwadi_party,,1,0,1,6e-06,31
en.wikipedia.org/wiki/Narayan_Das_Ahirwar,,1,0,1,6e-06,31
en.wikipedia.org/w/index.php?title=Kanpur_Dehat_district&action=edit&section=9,,1,0,1,6e-06,31
en.wikipedia.org/wiki/Train_electrification,,1,0,1,6e-06,31
"en.wikipedia.org/wiki/Bhaupur,_Kanpur",,1,0,1,6e-06,31
en.wikipedia.org/wiki/Roshan_Mau,,1,0,1,6e-06,31
en.wikipedia.org/wiki/Parjani,,1,0,1,6e-06,31
en.wikipedia.org/wiki/Binaur,,1,0,1,6e-06,31
en.wikipedia.org/wiki/Rasulpur_Gogumau,,1,0,1,6e-06,31
"en.wikipedia.org/wiki/Lalpur,_Kanpur_Dehat_district",,1,0,1,6e-06,31
en.wikipedia.org/w/index.php?title=Kanpur_Dehat_district&action=edit&section=10,,1,0,1,6e-06,31
en.wikipedia.org/w/index.php?title=Kanpur_Dehat_district&action=edit&section=11,,1,0,1,6e-06,31
en.wikipedia.org/w/index.php?title=Kanpur_Dehat_district&action=edit&section=12,,1,0,1,6e-06,31
en.wikipedia.org/wiki/File:Waneshwar_Mahadev_Mandir.JPG,,1,0,1,6e-06,31
en.wikipedia.org/wiki/Waneshwar_Mahadev_Temple,,1,0,1,6e-06,31
en.wikipedia.org/wiki/Musanagar,,1,0,1,6e-06,31
en.wikipedia.org/wiki/Lohari,,1,0,1,6e-06,31
en.wikipedia.org/w/index.php?title=Kanpur_Dehat_district&action=edit&section=13,,1,0,1,6e-06,31
en.wikipedia.org/w/index.php?title=Arahriyamau&action=edit&redlink=1,,1,0,1,6e-06,31
en.wikipedia.org/w/index.php?title=Kanpur_Dehat_district&action=edit&section=14,,1,0,1,6e-06,31
en.wikipedia.org/wiki/RSGU_Post_Graduate_College_Pukhrayan,,1,0,1,6e-06,31
en.wikipedia.org/wiki/R_P_S_Inter_College,,1,0,1,6e-06,31
"en.wikipedia.org/wiki/Kendriya_Vidyalaya,_Mati",,1,0,1,6e-06,31
en.wikipedia.org/wiki/Jawahar_Navodaya_Vidyalaya_Kanpur_Dehat,,1,0,1,6e-06,31
en.wikipedia.org/wiki/Shri_Ram_Janki_Sanskrit_Mahavidyalaya,,1,0,1,6e-06,31
en.wikipedia.org/wiki/Pt.Triyugi_Narayan_Mahavidyalaya,,1,0,1,6e-06,31
en.wikipedia.org/w/index.php?title=Kanpur_Dehat_district&action=edit&section=15,,1,0,1,6e-06,31
en.wikipedia.org/wiki/Nebraska,,1,0,1,6e-06,31
en.wikipedia.org/w/index.php?title=Kanpur_Dehat_district&action=edit&section=16,,1,0,1,6e-06,31
en.wikipedia.org/wiki/Mughal_Road,,1,0,1,6e-06,31
en.wikipedia.org/w/index.php?title=Kanpur_Dehat_district&action=edit&section=17,,1,0,1,6e-06,31
en.wikipedia.org/w/index.php?title=Banda_division&action=edit&redlink=1,,1,0,1,6e-06,31
en.wikipedia.org/w/index.php?title=Kanpur_Dehat_district&action=edit&section=18,,1,0,1,6e-06,31
jagran.com/uttar-pradesh/lucknow-city-bjps-arun-pathak-won-kanpurunnao-mlc-seat-12009112.html,,1,0,1,6e-06,31
myneta.info/uttarpradesh2017/candidate.php?candidate_id=2669,,1,0,1,6e-06,31
myneta.info/uttarpradesh2017/candidate.php?candidate_id=2697,,1,0,1,6e-06,31
myneta.info/uttarpradesh2017/candidate.php?candidate_id=2682,,1,0,1,6e-06,31
myneta.info/uttarpradesh2017/candidate.php?candidate_id=2662,,1,0,1,6e-06,31
164.100.47.194/Loksabha/Members/AlphabeticalList.aspx,,1,0,1,6e-06,31
indiatoday.intoday.in/story/ram-nath-kovind-elected-india-14th-president/1/1006696.html,,1,0,1,6e-06,31
web.archive.org/web/20161012181412/http://www.ufhnews.in/kanpur-dehat-7489-a,,1,0,1,6e-06,31
ufhnews.in/kanpur-dehat-7489-a,,1,0,1,6e-06,31
hindi.eenaduindia.com/State/UttarPradesh/2015/03/25223153/kanpur-to-abroad-has-gone-soon.vpf,,1,0,1,6e-06,31
wikidata.org/wiki/Q610612,,1,0,1,6e-06,31
viaf.org/viaf/244358185,,1,0,1,6e-06,31
en.wikipedia.org/wiki/Category:1981_establishments_in_Uttar_Pradesh,,1,0,1,6e-06,31
en.m.wikipedia.org/w/index.php?title=Kanpur_Dehat_district&mobileaction=toggle_view_mobile,,1,0,1,6e-06,31
upload.wikimedia.org/wikipedia/commons/thumb/9/99/Rind_River.JPG/250px-Rind_River.JPG,,1,0,1,6e-06,31
en.wikipedia.org/w/index.php?title=Special:CreateAccount&returnto=Kanpur+Monorail,,1,0,1,6e-06,31
en.wikipedia.org/w/index.php?title=Special:UserLogin&returnto=Kanpur+Monorail,,1,0,1,6e-06,31
wikidata.org/wiki/Special:EntityPage/Q6364376,,1,0,1,6e-06,31
en.wikipedia.org/wiki/Talk:Kanpur_Monorail,,1,0,1,6e-06,31
en.wikipedia.org/w/index.php?title=Kanpur_Monorail&action=edit,,1,0,1,6e-06,31
en.wikipedia.org/w/index.php?title=Kanpur_Monorail&action=history,,1,0,1,6e-06,31
en.wikipedia.org/wiki/Special:WhatLinksHere/Kanpur_Monorail,,1,0,1,6e-06,31
en.wikipedia.org/wiki/Special:RecentChangesLinked/Kanpur_Monorail,,1,0,1,6e-06,31
en.wikipedia.org/w/index.php?title=Kanpur_Monorail&oldid=1304675338,,1,0,1,6e-06,31
en.wikipedia.org/w/index.php?title=Kanpur_Monorail&action=info,,1,0,1,6e-06,31
en.wikipedia.org/w/index.php?title=Kanpur_Monorail&printable=yes,,1,0,1,6e-06,31
en.wikipedia.org/w/index.php?title=Kanpur_Monorail&action=edit&section=1,,1,0,1,6e-06,31
en.wikipedia.org/w/index.php?title=Kanpur_Monorail&action=edit&section=2,,1,0,1,6e-06,31
en.wikipedia.org/w/index.php?title=Kanpur_Monorail&action=edit&section=3,,1,0,1,6e-06,31
en.wikipedia.org/w/index.php?title=Kanpur_Monorail&action=edit&section=4,,1,0,1,6e-06,31
web.archive.org/web/20100613055508/http://monorails.org/tMspages/News.html,,1,0,1,6e-06,31
monorails.org/tmspages/News.html,,1,0,1,6e-06,31
niua.org/projects/tpt/introduction.pdf,,1,0,1,6e-06,31
web.archive.org/web/20120514113738/http://niua.org/projects/tpt/INTRODUCTION.pdf,,1,0,1,6e-06,31
beta.thehindu.com/news/cities/Kanpur/article87665.ece,,1,0,1,6e-06,31
timesofindia.indiatimes.com/Monorail_to_hit_Kanpur_streets_by_2010/rssarticleshow/2802311.cms,,1,0,1,6e-06,31
en.wikipedia.org/wiki/Template:India-rail-transport-stub,,1,0,1,6e-06,31
en.wikipedia.org/wiki/Template_talk:India-rail-transport-stub,,1,0,1,6e-06,31
en.wikipedia.org/wiki/Special:EditPage/Template:India-rail-transport-stub,,1,0,1,6e-06,31
en.wikipedia.org/wiki/File:Aiga_railtransportation_25.svg,,1,0,1,6e-06,31
en.wikipedia.org/wiki/Template:Asia-metro-stub,,1,0,1,6e-06,31
en.wikipedia.org/wiki/Template_talk:Asia-metro-stub,,1,0,1,6e-06,31
en.wikipedia.org/wiki/Special:EditPage/Template:Asia-metro-stub,,1,0,1,6e-06,31
en.wikipedia.org/wiki/Category:Proposed_monorails_in_India,,1,0,1,6e-06,31
en.wikipedia.org/wiki/Category:India_rail_transport_stubs,,1,0,1,6e-06,31
en.wikipedia.org/wiki/Category:Asian_rapid_transit_stubs,,1,0,1,6e-06,31
en.m.wikipedia.org/w/index.php?title=Kanpur_Monorail&mobileaction=toggle_view_mobile,,1,0,1,6e-06,31
en.wikipedia.org/w/index.php?title=Special:CreateAccount&returnto=Kanpur+Cantonment,,1,0,1,6e-06,31
en.wikipedia.org/w/index.php?title=Special:UserLogin&returnto=Kanpur+Cantonment,,1,0,1,6e-06,31
bh.wikipedia.org/wiki/कानपुर_छावनी,,1,0,1,6e-06,31
es.wikipedia.org/wiki/Kanpur_Cantonment,,1,0,1,6e-06,31
hi.wikipedia.org/wiki/कानपुर_छावनी,,1,0,1,6e-06,31
sv.wikipedia.org/wiki/Kanpur_(Cantonment),,1,0,1,6e-06,31
ur.wikipedia.org/wiki/کانپور_چھاؤنی,,1,0,1,6e-06,31
wikidata.org/wiki/Special:EntityPage/Q6364351,,1,0,1,6e-06,31
en.wikipedia.org/wiki/Talk:Kanpur_Cantonment,,1,0,1,6e-06,31
en.wikipedia.org/w/index.php?title=Kanpur_Cantonment&action=edit,,1,0,1,6e-06,31
en.wikipedia.org/w/index.php?title=Kanpur_Cantonment&action=history,,1,0,1,6e-06,31
en.wikipedia.org/wiki/Special:WhatLinksHere/Kanpur_Cantonment,,1,0,1,6e-06,31
en.wikipedia.org/wiki/Special:RecentChangesLinked/Kanpur_Cantonment,,1,0,1,6e-06,31
en.wikipedia.org/w/index.php?title=Kanpur_Cantonment&oldid=1306088337,,1,0,1,6e-06,31
en.wikipedia.org/w/index.php?title=Kanpur_Cantonment&action=info,,1,0,1,6e-06,31
en.wikipedia.org/w/index.php?title=Kanpur_Cantonment&printable=yes,,1,0,1,6e-06,31
"google.com/search?as_eq=wikipedia&q=""Kanpur+Cantonment""",,1,0,1,6e-06,31
"google.com/search?tbm=nws&q=""Kanpur+Cantonment""+-wikipedia&tbs=ar:1",,1,0,1,6e-06,31
"google.com/search?&q=""Kanpur+Cantonment""&tbs=bkt:s&tbm=bks",,1,0,1,6e-06,31
"google.com/search?tbs=bks:1&q=""Kanpur+Cantonment""+-wikipedia",,1,0,1,6e-06,31
"scholar.google.com/scholar?q=""Kanpur+Cantonment""",,1,0,1,6e-06,31
"jstor.org/action/doBasicSearch?Query=""Kanpur+Cantonment""&acc=on&wc=on",,1,0,1,6e-06,31
kanpur.cantt.gov.in/,,1,0,1,6e-06,31
en.wikipedia.org/w/index.php?title=Kanpur_Cantonment&action=edit&section=1,,1,0,1,6e-06,31
en.wikipedia.org/w/index.php?title=Kanpur_Cantonment&action=edit&section=2,,1,0,1,6e-06,31
en.wikipedia.org/w/index.php?title=Kanpur_Cantonment&action=edit&section=3,,1,0,1,6e-06,31
en.wikipedia.org/w/index.php?title=Kanpur_Cantonment&action=edit&section=4,,1,0,1,6e-06,31
en.wikipedia.org/w/index.php?title=Kanpur_Cantonment&action=edit&section=5,,1,0,1,6e-06,31
en.wikipedia.org/w/index.php?title=Kanpur_Cantonment&action=edit&section=6,,1,0,1,6e-06,31
en.wikipedia.org/w/index.php?title=Kanpur_Cantonment&action=edit&section=7,,1,0,1,6e-06,31
en.wikipedia.org/wiki/Golf_Club,,1,0,1,6e-06,31
en.wikipedia.org/w/index.php?title=Kanpur_Cantonment&action=edit&section=8,,1,0,1,6e-06,31
en.wikipedia.org/w/index.php?title=Kanpur_Cantonment&action=edit&section=9,,1,0,1,6e-06,31
en.wikipedia.org/w/index.php?title=Kanpur_Cantonment&action=edit&section=10,,1,0,1,6e-06,31
en.wikipedia.org/w/index.php?title=Kanpur_Cantonment&action=edit&section=11,,1,0,1,6e-06,31
en.wikipedia.org/w/index.php?title=Kanpur_Cantonment&action=edit&section=12,,1,0,1,6e-06,31
en.wikipedia.org/w/index.php?title=Kanpur_Cantonment&action=edit&section=13,,1,0,1,6e-06,31
en.wikipedia.org/w/index.php?title=Kanpur_Cantonment&action=edit&section=14,,1,0,1,6e-06,31
cbkanpur.org.in/,,1,0,1,6e-06,31
census2011.co.in/census/city/132-kanpur-cantonment.html/,,1,0,1,6e-06,31
en.wikipedia.org/wiki/Category:Cantonments_of_India,,1,0,1,6e-06,31
en.wikipedia.org/wiki/Category:Cantonments_of_British_India,,1,0,1,6e-06,31
en.wikipedia.org/wiki/Category:1778_establishments_in_India,,1,0,1,6e-06,31
en.wikipedia.org/wiki/Category:Cantonment_towns_in_Uttar_Pradesh,,1,0,1,6e-06,31
en.wikipedia.org/wiki/Category:Military_installations_established_in_1811,,1,0,1,6e-06,31
en.wikipedia.org/wiki/Category:Articles_needing_additional_references_from_February_2012,,1,0,1,6e-06,31
en.m.wikipedia.org/w/index.php?title=Kanpur_Cantonment&mobileaction=toggle_view_mobile,,1,0,1,6e-06,31
en.wikipedia.org/w/index.php?title=Special:CreateAccount&returnto=Kanpur+Anwarganj+railway+station,,1,0,1,6e-06,31
en.wikipedia.org/w/index.php?title=Special:UserLogin&returnto=Kanpur+Anwarganj+railway+station,,1,0,1,6e-06,31
hi.wikipedia.org/wiki/कानपुर_अनवरगंज_रेलवे_स्टेशन,,1,0,1,6e-06,31
wikidata.org/wiki/Special:EntityPage/Q13640954,,1,0,1,6e-06,31
en.wikipedia.org/wiki/Talk:Kanpur_Anwarganj_railway_station,,1,0,1,6e-06,31
en.wikipedia.org/w/index.php?title=Kanpur_Anwarganj_railway_station&action=edit,,1,0,1,6e-06,31
en.wikipedia.org/w/index.php?title=Kanpur_Anwarganj_railway_station&action=history,,1,0,1,6e-06,31
en.wikipedia.org/wiki/Special:WhatLinksHere/Kanpur_Anwarganj_railway_station,,1,0,1,6e-06,31
en.wikipedia.org/wiki/Special:RecentChangesLinked/Kanpur_Anwarganj_railway_station,,1,0,1,6e-06,31
en.wikipedia.org/w/index.php?title=Kanpur_Anwarganj_railway_station&oldid=1283226596,,1,0,1,6e-06,31
en.wikipedia.org/w/index.php?title=Kanpur_Anwarganj_railway_station&action=info,,1,0,1,6e-06,31
en.wikipedia.org/w/index.php?title=Kanpur_Anwarganj_railway_station&printable=yes,,1,0,1,6e-06,31
en.wikipedia.org/wiki/File:Kanpur_Anwarganj_Railway_Station_building.jpg,,1,0,1,6e-06,31
en.wikipedia.org/w/index.php?title=Indian_Branch_Rly._Co.&action=edit&redlink=1,,1,0,1,6e-06,31
en.wikipedia.org/wiki/Special:Map/13/26.455402/80.328925/en,,1,0,1,6e-06,31
en.wikipedia.org/w/index.php?title=Kanpur_Anwarganj_railway_station&action=edit&section=1,,1,0,1,6e-06,31
en.wikipedia.org/wiki/Railway_platform,,1,0,1,6e-06,31
en.wikipedia.org/wiki/Metre-gauge,,1,0,1,6e-06,31
en.wikipedia.org/wiki/Lalu_Prasad_Yadav,,1,0,1,6e-06,31
en.wikipedia.org/wiki/Broad-gauge_railway,,1,0,1,6e-06,31
en.wikipedia.org/w/index.php?title=Kanpur_Anwarganj_railway_station&action=edit&section=2,,1,0,1,6e-06,31
en.wikipedia.org/w/index.php?title=Kanpur_Anwarganj_railway_station&action=edit&section=3,,1,0,1,6e-06,31
en.wikipedia.org/wiki/Chauri_Chaura_Express,,1,0,1,6e-06,31
en.wikipedia.org/wiki/Utsarg_Express,,1,0,1,6e-06,31
en.wikipedia.org/w/index.php?title=Kanpur_Anwarganj_railway_station&action=edit&section=4,,1,0,1,6e-06,31
en.wikipedia.org/w/index.php?title=Kanpur_Anwarganj_railway_station&action=edit&section=5,,1,0,1,6e-06,31
goibibo.com/trains/kanpur-anwarganj-railway-station-cpa/,,1,0,1,6e-06,31
en.wikipedia.org/w/index.php?title=Kanpur_Anwarganj_railway_station&action=edit&section=6,,1,0,1,6e-06,31
en.wikipedia.org/wiki/Category:Railway_stations_in_India_opened_in_1896,,1,0,1,6e-06,31
en.wikipedia.org/wiki/Category:Articles_with_unsourced_statements_from_April_2012,,1,0,1,6e-06,31
en.wikipedia.org/w/index.php?title=Special:CreateAccount&returnto=Kanpur+Lok+Sabha+constituency,,1,0,1,6e-06,31
en.wikipedia.org/w/index.php?title=Special:UserLogin&returnto=Kanpur+Lok+Sabha+constituency,,1,0,1,6e-06,31
bn.wikipedia.org/wiki/কানপুর_লোকসভা_কেন্দ্র,,1,0,1,6e-06,31
hi.wikipedia.org/wiki/कानपुर_लोक_सभा_निर्वाचन_क्षेत्र,,1,0,1,6e-06,31
mai.wikipedia.org/wiki/कानपुर_लोक_सभा_निर्वाचन_क्षेत्र,,1,0,1,6e-06,31
mr.wikipedia.org/wiki/कानपूर_लोकसभा_मतदारसंघ,,1,0,1,6e-06,31
pa.wikipedia.org/wiki/ਕਾਨਪੁਰ_ਲੋਕ_ਸਭਾ_ਹਲਕਾ,,1,0,1,6e-06,31
ta.wikipedia.org/wiki/கான்பூர்_மக்களவைத்_தொகுதி,,1,0,1,6e-06,31
te.wikipedia.org/wiki/కాన్పూర్_లోక్‌సభ_నియోజకవర్గం,,1,0,1,6e-06,31
wikidata.org/wiki/Special:EntityPage/Q11032972,,1,0,1,6e-06,31
en.wikipedia.org/wiki/Talk:Kanpur_Lok_Sabha_constituency,,1,0,1,6e-06,31
en.wikipedia.org/w/index.php?title=Kanpur_Lok_Sabha_constituency&action=edit,,1,0,1,6e-06,31
en.wikipedia.org/w/index.php?title=Kanpur_Lok_Sabha_constituency&action=history,,1,0,1,6e-06,31
en.wikipedia.org/wiki/Special:WhatLinksHere/Kanpur_Lok_Sabha_constituency,,1,0,1,6e-06,31
en.wikipedia.org/wiki/Special:RecentChangesLinked/Kanpur_Lok_Sabha_constituency,,1,0,1,6e-06,31
en.wikipedia.org/w/index.php?title=Kanpur_Lok_Sabha_constituency&oldid=1295438119,,1,0,1,6e-06,31
en.wikipedia.org/w/index.php?title=Kanpur_Lok_Sabha_constituency&action=info,,1,0,1,6e-06,31
en.wikipedia.org/w/index.php?title=Kanpur_Lok_Sabha_constituency&printable=yes,,1,0,1,6e-06,31
geohack.toolforge.org/geohack.php?pagename=Kanpur_Lok_Sabha_constituency&params=26.46_N_80.32_E_,,1,0,1,6e-06,31
en.wikipedia.org/w/index.php?title=Kanpur_Lok_Sabha_constituency&action=edit&section=1,,1,0,1,6e-06,31
en.wikipedia.org/w/index.php?title=Kanpur_Lok_Sabha_constituency&action=edit&section=2,,1,0,1,6e-06,31
en.wikipedia.org/wiki/Harihar_Nath_Shastri,,1,0,1,6e-06,31
en.wikipedia.org/wiki/Shiv_Narayan_Tandon,,1,0,1,6e-06,31
en.wikipedia.org/wiki/S._M._Banerjee,,1,0,1,6e-06,31
en.wikipedia.org/wiki/Arif_Mohammed_Khan,,1,0,1,6e-06,31
en.wikipedia.org/wiki/Jagat_Vir_Singh_Drona,,1,0,1,6e-06,31
en.wikipedia.org/wiki/Ramesh_Awasthi,,1,0,1,6e-06,31
en.wikipedia.org/w/index.php?title=Kanpur_Lok_Sabha_constituency&action=edit&section=3,,1,0,1,6e-06,31
en.wikipedia.org/w/index.php?title=Kanpur_Lok_Sabha_constituency&action=edit&section=4,,1,0,1,6e-06,31
en.wikipedia.org/w/index.php?title=Kanpur_Lok_Sabha_constituency&action=edit&section=5,,1,0,1,6e-06,31
en.wikipedia.org/wiki/Ram_Kumar_(politician),,1,0,1,6e-06,31
en.wikipedia.org/w/index.php?title=Bhartiya_Shakti_Chetna_Party&action=edit&redlink=1,,1,0,1,6e-06,31
en.wikipedia.org/w/index.php?title=Kanpur_Lok_Sabha_constituency&action=edit&section=6,,1,0,1,6e-06,31
en.wikipedia.org/wiki/Dr._Murli_Manohar_Joshi,,1,0,1,6e-06,31
en.wikipedia.org/w/index.php?title=Kanpur_Lok_Sabha_constituency&action=edit&section=7,,1,0,1,6e-06,31
en.wikipedia.org/w/index.php?title=Kanpur_Lok_Sabha_constituency&action=edit&section=8,,1,0,1,6e-06,31
en.wikipedia.org/wiki/Shriprakash_Jaiswal,,1,0,1,6e-06,31
en.wikipedia.org/w/index.php?title=Kanpur_Lok_Sabha_constituency&action=edit&section=9,,1,0,1,6e-06,31
en.wikipedia.org/w/index.php?title=Kanpur_Lok_Sabha_constituency&action=edit&section=10,,1,0,1,6e-06,31
en.wikipedia.org/w/index.php?title=Kanpur_Lok_Sabha_constituency&action=edit&section=11,,1,0,1,6e-06,31
en.wikipedia.org/wiki/Sharfuddin_Ahmad,,1,0,1,6e-06,31
en.wikipedia.org/w/index.php?title=Kanpur_Lok_Sabha_constituency&action=edit&section=12,,1,0,1,6e-06,31
en.wikipedia.org/w/index.php?title=Kanpur_Lok_Sabha_constituency&action=edit&section=13,,1,0,1,6e-06,31
en.wikipedia.org/w/index.php?title=Kanpur_Lok_Sabha_constituency&action=edit&section=14,,1,0,1,6e-06,31
en.wikipedia.org/wiki/Syed_Shahabuddin,,1,0,1,6e-06,31
en.wikipedia.org/w/index.php?title=Kanpur_Lok_Sabha_constituency&action=edit&section=15,,1,0,1,6e-06,31
en.wikipedia.org/wiki/Arif_Mohammad_Khan,,1,0,1,6e-06,31
en.wikipedia.org/w/index.php?title=Kanpur_Lok_Sabha_constituency&action=edit&section=16,,1,0,1,6e-06,31
en.wikipedia.org/wiki/S.M._Banerjee,,1,0,1,6e-06,31
en.wikipedia.org/w/index.php?title=Kanpur_Lok_Sabha_constituency&action=edit&section=17,,1,0,1,6e-06,31
en.wikipedia.org/wiki/Bharatiya_Jana_Sangh,,1,0,1,6e-06,31
en.wikipedia.org/w/index.php?title=Kanpur_Lok_Sabha_constituency&action=edit&section=18,,1,0,1,6e-06,31
en.wikipedia.org/w/index.php?title=Kanpur_Lok_Sabha_constituency&action=edit&section=19,,1,0,1,6e-06,31
en.wikipedia.org/w/index.php?title=Kanpur_Lok_Sabha_constituency&action=edit&section=20,,1,0,1,6e-06,31
en.wikipedia.org/w/index.php?title=Kanpur_Lok_Sabha_constituency&action=edit&section=21,,1,0,1,6e-06,31
en.wikipedia.org/w/index.php?title=Kanpur_Lok_Sabha_constituency&action=edit&section=22,,1,0,1,6e-06,31
en.wikipedia.org/w/index.php?title=Kanpur_Lok_Sabha_constituency&action=edit&section=23,,1,0,1,6e-06,31
en.wikipedia.org/wiki/1952_Indian_general_election,,1,0,1,6e-06,31
en.wikipedia.org/wiki/Kisan_Mazdoor_Praja_Party,,1,0,1,6e-06,31
en.wikipedia.org/w/index.php?title=Kanpur_Lok_Sabha_constituency&action=edit&section=24,,1,0,1,6e-06,31
en.wikipedia.org/w/index.php?title=Kanpur_Lok_Sabha_constituency&action=edit&section=25,,1,0,1,6e-06,31
en.wikipedia.org/w/index.php?title=Kanpur_Lok_Sabha_constituency&action=edit&section=26,,1,0,1,6e-06,31
news18.com/lok-sabha-elections-2019/uttar-pradesh/kanpur-election-result-s24p43/,,1,0,1,6e-06,31
elections.in/uttar-pradesh/parliamentary-constituencies/kanpur.html,,1,0,1,6e-06,31
results.eci.gov.in/PcResultGenJune2024/candidateswise-S2443.htm,,1,0,1,6e-06,31
timesofindia.indiatimes.com/elections/lok-sabha-constituencies/uttar-pradesh/kanpur,,1,0,1,6e-06,31
gyanmandi.com/loksabha-election/Uttar%20Pradesh/2019/Kanpur,,1,0,1,6e-06,31
gyanmandi.com/loksabha-election/Uttar%20Pradesh/2014/Kanpur,,1,0,1,6e-06,31
en.m.wikipedia.org/w/index.php?title=Kanpur_Lok_Sabha_constituency&mobileaction=toggle_view_mobile,,1,0,1,6e-06,31
en.wikipedia.org/w/index.php?title=Special:CreateAccount&returnto=Kannauj+district,,1,0,1,6e-06,31
en.wikipedia.org/w/index.php?title=Special:UserLogin&returnto=Kannauj+district,,1,0,1,6e-06,31
ar.wikipedia.org/wiki/منطقة_كانواج,,1,0,1,6e-06,31
bn.wikipedia.org/wiki/কনৌজ_জেলা,,1,0,1,6e-06,31
zh-min-nan.wikipedia.org/wiki/Kannauj_(koān),,1,0,1,6e-06,31
bh.wikipedia.org/wiki/कन्नौज_जिला,,1,0,1,6e-06,31
ceb.wikipedia.org/wiki/Kannauj_(distrito),,1,0,1,6e-06,31
da.wikipedia.org/wiki/Kannauj_(distrikt),,1,0,1,6e-06,31
de.wikipedia.org/wiki/Kannauj_(Distrikt),,1,0,1,6e-06,31
es.wikipedia.org/wiki/Distrito_de_Kannauj,,1,0,1,6e-06,31
eu.wikipedia.org/wiki/Kannauj_barrutia,,1,0,1,6e-06,31
fa.wikipedia.org/wiki/بخش_قنوج,,1,0,1,6e-06,31
fr.wikipedia.org/wiki/District_de_Kannauj,,1,0,1,6e-06,31
gu.wikipedia.org/wiki/કન્નોજ_જિલ્લો,,1,0,1,6e-06,31
hi.wikipedia.org/wiki/कन्नौज_जिला,,1,0,1,6e-06,31
it.wikipedia.org/wiki/Distretto_di_Kannauj,,1,0,1,6e-06,31
mr.wikipedia.org/wiki/कनौज_जिल्हा,,1,0,1,6e-06,31
arz.wikipedia.org/wiki/كانواج,,1,0,1,6e-06,31
nl.wikipedia.org/wiki/Kannauj_(district),,1,0,1,6e-06,31
ne.wikipedia.org/wiki/कन्नौज_जिल्ला,,1,0,1,6e-06,31
new.wikipedia.org/wiki/कन्नौज_जिल्ला,,1,0,1,6e-06,31
no.wikipedia.org/wiki/Kannauj_(distrikt),,1,0,1,6e-06,31
pa.wikipedia.org/wiki/ਕੰਨੌਜ_ਜਿਲ੍ਹਾ,,1,0,1,6e-06,31
pnb.wikipedia.org/wiki/ضلع_کنوج,,1,0,1,6e-06,31
pl.wikipedia.org/wiki/Kannauj_(dystrykt),,1,0,1,6e-06,31
ru.wikipedia.org/wiki/Каннаудж_(округ),,1,0,1,6e-06,31
sa.wikipedia.org/wiki/कन्नौजमण्डलम्,,1,0,1,6e-06,31
sat.wikipedia.org/wiki/ᱠᱟᱱᱱᱳᱡᱽ_ᱦᱚᱱᱚᱛ,,1,0,1,6e-06,31
simple.wikipedia.org/wiki/Kannauj_district,,1,0,1,6e-06,31
sv.wikipedia.org/wiki/Kannauj_(distrikt),,1,0,1,6e-06,31
ta.wikipedia.org/wiki/கன்னாஜ்_மாவட்டம்,,1,0,1,6e-06,31
te.wikipedia.org/wiki/కన్నౌజ్_జిల్లా,,1,0,1,6e-06,31
ur.wikipedia.org/wiki/قنوج_ضلع,,1,0,1,6e-06,31
vi.wikipedia.org/wiki/Kannauj_(huyện),,1,0,1,6e-06,31
zh.wikipedia.org/wiki/根瑙杰县,,1,0,1,6e-06,31
wikidata.org/wiki/Special:EntityPage/Q627979,,1,0,1,6e-06,31
en.wikipedia.org/wiki/Talk:Kannauj_district,,1,0,1,6e-06,31
en.wikipedia.org/w/index.php?title=Kannauj_district&action=edit,,1,0,1,6e-06,31
en.wikipedia.org/w/index.php?title=Kannauj_district&action=history,,1,0,1,6e-06,31
en.wikipedia.org/wiki/Special:WhatLinksHere/Kannauj_district,,1,0,1,6e-06,31
en.wikipedia.org/wiki/Special:RecentChangesLinked/Kannauj_district,,1,0,1,6e-06,31
en.wikipedia.org/w/index.php?title=Kannauj_district&oldid=1276487409,,1,0,1,6e-06,31
en.wikipedia.org/w/index.php?title=Kannauj_district&action=info,,1,0,1,6e-06,31
en.wikipedia.org/w/index.php?title=Kannauj_district&printable=yes,,1,0,1,6e-06,31
commons.wikimedia.org/wiki/Category:Kannauj_district,,1,0,1,6e-06,31
en.wikipedia.org/wiki/File:India_Uttar_Pradesh_districts_2012_Kannauj.svg,,1,0,1,6e-06,31
en.wikipedia.org/w/index.php?title=Kannauj_district&action=edit&section=1,,1,0,1,6e-06,31
geohack.toolforge.org/geohack.php?pagename=Kannauj_district&params=27.07_N_79.92_E_,,1,0,1,6e-06,31
en.wikipedia.org/wiki/Kanpur_Dehat_District,,1,0,1,6e-06,31
en.wikipedia.org/wiki/Mainpuri_District,,1,0,1,6e-06,31
en.wikipedia.org/w/index.php?title=Kannauj_district&action=edit&section=2,,1,0,1,6e-06,31
en.wikipedia.org/wiki/Guinea-Bissau,,1,0,1,6e-06,31
en.wikipedia.org/w/index.php?title=Kannauj_district&action=edit&section=3,,1,0,1,6e-06,31
en.wikipedia.org/w/index.php?title=Kannauj_district&action=edit&section=4,,1,0,1,6e-06,31
en.wikipedia.org/w/index.php?title=Kannauj_district&action=edit&section=5,,1,0,1,6e-06,31
en.wikipedia.org/w/index.php?title=Kannauj_district&action=edit&section=6,,1,0,1,6e-06,31
en.wikipedia.org/w/index.php?title=Kannauj_district&action=edit&section=7,,1,0,1,6e-06,31
en.wikipedia.org/w/index.php?title=Kannauj_district&action=edit&section=8,,1,0,1,6e-06,31
en.wikipedia.org/w/index.php?title=Kannauj_district&action=edit&section=9,,1,0,1,6e-06,31
censusindia.gov.in/nada/index.php/catalog/1234/download/3950/DH_2011_0929_PART_A_DCHB_KANNAUJ.pdf,,1,0,1,6e-06,31
censusindiamaps.net/page/India_WhizMap/IndiaMap.htm,,1,0,1,6e-06,31
web.archive.org/web/20100111052456/http://www.censusindiamaps.net/page/India_WhizMap/IndiaMap.htm,,1,0,1,6e-06,31
en.wikipedia.org/w/index.php?title=Kannauj_district&action=edit&section=10,,1,0,1,6e-06,31
wikidata.org/wiki/Q627979,,1,0,1,6e-06,31
viaf.org/viaf/158509848,,1,0,1,6e-06,31
id.loc.gov/authorities/n2009215599,,1,0,1,6e-06,31
musicbrainz.org/place/6a4a69b9-cc2d-4b19-bf83-4c41159dcd27,,1,0,1,6e-06,31
lux.collections.yale.edu/view/place/8c92ed3f-8cd5-4800-97de-c27c4d7f85dc,,1,0,1,6e-06,31
en.m.wikipedia.org/w/index.php?title=Kannauj_district&mobileaction=toggle_view_mobile,,1,0,1,6e-06,31
en.wikipedia.org/w/index.php?title=Special:CreateAccount&returnto=Kamla+Club+Ground,,1,0,1,6e-06,31
en.wikipedia.org/w/index.php?title=Special:UserLogin&returnto=Kamla+Club+Ground,,1,0,1,6e-06,31
ta.wikipedia.org/wiki/கம்லா_சங்க_விளையாட்டரங்கம்,,1,0,1,6e-06,31
wikidata.org/wiki/Special:EntityPage/Q23035598,,1,0,1,6e-06,31
en.wikipedia.org/wiki/Talk:Kamla_Club_Ground,,1,0,1,6e-06,31
en.wikipedia.org/w/index.php?title=Kamla_Club_Ground&action=edit,,1,0,1,6e-06,31
en.wikipedia.org/w/index.php?title=Kamla_Club_Ground&action=history,,1,0,1,6e-06,31
en.wikipedia.org/wiki/Special:WhatLinksHere/Kamla_Club_Ground,,1,0,1,6e-06,31
en.wikipedia.org/wiki/Special:RecentChangesLinked/Kamla_Club_Ground,,1,0,1,6e-06,31
en.wikipedia.org/w/index.php?title=Kamla_Club_Ground&oldid=1288415766,,1,0,1,6e-06,31
en.wikipedia.org/w/index.php?title=Kamla_Club_Ground&action=info,,1,0,1,6e-06,31
en.wikipedia.org/w/index.php?title=Kamla_Club_Ground&printable=yes,,1,0,1,6e-06,31
en.wikipedia.org/wiki/Template:Infobox_venue,,1,0,1,6e-06,31
espncricinfo.com/india/content/ground/58207.html,,1,0,1,6e-06,31
en.wikipedia.org/wiki/First-class_cricket,,1,0,1,6e-06,31
en.wikipedia.org/wiki/North_Zone_cricket_team,,1,0,1,6e-06,31
en.wikipedia.org/wiki/South_Zone_cricket_team,,1,0,1,6e-06,31
en.wikipedia.org/wiki/List_A,,1,0,1,6e-06,31
en.wikipedia.org/wiki/Railways_cricket_team,,1,0,1,6e-06,31
en.wikipedia.org/wiki/Madhya_Pradesh_cricket_team,,1,0,1,6e-06,31
en.wikipedia.org/w/index.php?title=Kamla_Club_Ground&action=edit&section=1,,1,0,1,6e-06,31
cricketarchive.com/Archive/Grounds/14/1076_f.html,,1,0,1,6e-06,31
cricketarchive.com/Archive/Scorecards/49/49300.html,,1,0,1,6e-06,31
cricketarchive.com/Archive/Scorecards/125/125451.html,,1,0,1,6e-06,31
cricketarchive.com/Archive/Grounds/14/1076_misc.html,,1,0,1,6e-06,31
web.archive.org/web/20150710024647/http://www.upca.co.in/academy/index,,1,0,1,6e-06,31
upca.co.in/academy/index,,1,0,1,6e-06,31
en.wikipedia.org/w/index.php?title=Kamla_Club_Ground&action=edit&section=2,,1,0,1,6e-06,31
cricketarchive.com/Archive/Grounds/14/1065.html,,1,0,1,6e-06,31
wikimapia.org/319772/Kamla-Club,,1,0,1,6e-06,31
en.wikipedia.org/wiki/File:Eden_Gardens.jpg,,1,0,1,6e-06,31
en.wikipedia.org/wiki/Template:India-sports-venue-stub,,1,0,1,6e-06,31
en.wikipedia.org/wiki/Template_talk:India-sports-venue-stub,,1,0,1,6e-06,31
en.wikipedia.org/wiki/Special:EditPage/Template:India-sports-venue-stub,,1,0,1,6e-06,31
en.wikipedia.org/wiki/File:Mcg_internal_odi_medium.jpg,,1,0,1,6e-06,31
en.wikipedia.org/wiki/Ground_(cricket),,1,0,1,6e-06,31
en.wikipedia.org/wiki/Template:India-cricket-ground-stub,,1,0,1,6e-06,31
en.wikipedia.org/wiki/Template_talk:India-cricket-ground-stub,,1,0,1,6e-06,31
en.wikipedia.org/wiki/Special:EditPage/Template:India-cricket-ground-stub,,1,0,1,6e-06,31
en.wikipedia.org/wiki/Category:Cricket_grounds_in_Uttar_Pradesh,,1,0,1,6e-06,31
en.wikipedia.org/wiki/Category:Sports_venues_completed_in_1932,,1,0,1,6e-06,31
en.wikipedia.org/wiki/Category:1932_establishments_in_India,,1,0,1,6e-06,31
en.wikipedia.org/wiki/Category:Memorials_to_Kamala_Nehru,,1,0,1,6e-06,31
en.wikipedia.org/wiki/Category:Indian_sports_venue_stubs,,1,0,1,6e-06,31
en.wikipedia.org/wiki/Category:Indian_cricket_ground_stubs,,1,0,1,6e-06,31
en.m.wikipedia.org/w/index.php?title=Kamla_Club_Ground&mobileaction=toggle_view_mobile,,1,0,1,6e-06,31
upload.wikimedia.org/wikipedia/commons/thumb/a/a4/Eden_Gardens.jpg/40px-Eden_Gardens.jpg,,1,0,1,6e-06,31
